,year,county_name,subject_sex,nb_arrest,male,female,population,relative_arrest,state
0,2009,Alameda,female,34786,807171,836529,1643700,0.0415837346941947,California
2,2010,Alameda,female,76046,807171,836529,1643700,0.09090659140328668,California
4,2011,Alameda,female,87530,807171,836529,1643700,0.10463474667345662,California
6,2012,Alameda,female,74437,807171,836529,1643700,0.0889831673498468,California
8,2013,Alameda,female,76476,807171,836529,1643700,0.09142062020563543,California
10,2014,Alameda,female,69083,807171,836529,1643700,0.08258291105269512,California
12,2015,Alameda,female,67701,807171,836529,1643700,0.08093084639026261,California
14,2016,Alameda,female,30140,807171,836529,1643700,0.03602983279718934,California
16,2009,Alpine,female,1895,612,534,1146,3.548689138576779,California
18,2010,Alpine,female,3465,612,534,1146,6.48876404494382,California
20,2011,Alpine,female,4241,612,534,1146,7.941947565543071,California
22,2012,Alpine,female,3389,612,534,1146,6.346441947565543,California
24,2013,Alpine,female,3534,612,534,1146,6.617977528089888,California
26,2014,Alpine,female,3213,612,534,1146,6.01685393258427,California
28,2015,Alpine,female,3267,612,534,1146,6.117977528089888,California
30,2016,Alpine,female,1394,612,534,1146,2.6104868913857677,California
32,2009,Amador,female,2239,20302,17527,37829,0.12774576367889542,California
34,2010,Amador,female,4773,20302,17527,37829,0.2723227021167342,California
36,2011,Amador,female,5100,20302,17527,37829,0.2909796314258002,California
38,2012,Amador,female,3638,20302,17527,37829,0.2075654704170708,California
40,2013,Amador,female,3865,20302,17527,37829,0.22051691675700347,California
42,2014,Amador,female,3611,20302,17527,37829,0.2060249900154048,California
44,2015,Amador,female,3014,20302,17527,37829,0.1719632566896788,California
46,2016,Amador,female,1957,20302,17527,37829,0.1116563017059394,California
48,2009,Butte,female,6795,112513,114562,227075,0.059312861158150175,California
49,2009,Butte,female,6795,1342,1260,2602,5.392857142857143,California
50,2009,Butte,female,6795,5083,5094,10177,1.3339222614840989,California
54,2010,Butte,female,14787,112513,114562,227075,0.12907421308985528,California
55,2010,Butte,female,14787,1342,1260,2602,11.735714285714286,California
56,2010,Butte,female,14787,5083,5094,10177,2.902826855123675,California
60,2011,Butte,female,13213,112513,114562,227075,0.11533492781201446,California
61,2011,Butte,female,13213,1342,1260,2602,10.486507936507936,California
62,2011,Butte,female,13213,5083,5094,10177,2.59383588535532,California
66,2012,Butte,female,11938,112513,114562,227075,0.10420558300309003,California
67,2012,Butte,female,11938,1342,1260,2602,9.474603174603175,California
68,2012,Butte,female,11938,5083,5094,10177,2.3435414212799373,California
72,2013,Butte,female,11857,112513,114562,227075,0.10349854227405247,California
73,2013,Butte,female,11857,1342,1260,2602,9.41031746031746,California
74,2013,Butte,female,11857,5083,5094,10177,2.3276403612092658,California
78,2014,Butte,female,10205,112513,114562,227075,0.08907840296084217,California
79,2014,Butte,female,10205,1342,1260,2602,8.09920634920635,California
80,2014,Butte,female,10205,5083,5094,10177,2.0033372595210053,California
84,2015,Butte,female,10468,112513,114562,227075,0.09137410310574187,California
85,2015,Butte,female,10468,1342,1260,2602,8.307936507936509,California
86,2015,Butte,female,10468,5083,5094,10177,2.0549666274047897,California
90,2016,Butte,female,5062,112513,114562,227075,0.044185681115902306,California
91,2016,Butte,female,5062,1342,1260,2602,4.017460317460317,California
92,2016,Butte,female,5062,5083,5094,10177,0.9937180997251669,California
96,2009,Calaveras,female,3282,22434,22801,45235,0.14394105521687645,California
98,2010,Calaveras,female,6259,22434,22801,45235,0.27450550414455505,California
100,2011,Calaveras,female,5668,22434,22801,45235,0.2485855883513881,California
102,2012,Calaveras,female,4693,22434,22801,45235,0.20582430595149337,California
104,2013,Calaveras,female,3811,22434,22801,45235,0.1671417920266655,California
106,2014,Calaveras,female,3367,22434,22801,45235,0.1476689618876365,California
108,2015,Calaveras,female,3637,22434,22801,45235,0.15951054778299198,California
110,2016,Calaveras,female,1575,22434,22801,45235,0.06907591772290689,California
112,2009,Colusa,female,2400,11124,10340,21464,0.23210831721470018,California
114,2010,Colusa,female,5375,11124,10340,21464,0.519825918762089,California
116,2011,Colusa,female,5220,11124,10340,21464,0.504835589941973,California
118,2012,Colusa,female,4759,11124,10340,21464,0.4602514506769826,California
120,2013,Colusa,female,3606,11124,10340,21464,0.34874274661508703,California
122,2014,Colusa,female,3510,11124,10340,21464,0.33945841392649906,California
124,2015,Colusa,female,4936,11124,10340,21464,0.4773694390715667,California
126,2016,Colusa,female,2702,11124,10340,21464,0.26131528046421665,California
128,2009,Contra Costa,female,9552,553701,579546,1133247,0.016481866840595914,California
130,2010,Contra Costa,female,24124,553701,579546,1133247,0.04162568631307955,California
132,2011,Contra Costa,female,25296,553701,579546,1133247,0.043647958919568075,California
134,2012,Contra Costa,female,22360,553701,579546,1133247,0.03858192447191422,California
136,2013,Contra Costa,female,21355,553701,579546,1133247,0.03684780845696459,California
138,2014,Contra Costa,female,17786,553701,579546,1133247,0.03068953974317828,California
140,2015,Contra Costa,female,15682,553701,579546,1133247,0.027059111787502633,California
142,2016,Contra Costa,female,6652,553701,579546,1133247,0.011477949981537273,California
144,2009,Del Norte,female,1861,14575,12849,27424,0.14483617402132462,California
146,2010,Del Norte,female,3462,14575,12849,27424,0.2694373102965211,California
148,2011,Del Norte,female,3908,14575,12849,27424,0.30414818273795624,California
150,2012,Del Norte,female,3316,14575,12849,27424,0.25807455833138765,California
152,2013,Del Norte,female,3169,14575,12849,27424,0.24663397929799985,California
154,2014,Del Norte,female,3403,14575,12849,27424,0.26484551326951516,California
156,2015,Del Norte,female,3967,14575,12849,27424,0.30873997976496226,California
158,2016,Del Norte,female,1759,14575,12849,27424,0.13689781305938206,California
160,2009,El Dorado,female,4201,93040,93621,186661,0.04487241110434625,California
162,2010,El Dorado,female,8003,93040,93621,186661,0.08548295788338087,California
164,2011,El Dorado,female,8252,93040,93621,186661,0.0881426175751167,California
166,2012,El Dorado,female,8765,93040,93621,186661,0.09362215742194593,California
168,2013,El Dorado,female,9513,93040,93621,186661,0.10161181786137725,California
170,2014,El Dorado,female,7907,93040,93621,186661,0.08445754691789235,California
172,2015,El Dorado,female,6983,93040,93621,186661,0.07458796637506543,California
174,2016,El Dorado,female,3297,93040,93621,186661,0.03521645784599609,California
176,2009,Fresno,female,14788,487936,490194,978130,0.03016764791082714,California
178,2010,Fresno,female,31753,487936,490194,978130,0.06477639465191333,California
180,2011,Fresno,female,30017,487936,490194,978130,0.061234939636144056,California
182,2012,Fresno,female,28820,487936,490194,978130,0.05879304928252896,California
184,2013,Fresno,female,24893,487936,490194,978130,0.050781935315405737,California
186,2014,Fresno,female,20044,487936,490194,978130,0.040889933373317505,California
188,2015,Fresno,female,21447,487936,490194,978130,0.04375206550875776,California
190,2016,Fresno,female,11597,487936,490194,978130,0.023657980309836513,California
192,2009,Glenn,female,3224,14171,13726,27897,0.2348827043566953,California
194,2010,Glenn,female,6610,14171,13726,27897,0.4815678274806936,California
196,2011,Glenn,female,5373,14171,13726,27897,0.39144688911554715,California
198,2012,Glenn,female,5089,14171,13726,27897,0.3707562290543494,California
200,2013,Glenn,female,5116,14171,13726,27897,0.3727232988488999,California
202,2014,Glenn,female,4729,14171,13726,27897,0.3445286317936762,California
204,2015,Glenn,female,4534,14171,13726,27897,0.3303220166108116,California
206,2016,Glenn,female,1743,14171,13726,27897,0.12698528340375928,California
208,2009,Humboldt,female,4675,67666,68102,135768,0.06864702945581627,California
209,2009,Humboldt,female,4675,4651,4915,9566,0.9511698880976602,California
210,2009,Humboldt,female,4675,8779,8125,16904,0.5753846153846154,California
214,2010,Humboldt,female,8362,67666,68102,135768,0.12278640862236058,California
215,2010,Humboldt,female,8362,4651,4915,9566,1.701322482197355,California
216,2010,Humboldt,female,8362,8779,8125,16904,1.0291692307692308,California
220,2011,Humboldt,female,7786,67666,68102,135768,0.11432850723914129,California
221,2011,Humboldt,female,7786,4651,4915,9566,1.5841302136317397,California
222,2011,Humboldt,female,7786,8779,8125,16904,0.958276923076923,California
226,2012,Humboldt,female,6241,67666,68102,135768,0.09164194884144372,California
227,2012,Humboldt,female,6241,4651,4915,9566,1.2697863682604273,California
228,2012,Humboldt,female,6241,8779,8125,16904,0.7681230769230769,California
232,2013,Humboldt,female,5952,67666,68102,135768,0.08739831429326599,California
233,2013,Humboldt,female,5952,4651,4915,9566,1.2109867751780266,California
234,2013,Humboldt,female,5952,8779,8125,16904,0.7325538461538461,California
238,2014,Humboldt,female,6245,67666,68102,135768,0.09170068426771608,California
239,2014,Humboldt,female,6245,4651,4915,9566,1.2706002034587995,California
240,2014,Humboldt,female,6245,8779,8125,16904,0.7686153846153846,California
244,2015,Humboldt,female,6788,67666,68102,135768,0.09967401838418842,California
245,2015,Humboldt,female,6788,4651,4915,9566,1.3810783316378434,California
246,2015,Humboldt,female,6788,8779,8125,16904,0.8354461538461538,California
250,2016,Humboldt,female,3955,67666,68102,135768,0.058074652726792166,California
251,2016,Humboldt,female,3955,4651,4915,9566,0.8046795523906409,California
252,2016,Humboldt,female,3955,8779,8125,16904,0.4867692307692308,California
256,2009,Imperial,female,9110,92250,87966,180216,0.10356274014960326,California
258,2010,Imperial,female,18661,92250,87966,180216,0.2121387808926176,California
260,2011,Imperial,female,18461,92250,87966,180216,0.20986517518132006,California
262,2012,Imperial,female,17099,92250,87966,180216,0.19438192028738377,California
264,2013,Imperial,female,19672,92250,87966,180216,0.2236318577632267,California
266,2014,Imperial,female,21235,92250,87966,180216,0.24140008639701702,California
268,2015,Imperial,female,22426,92250,87966,180216,0.25493940840779394,California
270,2016,Imperial,female,9545,92250,87966,180216,0.10850783257167541,California
272,2009,Inyo,female,2557,9084,9001,18085,0.28407954671703145,California
274,2010,Inyo,female,5408,9084,9001,18085,0.6008221308743473,California
276,2011,Inyo,female,5396,9084,9001,18085,0.599488945672703,California
278,2012,Inyo,female,4444,9084,9001,18085,0.4937229196755916,California
280,2013,Inyo,female,4092,9084,9001,18085,0.45461615376069325,California
282,2014,Inyo,female,4025,9084,9001,18085,0.4471725363848461,California
284,2015,Inyo,female,4726,9084,9001,18085,0.5250527719142317,California
286,2016,Inyo,female,3092,9084,9001,18085,0.3435173869570048,California
288,2009,Kern,female,28031,452646,430407,883053,0.06512672888684432,California
290,2010,Kern,female,60014,452646,430407,883053,0.1394354645719052,California
292,2011,Kern,female,59526,452646,430407,883053,0.13830165401585012,California
294,2012,Kern,female,53159,452646,430407,883053,0.12350867899453308,California
296,2013,Kern,female,50283,452646,430407,883053,0.11682663153712648,California
298,2014,Kern,female,46519,452646,430407,883053,0.10808142060886557,California
300,2015,Kern,female,45219,452646,430407,883053,0.10506102363576801,California
302,2016,Kern,female,22680,452646,430407,883053,0.05269431026911737,California
304,2009,Kings,female,4087,82674,67401,150075,0.06063708253586742,California
305,2009,Kings,female,4087,1231912,1368835,2600747,0.002985750656580231,California
308,2010,Kings,female,9278,82674,67401,150075,0.1376537440097328,California
309,2010,Kings,female,9278,1231912,1368835,2600747,0.0067780265700394865,California
312,2011,Kings,female,8865,82674,67401,150075,0.13152623848310857,California
313,2011,Kings,female,8865,1231912,1368835,2600747,0.006476310146949779,California
316,2012,Kings,female,8465,82674,67401,150075,0.1255916084331093,California
317,2012,Kings,female,8465,1231912,1368835,2600747,0.006184090850979118,California
320,2013,Kings,female,8787,82674,67401,150075,0.1303689856233587,California
321,2013,Kings,female,8787,1231912,1368835,2600747,0.006419327384235499,California
324,2014,Kings,female,7438,82674,67401,150075,0.1103544457797362,California
325,2014,Kings,female,7438,1231912,1368835,2600747,0.005433817808574445,California
328,2015,Kings,female,6061,82674,67401,150075,0.08992448183261376,California
329,2015,Kings,female,6061,1231912,1368835,2600747,0.004427852882195444,California
332,2016,Kings,female,2514,82674,67401,150075,0.03729914986424534,California
333,2016,Kings,female,2514,1231912,1368835,2600747,0.0018365982751756054,California
336,2009,Lake,female,2639,31879,32269,64148,0.08178127614738603,California
337,2009,Lake,female,2639,4176,3409,7585,0.7741273100616016,California
338,2009,Lake,female,2639,162402,172960,335362,0.01525786308973173,California
339,2009,Lake,female,2639,351343,352276,703619,0.007491285242253233,California
340,2009,Lake,female,2639,235515,251334,486849,0.01049997214861499,California
341,2009,Lake,female,2639,6000,5763,11763,0.45792122158597953,California
342,2009,Lake,female,2639,5428,5141,10569,0.5133242559813266,California
343,2009,Lake,female,2639,14744,15030,29774,0.17558216899534265,California
344,2009,Lake,female,2639,112379,117673,230052,0.02242655494463471,California
345,2009,Lake,female,2639,4192,3651,7843,0.7228156669405642,California
346,2009,Lake,female,2639,6569,6005,12574,0.4394671107410491,California
347,2009,Lake,female,2639,4642,2884,7526,0.9150485436893204,California
360,2010,Lake,female,5890,31879,32269,64148,0.18252812296631443,California
361,2010,Lake,female,5890,4176,3409,7585,1.7277794074508654,California
362,2010,Lake,female,5890,162402,172960,335362,0.0340541165587419,California
363,2010,Lake,female,5890,351343,352276,703619,0.01671984466724954,California
364,2010,Lake,female,5890,235515,251334,486849,0.02343495110092546,California
365,2010,Lake,female,5890,6000,5763,11763,1.0220371334374458,California
366,2010,Lake,female,5890,5428,5141,10569,1.145691499708228,California
367,2010,Lake,female,5890,14744,15030,29774,0.39188290086493677,California
368,2010,Lake,female,5890,112379,117673,230052,0.0500539631011362,California
369,2010,Lake,female,5890,4192,3651,7843,1.613256642015886,California
370,2010,Lake,female,5890,6569,6005,12574,0.980849292256453,California
371,2010,Lake,female,5890,4642,2884,7526,2.0423023578363386,California
384,2011,Lake,female,4818,31879,32269,64148,0.14930738479655398,California
385,2011,Lake,female,4818,4176,3409,7585,1.4133176884716925,California
386,2011,Lake,female,4818,162402,172960,335362,0.027856151711378355,California
387,2011,Lake,female,4818,351343,352276,703619,0.013676776164144023,California
388,2011,Lake,female,4818,235515,251334,486849,0.019169710425171287,California
389,2011,Lake,female,4818,6000,5763,11763,0.836022904737116,California
390,2011,Lake,female,4818,5428,5141,10569,0.9371717564676133,California
391,2011,Lake,female,4818,14744,15030,29774,0.3205588822355289,California
392,2011,Lake,female,4818,112379,117673,230052,0.040943971854206146,California
393,2011,Lake,female,4818,4192,3651,7843,1.3196384552177485,California
394,2011,Lake,female,4818,6569,6005,12574,0.80233139050791,California
395,2011,Lake,female,4818,4642,2884,7526,1.6705963938973647,California
408,2012,Lake,female,3661,31879,32269,64148,0.1134525395890793,California
409,2012,Lake,female,3661,4176,3409,7585,1.0739219712525667,California
410,2012,Lake,female,3661,162402,172960,335362,0.021166743755781682,California
411,2012,Lake,female,3661,351343,352276,703619,0.010392419580101965,California
412,2012,Lake,female,3661,235515,251334,486849,0.01456627436001496,California
413,2012,Lake,female,3661,6000,5763,11763,0.6352594134999132,California
414,2012,Lake,female,3661,5428,5141,10569,0.7121182649290021,California
415,2012,Lake,female,3661,14744,15030,29774,0.24357950765136394,California
416,2012,Lake,female,3661,112379,117673,230052,0.03111163988340571,California
417,2012,Lake,female,3661,4192,3651,7843,1.0027389756231169,California
418,2012,Lake,female,3661,6569,6005,12574,0.6096586178184846,California
419,2012,Lake,female,3661,4642,2884,7526,1.2694174757281553,California
432,2013,Lake,female,3703,31879,32269,64148,0.11475409836065574,California
433,2013,Lake,female,3703,4176,3409,7585,1.0862422997946612,California
434,2013,Lake,female,3703,162402,172960,335362,0.021409574468085106,California
435,2013,Lake,female,3703,351343,352276,703619,0.010511644278917667,California
436,2013,Lake,female,3703,235515,251334,486849,0.014733382670072494,California
437,2013,Lake,female,3703,6000,5763,11763,0.6425472844004858,California
438,2013,Lake,female,3703,5428,5141,10569,0.720287881735071,California
439,2013,Lake,female,3703,14744,15030,29774,0.24637391882900864,California
440,2013,Lake,female,3703,112379,117673,230052,0.03146856118225931,California
441,2013,Lake,female,3703,4192,3651,7843,1.0142426732402081,California
442,2013,Lake,female,3703,6569,6005,12574,0.6166527893422148,California
443,2013,Lake,female,3703,4642,2884,7526,1.2839805825242718,California
456,2014,Lake,female,4180,31879,32269,64148,0.1295360872664167,California
457,2014,Lake,female,4180,4176,3409,7585,1.2261660310941624,California
458,2014,Lake,female,4180,162402,172960,335362,0.024167437557816838,California
459,2014,Lake,female,4180,351343,352276,703619,0.011865696215467418,California
460,2014,Lake,female,4180,235515,251334,486849,0.01663125562001162,California
461,2014,Lake,female,4180,6000,5763,11763,0.7253166753427035,California
462,2014,Lake,female,4180,5428,5141,10569,0.8130713868897101,California
463,2014,Lake,female,4180,14744,15030,29774,0.27811044577511645,California
464,2014,Lake,female,4180,112379,117673,230052,0.03552216736209666,California
465,2014,Lake,female,4180,4192,3651,7843,1.144891810462887,California
466,2014,Lake,female,4180,6569,6005,12574,0.6960865945045795,California
467,2014,Lake,female,4180,4642,2884,7526,1.449375866851595,California
480,2015,Lake,female,3519,31879,32269,64148,0.1090520313613685,California
481,2015,Lake,female,3519,4176,3409,7585,1.032267527134057,California
482,2015,Lake,female,3519,162402,172960,335362,0.020345744680851065,California
483,2015,Lake,female,3519,351343,352276,703619,0.00998932655077269,California
484,2015,Lake,female,3519,235515,251334,486849,0.014001289121249014,California
485,2015,Lake,female,3519,6000,5763,11763,0.6106194690265486,California
486,2015,Lake,female,3519,5428,5141,10569,0.684497179537055,California
487,2015,Lake,female,3519,14744,15030,29774,0.2341317365269461,California
488,2015,Lake,female,3519,112379,117673,230052,0.029904905968234006,California
489,2015,Lake,female,3519,4192,3651,7843,0.9638455217748562,California
490,2015,Lake,female,3519,6569,6005,12574,0.5860116569525395,California
491,2015,Lake,female,3519,4642,2884,7526,1.2201803051317615,California
504,2016,Lake,female,2024,31879,32269,64148,0.06272273699215966,California
505,2016,Lake,female,2024,4176,3409,7585,0.5937224992666471,California
506,2016,Lake,female,2024,162402,172960,335362,0.011702127659574468,California
507,2016,Lake,female,2024,351343,352276,703619,0.005745495009594749,California
508,2016,Lake,female,2024,235515,251334,486849,0.008053029037058257,California
509,2016,Lake,female,2024,6000,5763,11763,0.35120596911330904,California
510,2016,Lake,female,2024,5428,5141,10569,0.39369772417817545,California
511,2016,Lake,female,2024,14744,15030,29774,0.13466400532268796,California
512,2016,Lake,female,2024,112379,117673,230052,0.017200207354278383,California
513,2016,Lake,female,2024,4192,3651,7843,0.5543686661188716,California
514,2016,Lake,female,2024,6569,6005,12574,0.337052456286428,California
515,2016,Lake,female,2024,4642,2884,7526,0.7018030513176144,California
528,2009,Lassen,female,2904,20671,10514,31185,0.27620315769450254,California
530,2010,Lassen,female,6660,20671,10514,31185,0.6334411261175575,California
532,2011,Lassen,female,5782,20671,10514,31185,0.5499334221038615,California
534,2012,Lassen,female,4999,20671,10514,31185,0.47546128970895946,California
536,2013,Lassen,female,5267,20671,10514,31185,0.5009511128019783,California
538,2014,Lassen,female,4187,20671,10514,31185,0.39823093018832034,California
540,2015,Lassen,female,5252,20671,10514,31185,0.4995244435990108,California
542,2016,Lassen,female,2704,20671,10514,31185,0.2571809016549363,California
544,2009,Los Angeles,female,144806,4976788,5121264,10098052,0.028275441375410444,California
546,2010,Los Angeles,female,305855,4976788,5121264,10098052,0.05972256068033204,California
548,2011,Los Angeles,female,315453,4976788,5121264,10098052,0.061596707375366704,California
550,2012,Los Angeles,female,291142,4976788,5121264,10098052,0.056849637120835794,California
552,2013,Los Angeles,female,282079,4976788,5121264,10098052,0.05507995682315928,California
554,2014,Los Angeles,female,258383,4976788,5121264,10098052,0.05045297410951671,California
556,2015,Los Angeles,female,229038,4976788,5121264,10098052,0.044722943398348536,California
558,2016,Los Angeles,female,105820,4976788,5121264,10098052,0.020662867604560126,California
560,2009,Madera,female,6013,74683,80330,155013,0.0748537283704718,California
562,2010,Madera,female,11368,74683,80330,155013,0.14151624548736463,California
564,2011,Madera,female,9539,74683,80330,155013,0.11874766587825221,California
566,2012,Madera,female,8972,74683,80330,155013,0.11168928171293414,California
568,2013,Madera,female,7382,74683,80330,155013,0.09189592929167185,California
570,2014,Madera,female,6934,74683,80330,155013,0.08631893439561808,California
572,2015,Madera,female,8189,74683,80330,155013,0.10194198929416158,California
574,2016,Madera,female,4503,74683,80330,155013,0.0560562678949334,California
576,2009,Marin,female,11294,127113,133182,260295,0.08480124941808953,California
578,2010,Marin,female,21409,127113,133182,260295,0.1607499511946059,California
580,2011,Marin,female,20481,127113,133182,260295,0.15378204261837186,California
582,2012,Marin,female,20572,127113,133182,260295,0.15446531813608447,California
584,2013,Marin,female,22007,127113,133182,260295,0.16524004745386014,California
586,2014,Marin,female,15223,127113,133182,260295,0.11430223303449415,California
588,2015,Marin,female,15861,127113,133182,260295,0.11909267018065504,California
590,2016,Marin,female,7724,127113,133182,260295,0.057995825261672,California
592,2009,Mariposa,female,1030,8920,8620,17540,0.11948955916473318,California
594,2010,Mariposa,female,2617,8920,8620,17540,0.3035962877030162,California
596,2011,Mariposa,female,2001,8920,8620,17540,0.23213457076566124,California
598,2012,Mariposa,female,2223,8920,8620,17540,0.25788863109048726,California
600,2013,Mariposa,female,1864,8920,8620,17540,0.2162412993039443,California
602,2014,Mariposa,female,1895,8920,8620,17540,0.21983758700696054,California
604,2015,Mariposa,female,1999,8920,8620,17540,0.23190255220417633,California
606,2016,Mariposa,female,756,8920,8620,17540,0.08770301624129931,California
608,2009,Mendocino,female,7015,43439,43983,87422,0.1594934406475229,California
610,2010,Mendocino,female,13836,43439,43983,87422,0.31457608621512856,California
612,2011,Mendocino,female,12624,43439,43983,87422,0.2870199849942023,California
614,2012,Mendocino,female,12363,43439,43983,87422,0.2810858740877157,California
616,2013,Mendocino,female,12678,43439,43983,87422,0.28824773207830295,California
618,2014,Mendocino,female,11348,43439,43983,87422,0.2580087761180456,California
620,2015,Mendocino,female,12037,43439,43983,87422,0.2736739194688857,California
622,2016,Mendocino,female,5786,43439,43983,87422,0.13155082645567606,California
624,2009,Merced,female,9777,135816,133259,269075,0.07336840288460816,California
626,2010,Merced,female,19307,135816,133259,269075,0.1448832724243766,California
628,2011,Merced,female,17122,135816,133259,269075,0.12848663129694804,California
630,2012,Merced,female,15996,135816,133259,269075,0.12003692058322515,California
632,2013,Merced,female,17190,135816,133259,269075,0.12899691578054764,California
634,2014,Merced,female,14899,135816,133259,269075,0.11180483119339031,California
636,2015,Merced,female,14258,135816,133259,269075,0.10699464951710579,California
638,2016,Merced,female,6620,135816,133259,269075,0.04967769531513819,California
640,2009,Modoc,female,1192,4613,4325,8938,0.27560693641618494,California
642,2010,Modoc,female,2038,4613,4325,8938,0.47121387283236993,California
644,2011,Modoc,female,1525,4613,4325,8938,0.35260115606936415,California
646,2012,Modoc,female,1645,4613,4325,8938,0.38034682080924853,California
648,2013,Modoc,female,1761,4613,4325,8938,0.4071676300578035,California
650,2014,Modoc,female,1761,4613,4325,8938,0.4071676300578035,California
652,2015,Modoc,female,1378,4613,4325,8938,0.3186127167630058,California
654,2016,Modoc,female,738,4613,4325,8938,0.17063583815028902,California
656,2009,Mono,female,1495,7341,6833,14174,0.2187911605444168,California
658,2010,Mono,female,3666,7341,6833,14174,0.5365139762915264,California
660,2011,Mono,female,3711,7341,6833,14174,0.5430996633982146,California
662,2012,Mono,female,3444,7341,6833,14174,0.5040245865651983,California
664,2013,Mono,female,2770,7341,6833,14174,0.4053856285672472,California
666,2014,Mono,female,3104,7341,6833,14174,0.4542660617591102,California
668,2015,Mono,female,3512,7341,6833,14174,0.5139762915264159,California
670,2016,Mono,female,1862,7341,6833,14174,0.2725010976145178,California
672,2009,Monterey,female,13475,220967,212245,433212,0.06348795024617776,California
674,2010,Monterey,female,27894,220967,212245,433212,0.13142359066173526,California
676,2011,Monterey,female,25165,220967,212245,433212,0.11856580838182289,California
678,2012,Monterey,female,25533,220967,212245,433212,0.12029965370208956,California
680,2013,Monterey,female,21004,220967,212245,433212,0.0989611062686989,California
682,2014,Monterey,female,19953,220967,212245,433212,0.09400928172630686,California
684,2015,Monterey,female,20056,220967,212245,433212,0.09449456995453367,California
686,2016,Monterey,female,8896,220967,212245,433212,0.041913826002968266,California
688,2009,Napa,female,3701,70082,70448,140530,0.05253520327049739,California
690,2010,Napa,female,8663,70082,70448,140530,0.12297013399954576,California
692,2011,Napa,female,8460,70082,70448,140530,0.12008857597092891,California
694,2012,Napa,female,7598,70082,70448,140530,0.10785260049965932,California
696,2013,Napa,female,8619,70082,70448,140530,0.12234555984555985,California
698,2014,Napa,female,8195,70082,70448,140530,0.11632693617987735,California
700,2015,Napa,female,8718,70082,70448,140530,0.12375085169202817,California
702,2016,Napa,female,3942,70082,70448,140530,0.0559561662502839,California
704,2009,Nevada,female,4467,4425,4015,8440,1.1125778331257783,California
705,2009,Nevada,female,4467,48889,50203,99092,0.08897874629006235,California
708,2010,Nevada,female,9246,4425,4015,8440,2.3028642590286426,California
709,2010,Nevada,female,9246,48889,50203,99092,0.1841722606218752,California
712,2011,Nevada,female,7703,4425,4015,8440,1.9185554171855541,California
713,2011,Nevada,female,7703,48889,50203,99092,0.15343704559488477,California
716,2012,Nevada,female,5994,4425,4015,8440,1.4929016189290163,California
717,2012,Nevada,female,5994,48889,50203,99092,0.11939525526362967,California
720,2013,Nevada,female,7671,4425,4015,8440,1.910585305105853,California
721,2013,Nevada,female,7671,48889,50203,99092,0.15279963348803857,California
724,2014,Nevada,female,7476,4425,4015,8440,1.8620174346201743,California
725,2014,Nevada,female,7476,48889,50203,99092,0.1489154034619445,California
728,2015,Nevada,female,7898,4425,4015,8440,1.9671232876712328,California
729,2015,Nevada,female,7898,48889,50203,99092,0.15732127562097883,California
732,2016,Nevada,female,3932,4425,4015,8440,0.9793275217932752,California
733,2016,Nevada,female,3932,48889,50203,99092,0.07832201262872737,California
736,2009,Orange,female,37309,1562429,1601753,3164182,0.023292605039603485,California
737,2009,Orange,female,37309,648446,672748,1321194,0.05545761563022112,California
738,2009,Orange,female,37309,9727,9820,19547,3.7992871690427696,California
739,2009,Orange,female,37309,189484,188743,378227,0.19767090700052453,California
740,2009,Orange,female,37309,68187,74751,142938,0.49911037979425027,California
741,2009,Orange,female,37309,41630,42417,84047,0.8795765848598439,California
742,2009,Orange,female,37309,14357,14580,28937,2.5589163237311388,California
743,2009,Orange,female,37309,17418,18194,35612,2.0506210838738044,California
752,2010,Orange,female,78806,1562429,1601753,3164182,0.04919984541936241,California
753,2010,Orange,female,78806,648446,672748,1321194,0.11714044486196912,California
754,2010,Orange,female,78806,9727,9820,19547,8.025050916496944,California
755,2010,Orange,female,78806,189484,188743,378227,0.41753071637093825,California
756,2010,Orange,female,78806,68187,74751,142938,1.0542467659295527,California
757,2010,Orange,female,78806,41630,42417,84047,1.8578871678808024,California
758,2010,Orange,female,78806,14357,14580,28937,5.405075445816187,California
759,2010,Orange,female,78806,17418,18194,35612,4.331427943278004,California
768,2011,Orange,female,85432,1562429,1601753,3164182,0.05333656312802286,California
769,2011,Orange,female,85432,648446,672748,1321194,0.12698960086094643,California
770,2011,Orange,female,85432,9727,9820,19547,8.69979633401222,California
771,2011,Orange,female,85432,189484,188743,378227,0.4526366540745882,California
772,2011,Orange,female,85432,68187,74751,142938,1.1428877205656112,California
773,2011,Orange,female,85432,41630,42417,84047,2.014098121036377,California
774,2011,Orange,female,85432,14357,14580,28937,5.8595336076817555,California
775,2011,Orange,female,85432,17418,18194,35612,4.695613938661097,California
784,2012,Orange,female,75087,1562429,1601753,3164182,0.04687801427560929,California
785,2012,Orange,female,75087,648446,672748,1321194,0.11161237194313472,California
786,2012,Orange,female,75087,9727,9820,19547,7.64633401221996,California
787,2012,Orange,female,75087,189484,188743,378227,0.39782667436673147,California
788,2012,Orange,female,75087,68187,74751,142938,1.0044949231448408,California
789,2012,Orange,female,75087,41630,42417,84047,1.7702100572883515,California
790,2012,Orange,female,75087,14357,14580,28937,5.15,California
791,2012,Orange,female,75087,17418,18194,35612,4.127019896669232,California
800,2013,Orange,female,66562,1562429,1601753,3164182,0.04155572051371217,California
801,2013,Orange,female,66562,648446,672748,1321194,0.09894046507756248,California
802,2013,Orange,female,66562,9727,9820,19547,6.778207739307535,California
803,2013,Orange,female,66562,189484,188743,378227,0.3526594363764484,California
804,2013,Orange,female,66562,68187,74751,142938,0.8904496260919587,California
805,2013,Orange,female,66562,41630,42417,84047,1.569229318433647,California
806,2013,Orange,female,66562,14357,14580,28937,4.565294924554184,California
807,2013,Orange,female,66562,17418,18194,35612,3.65845883258217,California
816,2014,Orange,female,65285,1562429,1601753,3164182,0.040758469002399246,California
817,2014,Orange,female,65285,648446,672748,1321194,0.09704228031893071,California
818,2014,Orange,female,65285,9727,9820,19547,6.64816700610998,California
819,2014,Orange,female,65285,189484,188743,378227,0.34589362254494205,California
820,2014,Orange,female,65285,68187,74751,142938,0.8733662425920723,California
821,2014,Orange,female,65285,41630,42417,84047,1.5391234646486078,California
822,2014,Orange,female,65285,14357,14580,28937,4.477709190672154,California
823,2014,Orange,female,65285,17418,18194,35612,3.588270858524788,California
832,2015,Orange,female,62130,1562429,1601753,3164182,0.03878875207350946,California
833,2015,Orange,female,62130,648446,672748,1321194,0.09235255994815295,California
834,2015,Orange,female,62130,9727,9820,19547,6.326883910386965,California
835,2015,Orange,female,62130,189484,188743,378227,0.3291777708312361,California
836,2015,Orange,female,62130,68187,74751,142938,0.8311594493719148,California
837,2015,Orange,female,62130,41630,42417,84047,1.4647429096824387,California
838,2015,Orange,female,62130,14357,14580,28937,4.261316872427984,California
839,2015,Orange,female,62130,17418,18194,35612,3.414862042431571,California
848,2016,Orange,female,28772,1562429,1601753,3164182,0.01796281948590076,California
849,2016,Orange,female,28772,648446,672748,1321194,0.04276787147639235,California
850,2016,Orange,female,28772,9727,9820,19547,2.929938900203666,California
851,2016,Orange,female,28772,189484,188743,378227,0.15244009049342228,California
852,2016,Orange,female,28772,68187,74751,142938,0.3849045497719094,California
853,2016,Orange,female,28772,41630,42417,84047,0.6783129405662824,California
854,2016,Orange,female,28772,14357,14580,28937,1.9733882030178327,California
855,2016,Orange,female,28772,17418,18194,35612,1.5814004616906672,California
864,2009,Placer,female,6744,185511,194566,380077,0.03466176001973623,California
866,2010,Placer,female,10430,185511,194566,380077,0.053606488286751026,California
868,2011,Placer,female,8884,185511,194566,380077,0.04566059846016262,California
870,2012,Placer,female,9859,185511,194566,380077,0.05067175148792698,California
872,2013,Placer,female,8688,185511,194566,380077,0.04465322821047871,California
874,2014,Placer,female,8118,185511,194566,380077,0.0417236310557857,California
876,2015,Placer,female,7791,185511,194566,380077,0.040042967424935495,California
878,2016,Placer,female,3710,185511,194566,380077,0.01906807972615976,California
880,2009,Plumas,female,2579,9423,9276,18699,0.27802932298404487,California
882,2010,Plumas,female,4288,9423,9276,18699,0.46226821905993964,California
884,2011,Plumas,female,3965,9423,9276,18699,0.42744717550668393,California
886,2012,Plumas,female,3116,9423,9276,18699,0.3359206554549375,California
888,2013,Plumas,female,2698,9423,9276,18699,0.2908581285036654,California
890,2014,Plumas,female,2817,9423,9276,18699,0.3036869340232859,California
892,2015,Plumas,female,2764,9423,9276,18699,0.29797326433807675,California
894,2016,Plumas,female,1781,9423,9276,18699,0.19200086244070722,California
896,2009,Riverside,female,23722,1186188,1197098,2383286,0.019816255644901252,California
898,2010,Riverside,female,47450,1186188,1197098,2383286,0.03963752341078174,California
900,2011,Riverside,female,50772,1186188,1197098,2383286,0.04241256772628473,California
902,2012,Riverside,female,46651,1186188,1197098,2383286,0.03897007596704698,California
904,2013,Riverside,female,42526,1186188,1197098,2383286,0.03552424279382306,California
906,2014,Riverside,female,42250,1186188,1197098,2383286,0.035293685228778265,California
908,2015,Riverside,female,38099,1186188,1197098,2383286,0.03182613286464433,California
910,2016,Riverside,female,19167,1186188,1197098,2383286,0.016011220468165513,California
912,2009,Sacramento,female,38461,737742,772281,1510023,0.049801820839823846,California
914,2010,Sacramento,female,79706,737742,772281,1510023,0.10320854714799406,California
916,2011,Sacramento,female,71386,737742,772281,1510023,0.09243526643799342,California
918,2012,Sacramento,female,60306,737742,772281,1510023,0.07808815703092527,California
920,2013,Sacramento,female,56014,737742,772281,1510023,0.07253059443389129,California
922,2014,Sacramento,female,48386,737742,772281,1510023,0.06265336062909745,California
924,2015,Sacramento,female,50775,737742,772281,1510023,0.06574679423681276,California
926,2016,Sacramento,female,21762,737742,772281,1510023,0.02817886235709541,California
928,2009,San Benito,female,5970,29626,29790,59416,0.20040281973816718,California
930,2010,San Benito,female,13134,29626,29790,59416,0.4408862034239678,California
932,2011,San Benito,female,13718,29626,29790,59416,0.46049009734810337,California
934,2012,San Benito,female,13606,29626,29790,59416,0.45673044645854316,California
936,2013,San Benito,female,11379,29626,29790,59416,0.38197381671701913,California
938,2014,San Benito,female,9148,29626,29790,59416,0.3070829137294394,California
940,2015,San Benito,female,9655,29626,29790,59416,0.32410204766700235,California
942,2016,San Benito,female,4551,29626,29790,59416,0.15276938569989928,California
944,2009,San Bernardino,female,48922,1062472,1072941,2135413,0.045596169780071784,California
946,2010,San Bernardino,female,94051,1062472,1072941,2135413,0.0876571964348459,California
948,2011,San Bernardino,female,95793,1062472,1072941,2135413,0.08928077126328475,California
950,2012,San Bernardino,female,83978,1062472,1072941,2135413,0.07826898217143347,California
952,2013,San Bernardino,female,75386,1062472,1072941,2135413,0.0702610861175032,California
954,2014,San Bernardino,female,67758,1062472,1072941,2135413,0.06315165512362748,California
956,2015,San Bernardino,female,66211,1062472,1072941,2135413,0.06170982374613329,California
958,2016,San Bernardino,female,34056,1062472,1072941,2135413,0.03174079469420965,California
960,2009,San Diego,female,55671,1661931,1640902,3302833,0.033927071817817275,California
962,2010,San Diego,female,113438,1661931,1640902,3302833,0.06913148987569032,California
964,2011,San Diego,female,112873,1661931,1640902,3302833,0.06878716705811803,California
966,2012,San Diego,female,103379,1661931,1640902,3302833,0.0630013248810715,California
968,2013,San Diego,female,103567,1661931,1640902,3302833,0.06311589601329025,California
970,2014,San Diego,female,102376,1661931,1640902,3302833,0.06239007570226619,California
972,2015,San Diego,female,94726,1661931,1640902,3302833,0.05772800569442904,California
974,2016,San Diego,female,40741,1661931,1640902,3302833,0.02482841754108411,California
976,2009,San Francisco,female,8690,443970,426074,870044,0.020395518149429442,California
978,2010,San Francisco,female,20217,443970,426074,870044,0.04744950407675662,California
980,2011,San Francisco,female,21374,443970,426074,870044,0.050164994813107586,California
982,2012,San Francisco,female,19360,443970,426074,870044,0.04543811638353901,California
984,2013,San Francisco,female,19522,443970,426074,870044,0.04581833202683102,California
986,2014,San Francisco,female,17282,443970,426074,870044,0.04056102930476865,California
988,2015,San Francisco,female,17238,443970,426074,870044,0.04045776085844243,California
990,2016,San Francisco,female,6360,443970,426074,870044,0.014926984514427071,California
992,2009,San Joaquin,female,16473,364612,367600,732212,0.044812295973884655,California
994,2010,San Joaquin,female,29443,364612,367600,732212,0.08009521218715995,California
996,2011,San Joaquin,female,26573,364612,367600,732212,0.07228781284004353,California
998,2012,San Joaquin,female,23775,364612,367600,732212,0.06467627856365615,California
1000,2013,San Joaquin,female,23645,364612,367600,732212,0.06432263329706202,California
1002,2014,San Joaquin,female,22038,364612,367600,732212,0.059951033732317735,California
1004,2015,San Joaquin,female,23069,364612,367600,732212,0.0627557127312296,California
1006,2016,San Joaquin,female,11091,364612,367600,732212,0.030171381936887922,California
1008,2009,San Luis Obispo,female,8749,142769,138686,281455,0.06308495450153584,California
1010,2010,San Luis Obispo,female,16543,142769,138686,281455,0.11928384984785775,California
1012,2011,San Luis Obispo,female,15418,142769,138686,281455,0.11117200005768427,California
1014,2012,San Luis Obispo,female,15470,142769,138686,281455,0.11154694778131895,California
1016,2013,San Luis Obispo,female,13041,142769,138686,281455,0.09403256276769105,California
1018,2014,San Luis Obispo,female,13138,142769,138686,281455,0.09473198448293267,California
1020,2015,San Luis Obispo,female,15856,142769,138686,281455,0.11433021357599181,California
1022,2016,San Luis Obispo,female,7788,142769,138686,281455,0.05615563214744098,California
1024,2009,San Mateo,female,10857,377851,388084,765935,0.027975902124282373,California
1026,2010,San Mateo,female,22550,377851,388084,765935,0.05810597705651354,California
1028,2011,San Mateo,female,25115,377851,388084,765935,0.0647153708990837,California
1030,2012,San Mateo,female,22481,377851,388084,765935,0.0579281804970058,California
1032,2013,San Mateo,female,22498,377851,388084,765935,0.057971985446449735,California
1034,2014,San Mateo,female,21166,377851,388084,765935,0.05453973881943085,California
1036,2015,San Mateo,female,17355,377851,388084,765935,0.044719699858793455,California
1038,2016,San Mateo,female,7650,377851,388084,765935,0.019712227249770668,California
1040,2009,Santa Barbara,female,31167,222208,221530,443738,0.14068974856678554,California
1042,2010,Santa Barbara,female,61009,222208,221530,443738,0.27539836590980904,California
1044,2011,Santa Barbara,female,62624,222208,221530,443738,0.2826885749108473,California
1046,2012,Santa Barbara,female,58418,222208,221530,443738,0.26370243307904123,California
1048,2013,Santa Barbara,female,54803,222208,221530,443738,0.24738410147609805,California
1050,2014,Santa Barbara,female,54552,222208,221530,443738,0.246251072089559,California
1052,2015,Santa Barbara,female,52365,222208,221530,443738,0.23637882002437594,California
1054,2016,Santa Barbara,female,25401,222208,221530,443738,0.1146616711054936,California
1056,2009,Santa Clara,female,17077,970469,951731,1922200,0.017943095265363848,California
1058,2010,Santa Clara,female,33366,970469,951731,1922200,0.03505822548598291,California
1060,2011,Santa Clara,female,38515,970469,951731,1922200,0.04046836763749421,California
1062,2012,Santa Clara,female,37118,970469,951731,1922200,0.03900051590207737,California
1064,2013,Santa Clara,female,31067,970469,951731,1922200,0.032642626960769375,California
1066,2014,Santa Clara,female,28539,970469,951731,1922200,0.029986414228390164,California
1068,2015,Santa Clara,female,26203,970469,951731,1922200,0.027531939171887856,California
1070,2016,Santa Clara,female,13713,970469,951731,1922200,0.014408483069270624,California
1072,2009,Santa Cruz,female,7634,22285,24299,46584,0.31416930737890447,California
1073,2009,Santa Cruz,female,7634,135727,138038,273765,0.05530361204885611,California
1076,2010,Santa Cruz,female,17169,22285,24299,46584,0.7065722869253879,California
1077,2010,Santa Cruz,female,17169,135727,138038,273765,0.12437879424506296,California
1080,2011,Santa Cruz,female,17322,22285,24299,46584,0.7128688423391909,California
1081,2011,Santa Cruz,female,17322,135727,138038,273765,0.12548718468827424,California
1084,2012,Santa Cruz,female,16696,22285,24299,46584,0.6871064652866373,California
1085,2012,Santa Cruz,female,16696,135727,138038,273765,0.12095220156768426,California
1088,2013,Santa Cruz,female,16304,22285,24299,46584,0.6709741141610766,California
1089,2013,Santa Cruz,female,16304,135727,138038,273765,0.11811240383082919,California
1092,2014,Santa Cruz,female,13657,22285,24299,46584,0.5620395901065888,California
1093,2014,Santa Cruz,female,13657,135727,138038,273765,0.0989365247250757,California
1096,2015,Santa Cruz,female,13908,22285,24299,46584,0.572369233301782,California
1097,2015,Santa Cruz,female,13908,135727,138038,273765,0.10075486460250076,California
1100,2016,Santa Cruz,female,6126,22285,24299,46584,0.25210914029383924,California
1101,2016,Santa Cruz,female,6126,135727,138038,273765,0.04437908402034223,California
1104,2009,Shasta,female,6275,87859,91226,179085,0.06878521474141144,California
1106,2010,Shasta,female,13057,87859,91226,179085,0.14312805559818473,California
1108,2011,Shasta,female,11485,87859,91226,179085,0.12589612610440007,California
1110,2012,Shasta,female,11379,87859,91226,179085,0.12473417666016268,California
1112,2013,Shasta,female,10014,87859,91226,179085,0.10977133711880385,California
1114,2014,Shasta,female,10050,87859,91226,179085,0.11016596145835617,California
1116,2015,Shasta,female,10269,87859,91226,179085,0.11256659285729946,California
1118,2016,Shasta,female,4809,87859,91226,179085,0.05271523469186416,California
1120,2009,Sierra,female,4400,1542,1388,2930,3.170028818443804,California
1121,2009,Sierra,female,4400,5516,5619,11135,0.7830574835379961,California
1124,2010,Sierra,female,7457,1542,1388,2930,5.372478386167147,California
1125,2010,Sierra,female,7457,5516,5619,11135,1.3271044669870085,California
1128,2011,Sierra,female,6314,1542,1388,2930,4.5489913544668585,California
1129,2011,Sierra,female,6314,5516,5619,11135,1.1236874888770243,California
1132,2012,Sierra,female,5885,1542,1388,2930,4.239913544668588,California
1133,2012,Sierra,female,5885,5516,5619,11135,1.0473393842320697,California
1136,2013,Sierra,female,5762,1542,1388,2930,4.151296829971182,California
1137,2013,Sierra,female,5762,5516,5619,11135,1.0254493682149848,California
1140,2014,Sierra,female,6229,1542,1388,2930,4.487752161383285,California
1141,2014,Sierra,female,6229,5516,5619,11135,1.1085602420359495,California
1144,2015,Sierra,female,6022,1542,1388,2930,4.338616714697406,California
1145,2015,Sierra,female,6022,5516,5619,11135,1.0717209467876847,California
1148,2016,Sierra,female,2218,1542,1388,2930,1.5979827089337175,California
1149,2016,Sierra,female,2218,5516,5619,11135,0.39473215874710804,California
1152,2009,Siskiyou,female,4936,21706,21834,43540,0.22606943299441237,California
1154,2010,Siskiyou,female,10217,21706,21834,43540,0.46793991023174863,California
1156,2011,Siskiyou,female,9598,21706,21834,43540,0.43958963085096636,California
1158,2012,Siskiyou,female,7640,21706,21834,43540,0.34991297975634333,California
1160,2013,Siskiyou,female,8883,21706,21834,43540,0.4068425391591097,California
1162,2014,Siskiyou,female,7836,21706,21834,43540,0.3588898048914537,California
1164,2015,Siskiyou,female,7587,21706,21834,43540,0.3474855729596043,California
1166,2016,Siskiyou,female,3340,21706,21834,43540,0.1529724283227993,California
1168,2009,Solano,female,10930,217931,220599,438530,0.049546915443859675,California
1170,2010,Solano,female,23391,217931,220599,438530,0.10603402553955367,California
1172,2011,Solano,female,22401,217931,220599,438530,0.10154624454326629,California
1174,2012,Solano,female,20056,217931,220599,438530,0.0909160966278179,California
1176,2013,Solano,female,20288,217931,220599,438530,0.09196777863906908,California
1178,2014,Solano,female,16479,217931,220599,438530,0.07470115458365632,California
1180,2015,Solano,female,17653,217931,220599,438530,0.0800230282095567,California
1182,2016,Solano,female,8805,217931,220599,438530,0.03991405219425292,California
1184,2009,Sonoma,female,10952,245196,256121,501317,0.04276103872778882,California
1186,2010,Sonoma,female,25131,245196,256121,501317,0.09812159096676962,California
1188,2011,Sonoma,female,24465,245196,256121,501317,0.0955212575306203,California
1190,2012,Sonoma,female,20572,245196,256121,501317,0.08032141058327899,California
1192,2013,Sonoma,female,17500,245196,256121,501317,0.06832707977869835,California
1194,2014,Sonoma,female,17867,245196,256121,501317,0.06975999625177162,California
1196,2015,Sonoma,female,18068,245196,256121,501317,0.07054478156808695,California
1198,2016,Sonoma,female,8374,245196,256121,501317,0.03269548377524686,California
1200,2009,Stanislaus,female,8900,266844,272457,539301,0.03266570504703494,California
1202,2010,Stanislaus,female,17730,266844,272457,539301,0.06507448881841905,California
1204,2011,Stanislaus,female,16557,266844,272457,539301,0.060769222299298604,California
1206,2012,Stanislaus,female,14151,266844,272457,539301,0.05193847102478556,California
1208,2013,Stanislaus,female,13443,266844,272457,539301,0.04933989583677424,California
1210,2014,Stanislaus,female,12434,266844,272457,539301,0.045636559163464326,California
1212,2015,Stanislaus,female,11789,266844,272457,539301,0.04326921312353876,California
1214,2016,Stanislaus,female,5854,266844,272457,539301,0.02148595925228568,California
1216,2009,Sutter,female,3787,47789,48083,95872,0.0787596447808997,California
1218,2010,Sutter,female,8428,47789,48083,95872,0.17528024457708546,California
1220,2011,Sutter,female,7876,47789,48083,95872,0.16380009566790757,California
1222,2012,Sutter,female,7694,47789,48083,95872,0.16001497410727283,California
1224,2013,Sutter,female,8261,47789,48083,95872,0.1718070835846349,California
1226,2014,Sutter,female,9531,47789,48083,95872,0.19821974502422893,California
1228,2015,Sutter,female,8731,47789,48083,95872,0.18158184805440591,California
1230,2016,Sutter,female,3265,47789,48083,95872,0.06790341700809017,California
1232,2009,Tehama,female,3228,31504,31869,63373,0.10128965452320436,California
1234,2010,Tehama,female,6141,31504,31869,63373,0.19269509554739717,California
1236,2011,Tehama,female,6315,31504,31869,63373,0.19815494681351783,California
1238,2012,Tehama,female,5507,31504,31869,63373,0.17280115472716434,California
1240,2013,Tehama,female,4718,31504,31869,63373,0.14804355329630675,California
1242,2014,Tehama,female,5228,31504,31869,63373,0.1640465656280398,California
1244,2015,Tehama,female,5354,31504,31869,63373,0.16800025102764443,California
1246,2016,Tehama,female,2234,31504,31869,63373,0.07009946970410116,California
1248,2009,Trinity,female,1607,6582,6280,12862,0.25589171974522296,California
1249,2009,Trinity,female,1607,7011,7558,14569,0.21262238687483462,California
1252,2010,Trinity,female,2714,6582,6280,12862,0.4321656050955414,California
1253,2010,Trinity,female,2714,7011,7558,14569,0.3590897062715004,California
1256,2011,Trinity,female,2392,6582,6280,12862,0.38089171974522296,California
1257,2011,Trinity,female,2392,7011,7558,14569,0.3164858428155597,California
1260,2012,Trinity,female,1868,6582,6280,12862,0.29745222929936305,California
1261,2012,Trinity,female,1868,7011,7558,14569,0.24715533209843873,California
1264,2013,Trinity,female,1927,6582,6280,12862,0.3068471337579618,California
1265,2013,Trinity,female,1927,7011,7558,14569,0.25496163006086264,California
1268,2014,Trinity,female,1860,6582,6280,12862,0.2961783439490446,California
1269,2014,Trinity,female,1860,7011,7558,14569,0.24609685101878803,California
1272,2015,Trinity,female,1887,6582,6280,12862,0.30047770700636944,California
1273,2015,Trinity,female,1887,7011,7558,14569,0.24966922466260916,California
1276,2016,Trinity,female,870,6582,6280,12862,0.13853503184713375,California
1277,2016,Trinity,female,870,7011,7558,14569,0.11510981741201376,California
1280,2009,Tulare,female,9995,230255,230222,460477,0.043414617195576446,California
1282,2010,Tulare,female,19840,230255,230222,460477,0.08617768936070401,California
1284,2011,Tulare,female,20284,230255,230222,460477,0.08810626265083267,California
1286,2012,Tulare,female,20956,230255,230222,460477,0.09102518438724362,California
1288,2013,Tulare,female,19862,230255,230222,460477,0.08627324929850319,California
1290,2014,Tulare,female,17799,230255,230222,460477,0.07731233331306304,California
1292,2015,Tulare,female,17285,230255,230222,460477,0.07507970567539157,California
1294,2016,Tulare,female,8380,230255,230222,460477,0.036399649034410266,California
1296,2009,Tuolumne,female,2582,28102,25830,53932,0.09996128532713898,California
1298,2010,Tuolumne,female,5842,28102,25830,53932,0.22617111885404567,California
1300,2011,Tuolumne,female,5306,28102,25830,53932,0.20542005420054202,California
1302,2012,Tuolumne,female,5055,28102,25830,53932,0.1957026713124274,California
1304,2013,Tuolumne,female,5571,28102,25830,53932,0.2156794425087108,California
1306,2014,Tuolumne,female,5067,28102,25830,53932,0.19616724738675959,California
1308,2015,Tuolumne,female,5214,28102,25830,53932,0.20185830429732868,California
1310,2016,Tuolumne,female,2593,28102,25830,53932,0.10038714672861014,California
1312,2009,Yolo,female,3393,104375,110602,214977,0.03067756460100179,California
1314,2010,Yolo,female,5878,104375,110602,214977,0.0531455127393718,California
1316,2011,Yolo,female,6502,104375,110602,214977,0.05878736370047558,California
1318,2012,Yolo,female,7150,104375,110602,214977,0.06464620892931412,California
1320,2013,Yolo,female,8325,104375,110602,214977,0.07526988662049511,California
1322,2014,Yolo,female,7270,104375,110602,214977,0.06573118026798792,California
1324,2015,Yolo,female,6691,104375,110602,214977,0.06049619355888682,California
1326,2016,Yolo,female,3224,104375,110602,214977,0.029149563299036185,California
1,2009,Alameda,male,79651,807171,836529,1643700,0.09867921419377058,California
3,2010,Alameda,male,169080,807171,836529,1643700,0.20947234229178205,California
5,2011,Alameda,male,193958,807171,836529,1643700,0.24029356852513284,California
7,2012,Alameda,male,171618,807171,836529,1643700,0.21261665743689998,California
9,2013,Alameda,male,179918,807171,836529,1643700,0.2228994847436293,California
11,2014,Alameda,male,164692,807171,836529,1643700,0.20403607166263407,California
13,2015,Alameda,male,166939,807171,836529,1643700,0.20681986840458838,California
15,2016,Alameda,male,79270,807171,836529,1643700,0.09820719525354603,California
17,2009,Alpine,male,5210,612,534,1146,8.513071895424837,California
19,2010,Alpine,male,9480,612,534,1146,15.490196078431373,California
21,2011,Alpine,male,10916,612,534,1146,17.836601307189543,California
23,2012,Alpine,male,9935,612,534,1146,16.233660130718953,California
25,2013,Alpine,male,9524,612,534,1146,15.562091503267974,California
27,2014,Alpine,male,9197,612,534,1146,15.027777777777779,California
29,2015,Alpine,male,9014,612,534,1146,14.72875816993464,California
31,2016,Alpine,male,4270,612,534,1146,6.977124183006536,California
33,2009,Amador,male,4773,20302,17527,37829,0.23509999014875382,California
35,2010,Amador,male,10182,20302,17527,37829,0.5015269431583095,California
37,2011,Amador,male,10954,20302,17527,37829,0.539552753423308,California
39,2012,Amador,male,7739,20302,17527,37829,0.3811939710373362,California
41,2013,Amador,male,7761,20302,17527,37829,0.38227760811742684,California
43,2014,Amador,male,7562,20302,17527,37829,0.37247561816569796,California
45,2015,Amador,male,6562,20302,17527,37829,0.32321938725248744,California
47,2016,Amador,male,4189,20302,17527,37829,0.20633435129543887,California
51,2009,Butte,male,11053,112513,114562,227075,0.09823753699572493,California
52,2009,Butte,male,11053,1342,1260,2602,8.236214605067063,California
53,2009,Butte,male,11053,5083,5094,10177,2.1745032461144995,California
57,2010,Butte,male,24560,112513,114562,227075,0.21828588696417303,California
58,2010,Butte,male,24560,1342,1260,2602,18.301043219076007,California
59,2010,Butte,male,24560,5083,5094,10177,4.831792248672044,California
63,2011,Butte,male,22484,112513,114562,227075,0.1998346857696444,California
64,2011,Butte,male,22484,1342,1260,2602,16.75409836065574,California
65,2011,Butte,male,22484,5083,5094,10177,4.423372024395042,California
69,2012,Butte,male,20201,112513,114562,227075,0.17954369717277113,California
70,2012,Butte,male,20201,1342,1260,2602,15.052906110283159,California
71,2012,Butte,male,20201,5083,5094,10177,3.974227818217588,California
75,2013,Butte,male,19936,112513,114562,227075,0.17718841378329614,California
76,2013,Butte,male,19936,1342,1260,2602,14.855439642324889,California
77,2013,Butte,male,19936,5083,5094,10177,3.9220932520165257,California
81,2014,Butte,male,17941,112513,114562,227075,0.15945712939838064,California
82,2014,Butte,male,17941,1342,1260,2602,13.368852459016393,California
83,2014,Butte,male,17941,5083,5094,10177,3.5296084989179617,California
87,2015,Butte,male,18952,112513,114562,227075,0.1684427577257739,California
88,2015,Butte,male,18952,1342,1260,2602,14.12220566318927,California
89,2015,Butte,male,18952,5083,5094,10177,3.728506787330317,California
93,2016,Butte,male,9145,112513,114562,227075,0.08127949659150498,California
94,2016,Butte,male,9145,1342,1260,2602,6.8144560357675115,California
95,2016,Butte,male,9145,5083,5094,10177,1.7991343694668502,California
97,2009,Calaveras,male,6266,22434,22801,45235,0.2793081929214585,California
99,2010,Calaveras,male,12499,22434,22801,45235,0.5571454042970492,California
101,2011,Calaveras,male,11467,22434,22801,45235,0.5111437995899082,California
103,2012,Calaveras,male,9597,22434,22801,45235,0.42778817865739505,California
105,2013,Calaveras,male,7422,22434,22801,45235,0.3308371222251939,California
107,2014,Calaveras,male,6076,22434,22801,45235,0.2708389052331283,California
109,2015,Calaveras,male,6905,22434,22801,45235,0.3077917446732638,California
111,2016,Calaveras,male,3222,22434,22801,45235,0.14362128911473657,California
113,2009,Colusa,male,5349,11124,10340,21464,0.4808522114347357,California
115,2010,Colusa,male,11833,11124,10340,21464,1.0637360661632507,California
117,2011,Colusa,male,12263,11124,10340,21464,1.1023912261776339,California
119,2012,Colusa,male,10827,11124,10340,21464,0.9733009708737864,California
121,2013,Colusa,male,7845,11124,10340,21464,0.7052319309600863,California
123,2014,Colusa,male,8102,11124,10340,21464,0.7283351312477526,California
125,2015,Colusa,male,11366,11124,10340,21464,1.021754764473211,California
127,2016,Colusa,male,5804,11124,10340,21464,0.5217547644732111,California
129,2009,Contra Costa,male,18016,553701,579546,1133247,0.032537416403437956,California
131,2010,Contra Costa,male,42291,553701,579546,1133247,0.07637876760200903,California
133,2011,Contra Costa,male,43871,553701,579546,1133247,0.0792322932412981,California
135,2012,Contra Costa,male,38898,553701,579546,1133247,0.07025091159308001,California
137,2013,Contra Costa,male,38300,553701,579546,1133247,0.06917090631947567,California
139,2014,Contra Costa,male,32138,553701,579546,1133247,0.05804215632624828,California
141,2015,Contra Costa,male,29116,553701,579546,1133247,0.05258433703388652,California
143,2016,Contra Costa,male,12327,553701,579546,1133247,0.022262918073111662,California
145,2009,Del Norte,male,3591,14575,12849,27424,0.24638078902229846,California
147,2010,Del Norte,male,6500,14575,12849,27424,0.44596912521440824,California
149,2011,Del Norte,male,7019,14575,12849,27424,0.4815780445969125,California
151,2012,Del Norte,male,6112,14575,12849,27424,0.41934819897084047,California
153,2013,Del Norte,male,6094,14575,12849,27424,0.4181132075471698,California
155,2014,Del Norte,male,6190,14575,12849,27424,0.42469982847341337,California
157,2015,Del Norte,male,7026,14575,12849,27424,0.4820583190394511,California
159,2016,Del Norte,male,3450,14575,12849,27424,0.2367066895368782,California
161,2009,El Dorado,male,8472,93040,93621,186661,0.09105760963026656,California
163,2010,El Dorado,male,15346,93040,93621,186661,0.16493981083404988,California
165,2011,El Dorado,male,15651,93040,93621,186661,0.16821797076526226,California
167,2012,El Dorado,male,15884,93040,93621,186661,0.17072226999140155,California
169,2013,El Dorado,male,17283,93040,93621,186661,0.18575881341358555,California
171,2014,El Dorado,male,14565,93040,93621,186661,0.15654557179707654,California
173,2015,El Dorado,male,12460,93040,93621,186661,0.13392089423903697,California
175,2016,El Dorado,male,6002,93040,93621,186661,0.06450988822012038,California
177,2009,Fresno,male,34882,487936,490194,978130,0.07148888378803778,California
179,2010,Fresno,male,72827,487936,490194,978130,0.14925523019412382,California
181,2011,Fresno,male,71685,487936,490194,978130,0.14691475931269674,California
183,2012,Fresno,male,72105,487936,490194,978130,0.14777552793809023,California
185,2013,Fresno,male,62013,487936,490194,978130,0.12709248753934943,California
187,2014,Fresno,male,49136,487936,490194,978130,0.1007017313746065,California
189,2015,Fresno,male,51610,487936,490194,978130,0.1057720684679958,California
191,2016,Fresno,male,29248,487936,490194,978130,0.05994228751311648,California
193,2009,Glenn,male,6680,14171,13726,27897,0.4713852233434479,California
195,2010,Glenn,male,13799,14171,13726,27897,0.9737492061251852,California
197,2011,Glenn,male,10927,14171,13726,27897,0.7710817867475831,California
199,2012,Glenn,male,9739,14171,13726,27897,0.6872486063086586,California
201,2013,Glenn,male,10617,14171,13726,27897,0.7492061251852374,California
203,2014,Glenn,male,9699,14171,13726,27897,0.6844259403006139,California
205,2015,Glenn,male,9063,14171,13726,27897,0.6395455507727048,California
207,2016,Glenn,male,3758,14171,13726,27897,0.26518947145578997,California
211,2009,Humboldt,male,7919,67666,68102,135768,0.11703070966216415,California
212,2009,Humboldt,male,7919,4651,4915,9566,1.7026445925607396,California
213,2009,Humboldt,male,7919,8779,8125,16904,0.9020389566009797,California
217,2010,Humboldt,male,14179,67666,68102,135768,0.209543936393462,California
218,2010,Humboldt,male,14179,4651,4915,9566,3.0485917007095247,California
219,2010,Humboldt,male,14179,8779,8125,16904,1.615104225993849,California
223,2011,Humboldt,male,13870,67666,68102,135768,0.2049773889397925,California
224,2011,Humboldt,male,13870,4651,4915,9566,2.982154375403139,California
225,2011,Humboldt,male,13870,8779,8125,16904,1.5799065952842009,California
229,2012,Humboldt,male,11265,67666,68102,135768,0.16647947270416458,California
230,2012,Humboldt,male,11265,4651,4915,9566,2.422059772092023,California
231,2012,Humboldt,male,11265,8779,8125,16904,1.2831757603371683,California
235,2013,Humboldt,male,10280,67666,68102,135768,0.15192267904117282,California
236,2013,Humboldt,male,10280,4651,4915,9566,2.21027735970759,California
237,2013,Humboldt,male,10280,8779,8125,16904,1.1709761931882903,California
241,2014,Humboldt,male,11128,67666,68102,135768,0.1644548222149972,California
242,2014,Humboldt,male,11128,4651,4915,9566,2.3926037411309395,California
243,2014,Humboldt,male,11128,8779,8125,16904,1.2675703383073242,California
247,2015,Humboldt,male,12201,67666,68102,135768,0.1803121213016877,California
248,2015,Humboldt,male,12201,4651,4915,9566,2.623306815738551,California
249,2015,Humboldt,male,12201,8779,8125,16904,1.389793826176102,California
253,2016,Humboldt,male,6637,67666,68102,135768,0.0980847101941891,California
254,2016,Humboldt,male,6637,4651,4915,9566,1.427004945173081,California
255,2016,Humboldt,male,6637,8779,8125,16904,0.7560086570224399,California
257,2009,Imperial,male,29552,92250,87966,180216,0.32034688346883466,California
259,2010,Imperial,male,58739,92250,87966,180216,0.6367371273712737,California
261,2011,Imperial,male,57515,92250,87966,180216,0.6234688346883469,California
263,2012,Imperial,male,50521,92250,87966,180216,0.5476531165311653,California
265,2013,Imperial,male,56406,92250,87966,180216,0.6114471544715447,California
267,2014,Imperial,male,59945,92250,87966,180216,0.6498102981029811,California
269,2015,Imperial,male,61310,92250,87966,180216,0.6646070460704607,California
271,2016,Imperial,male,25654,92250,87966,180216,0.2780921409214092,California
273,2009,Inyo,male,8356,9084,9001,18085,0.9198590929106121,California
275,2010,Inyo,male,16572,9084,9001,18085,1.8243064729194187,California
277,2011,Inyo,male,16132,9084,9001,18085,1.7758696609423161,California
279,2012,Inyo,male,12513,9084,9001,18085,1.3774768824306474,California
281,2013,Inyo,male,12844,9084,9001,18085,1.4139145750770585,California
283,2014,Inyo,male,11988,9084,9001,18085,1.3196829590488772,California
285,2015,Inyo,male,13584,9084,9001,18085,1.4953764861294583,California
287,2016,Inyo,male,8927,9084,9001,18085,0.9827168648172612,California
289,2009,Kern,male,84853,452646,430407,883053,0.18745995767111606,California
291,2010,Kern,male,171952,452646,430407,883053,0.3798818502759331,California
293,2011,Kern,male,170436,452646,430407,883053,0.37653265465728186,California
295,2012,Kern,male,153114,452646,430407,883053,0.33826433901989633,California
297,2013,Kern,male,142242,452646,430407,883053,0.3142455693853475,California
299,2014,Kern,male,133242,452646,430407,883053,0.2943624819395289,California
301,2015,Kern,male,126822,452646,430407,883053,0.280179212894845,California
303,2016,Kern,male,63362,452646,430407,883053,0.1399813540824397,California
306,2009,Kings,male,7922,82674,67401,150075,0.09582214480973462,California
307,2009,Kings,male,7922,1231912,1368835,2600747,0.006430654137633208,California
310,2010,Kings,male,17763,82674,67401,150075,0.21485594019885332,California
311,2010,Kings,male,17763,1231912,1368835,2600747,0.014419049412620382,California
314,2011,Kings,male,17130,82674,67401,150075,0.20719936134697728,California
315,2011,Kings,male,17130,1231912,1368835,2600747,0.013905214008792835,California
318,2012,Kings,male,15466,82674,67401,150075,0.18707211457048165,California
319,2012,Kings,male,15466,1231912,1368835,2600747,0.012554468176298307,California
322,2013,Kings,male,16449,82674,67401,150075,0.19896218883808695,California
323,2013,Kings,male,16449,1231912,1368835,2600747,0.0133524147828741,California
326,2014,Kings,male,14828,82674,67401,150075,0.17935505721266662,California
327,2014,Kings,male,14828,1231912,1368835,2600747,0.012036574041002928,California
330,2015,Kings,male,12871,82674,67401,150075,0.1556837699881462,California
331,2015,Kings,male,12871,1231912,1368835,2600747,0.010447986544493438,California
334,2016,Kings,male,5314,82674,67401,150075,0.06427655611195782,California
335,2016,Kings,male,5314,1231912,1368835,2600747,0.0043136198040119745,California
348,2009,Lake,male,5041,31879,32269,64148,0.15812917594654788,California
349,2009,Lake,male,5041,4176,3409,7585,1.2071360153256705,California
350,2009,Lake,male,5041,162402,172960,335362,0.03104025812489994,California
351,2009,Lake,male,5041,351343,352276,703619,0.014347802574691967,California
352,2009,Lake,male,5041,235515,251334,486849,0.021404156847759166,California
353,2009,Lake,male,5041,6000,5763,11763,0.8401666666666666,California
354,2009,Lake,male,5041,5428,5141,10569,0.9287030213706706,California
355,2009,Lake,male,5041,14744,15030,29774,0.34190179055887143,California
356,2009,Lake,male,5041,112379,117673,230052,0.04485713522989171,California
357,2009,Lake,male,5041,4192,3651,7843,1.2025286259541985,California
358,2009,Lake,male,5041,6569,6005,12574,0.7673922971532958,California
359,2009,Lake,male,5041,4642,2884,7526,1.0859543300301595,California
372,2010,Lake,male,10214,31879,32269,64148,0.3203990087518429,California
373,2010,Lake,male,10214,4176,3409,7585,2.44588122605364,California
374,2010,Lake,male,10214,162402,172960,335362,0.06289331412174727,California
375,2010,Lake,male,10214,351343,352276,703619,0.029071306387205665,California
376,2010,Lake,male,10214,235515,251334,486849,0.043368787550686794,California
377,2010,Lake,male,10214,6000,5763,11763,1.7023333333333333,California
378,2010,Lake,male,10214,5428,5141,10569,1.8817243920412674,California
379,2010,Lake,male,10214,14744,15030,29774,0.6927563754747694,California
380,2010,Lake,male,10214,112379,117673,230052,0.09088886713709857,California
381,2010,Lake,male,10214,4192,3651,7843,2.4365458015267176,California
382,2010,Lake,male,10214,6569,6005,12574,1.554878977013244,California
383,2010,Lake,male,10214,4642,2884,7526,2.2003446790176646,California
396,2011,Lake,male,8280,31879,32269,64148,0.25973211204868407,California
397,2011,Lake,male,8280,4176,3409,7585,1.9827586206896552,California
398,2011,Lake,male,8280,162402,172960,335362,0.050984593785790816,California
399,2011,Lake,male,8280,351343,352276,703619,0.023566714008817595,California
400,2011,Lake,male,8280,235515,251334,486849,0.03515699636965798,California
401,2011,Lake,male,8280,6000,5763,11763,1.38,California
402,2011,Lake,male,8280,5428,5141,10569,1.5254237288135593,California
403,2011,Lake,male,8280,14744,15030,29774,0.561584373304395,California
404,2011,Lake,male,8280,112379,117673,230052,0.0736792461224962,California
405,2011,Lake,male,8280,4192,3651,7843,1.9751908396946565,California
406,2011,Lake,male,8280,6569,6005,12574,1.2604658243263815,California
407,2011,Lake,male,8280,4642,2884,7526,1.7837139164153382,California
420,2012,Lake,male,6547,31879,32269,64148,0.20537030647134477,California
421,2012,Lake,male,6547,4176,3409,7585,1.5677681992337165,California
422,2012,Lake,male,6547,162402,172960,335362,0.040313542936663345,California
423,2012,Lake,male,6547,351343,352276,703619,0.018634212151658065,California
424,2012,Lake,male,6547,235515,251334,486849,0.027798654013544786,California
425,2012,Lake,male,6547,6000,5763,11763,1.0911666666666666,California
426,2012,Lake,male,6547,5428,5141,10569,1.2061532792925571,California
427,2012,Lake,male,6547,14744,15030,29774,0.44404503526858385,California
428,2012,Lake,male,6547,112379,117673,230052,0.05825821550289645,California
429,2012,Lake,male,6547,4192,3651,7843,1.5617843511450382,California
430,2012,Lake,male,6547,6569,6005,12574,0.9966509362155579,California
431,2012,Lake,male,6547,4642,2884,7526,1.4103834554071522,California
444,2013,Lake,male,7185,31879,32269,64148,0.2253834812886226,California
445,2013,Lake,male,7185,4176,3409,7585,1.7205459770114941,California
446,2013,Lake,male,7185,162402,172960,335362,0.04424206598440906,California
447,2013,Lake,male,7185,351343,352276,703619,0.02045010146779643,California
448,2013,Lake,male,7185,235515,251334,486849,0.030507610980192345,California
449,2013,Lake,male,7185,6000,5763,11763,1.1975,California
450,2013,Lake,male,7185,5428,5141,10569,1.3236919675755343,California
451,2013,Lake,male,7185,14744,15030,29774,0.48731687466087903,California
452,2013,Lake,male,7185,112379,117673,230052,0.06393543277658638,California
453,2013,Lake,male,7185,4192,3651,7843,1.7139790076335877,California
454,2013,Lake,male,7185,6569,6005,12574,1.0937737859643781,California
455,2013,Lake,male,7185,4642,2884,7526,1.547824213700991,California
468,2014,Lake,male,7734,31879,32269,64148,0.24260484958750275,California
469,2014,Lake,male,7734,4176,3409,7585,1.8520114942528736,California
470,2014,Lake,male,7734,162402,172960,335362,0.04762256622455389,California
471,2014,Lake,male,7734,351343,352276,703619,0.022012677070554983,California
472,2014,Lake,male,7734,235515,251334,486849,0.03283867269600663,California
473,2014,Lake,male,7734,6000,5763,11763,1.289,California
474,2014,Lake,male,7734,5428,5141,10569,1.4248341930729551,California
475,2014,Lake,male,7734,14744,15030,29774,0.5245523602821487,California
476,2014,Lake,male,7734,112379,117673,230052,0.06882068713905623,California
477,2014,Lake,male,7734,4192,3651,7843,1.844942748091603,California
478,2014,Lake,male,7734,6569,6005,12574,1.17734815040341,California
479,2014,Lake,male,7734,4642,2884,7526,1.6660922016372253,California
492,2015,Lake,male,6957,31879,32269,64148,0.2182314376235139,California
493,2015,Lake,male,6957,4176,3409,7585,1.665948275862069,California
494,2015,Lake,male,6957,162402,172960,335362,0.042838142387409024,California
495,2015,Lake,male,6957,351343,352276,703619,0.019801162966104346,California
496,2015,Lake,male,6957,235515,251334,486849,0.029539519775810458,California
497,2015,Lake,male,6957,6000,5763,11763,1.1595,California
498,2015,Lake,male,6957,5428,5141,10569,1.2816875460574797,California
499,2015,Lake,male,6957,14744,15030,29774,0.47185295713510583,California
500,2015,Lake,male,6957,112379,117673,230052,0.06190658397031474,California
501,2015,Lake,male,6957,4192,3651,7843,1.6595896946564885,California
502,2015,Lake,male,6957,6569,6005,12574,1.0590653067437967,California
503,2015,Lake,male,6957,4642,2884,7526,1.498707453683757,California
516,2016,Lake,male,3609,31879,32269,64148,0.1132093227516547,California
517,2016,Lake,male,3609,4176,3409,7585,0.8642241379310345,California
518,2016,Lake,male,3609,162402,172960,335362,0.02222263272619795,California
519,2016,Lake,male,3609,351343,352276,703619,0.01027201338862593,California
520,2016,Lake,male,3609,235515,251334,486849,0.01532386472199223,California
521,2016,Lake,male,3609,6000,5763,11763,0.6015,California
522,2016,Lake,male,3609,5428,5141,10569,0.6648857774502579,California
523,2016,Lake,male,3609,14744,15030,29774,0.24477753662506782,California
524,2016,Lake,male,3609,112379,117673,230052,0.03211454097295758,California
525,2016,Lake,male,3609,4192,3651,7843,0.860925572519084,California
526,2016,Lake,male,3609,6569,6005,12574,0.5493986908205206,California
527,2016,Lake,male,3609,4642,2884,7526,0.7774666092201638,California
529,2009,Lassen,male,7021,20671,10514,31185,0.33965458855401287,California
531,2010,Lassen,male,14909,20671,10514,31185,0.7212519955493203,California
533,2011,Lassen,male,13918,20671,10514,31185,0.6733104349088095,California
535,2012,Lassen,male,11155,20671,10514,31185,0.5396449131633689,California
537,2013,Lassen,male,11763,20671,10514,31185,0.5690581007208166,California
539,2014,Lassen,male,9839,20671,10514,31185,0.4759808427265251,California
541,2015,Lassen,male,11468,20671,10514,31185,0.5547868995210682,California
543,2016,Lassen,male,6156,20671,10514,31185,0.29780852401915725,California
545,2009,Los Angeles,male,308960,4976788,5121264,10098052,0.062080201125705975,California
547,2010,Los Angeles,male,636813,4976788,5121264,10098052,0.1279566258397987,California
549,2011,Los Angeles,male,650557,4976788,5121264,10098052,0.13071824638702714,California
551,2012,Los Angeles,male,594609,4976788,5121264,10098052,0.11947645750632738,California
553,2013,Los Angeles,male,585023,4976788,5121264,10098052,0.11755031558507213,California
555,2014,Los Angeles,male,547649,4976788,5121264,10098052,0.11004065272621619,California
557,2015,Los Angeles,male,512739,4976788,5121264,10098052,0.1030260883123814,California
559,2016,Los Angeles,male,239367,4976788,5121264,10098052,0.04809668404601522,California
561,2009,Madera,male,12914,74683,80330,155013,0.1729175314328562,California
563,2010,Madera,male,23604,74683,80330,155013,0.31605586278001685,California
565,2011,Madera,male,20385,74683,80330,155013,0.27295368423871563,California
567,2012,Madera,male,18696,74683,80330,155013,0.25033809568442617,California
569,2013,Madera,male,15003,74683,80330,155013,0.20088909122558013,California
571,2014,Madera,male,14622,74683,80330,155013,0.19578752862097132,California
573,2015,Madera,male,17934,74683,80330,155013,0.24013497047520854,California
575,2016,Madera,male,9994,74683,80330,155013,0.13381894139228473,California
577,2009,Marin,male,20004,127113,133182,260295,0.15737178730735646,California
579,2010,Marin,male,36713,127113,133182,260295,0.288821757019345,California
581,2011,Marin,male,35282,127113,133182,260295,0.277564057177472,California
583,2012,Marin,male,34139,127113,133182,260295,0.26857205793270555,California
585,2013,Marin,male,36491,127113,133182,260295,0.2870752794757421,California
587,2014,Marin,male,27653,127113,133182,260295,0.21754659240203597,California
589,2015,Marin,male,28507,127113,133182,260295,0.22426502403373377,California
591,2016,Marin,male,14319,127113,133182,260295,0.11264780156238938,California
593,2009,Mariposa,male,2683,8920,8620,17540,0.3007847533632287,California
595,2010,Mariposa,male,5911,8920,8620,17540,0.6626681614349775,California
597,2011,Mariposa,male,4297,8920,8620,17540,0.48172645739910314,California
599,2012,Mariposa,male,4607,8920,8620,17540,0.5164798206278027,California
601,2013,Mariposa,male,4318,8920,8620,17540,0.4840807174887892,California
603,2014,Mariposa,male,4296,8920,8620,17540,0.48161434977578477,California
605,2015,Mariposa,male,4304,8920,8620,17540,0.48251121076233183,California
607,2016,Mariposa,male,1846,8920,8620,17540,0.2069506726457399,California
609,2009,Mendocino,male,14519,43439,43983,87422,0.33423881765234004,California
611,2010,Mendocino,male,28232,43439,43983,87422,0.6499228803609659,California
613,2011,Mendocino,male,25622,43439,43983,87422,0.5898386242777228,California
615,2012,Mendocino,male,25811,43439,43983,87422,0.5941895531665093,California
617,2013,Mendocino,male,25335,43439,43983,87422,0.5832316581873431,California
619,2014,Mendocino,male,22758,43439,43983,87422,0.5239070881005548,California
621,2015,Mendocino,male,24881,43439,43983,87422,0.5727802205391469,California
623,2016,Mendocino,male,11679,43439,43983,87422,0.2688597803816847,California
625,2009,Merced,male,32077,135816,133259,269075,0.23617983153678507,California
627,2010,Merced,male,61636,135816,133259,269075,0.4538198739471049,California
629,2011,Merced,male,50296,135816,133259,269075,0.37032455675325443,California
631,2012,Merced,male,46015,135816,133259,269075,0.33880397007716323,California
633,2013,Merced,male,46596,135816,133259,269075,0.3430818165753667,California
635,2014,Merced,male,40391,135816,133259,269075,0.29739500500677385,California
637,2015,Merced,male,40015,135816,133259,269075,0.2946265535724804,California
639,2016,Merced,male,18129,135816,133259,269075,0.1334820639688991,California
641,2009,Modoc,male,3263,4613,4325,8938,0.7073487968783871,California
643,2010,Modoc,male,5418,4613,4325,8938,1.1745068285280729,California
645,2011,Modoc,male,3820,4613,4325,8938,0.8280945154996748,California
647,2012,Modoc,male,4020,4613,4325,8938,0.8714502492954693,California
649,2013,Modoc,male,4910,4613,4325,8938,1.0643832646867548,California
651,2014,Modoc,male,4484,4613,4325,8938,0.9720355517017125,California
653,2015,Modoc,male,3580,4613,4325,8938,0.7760676349447214,California
655,2016,Modoc,male,1847,4613,4325,8938,0.40039020160416217,California
657,2009,Mono,male,4793,7341,6833,14174,0.6529083231167416,California
659,2010,Mono,male,11484,7341,6833,14174,1.5643645279934615,California
661,2011,Mono,male,12036,7341,6833,14174,1.6395586432366163,California
663,2012,Mono,male,11279,7341,6833,14174,1.5364391772238115,California
665,2013,Mono,male,9353,7341,6833,14174,1.2740771012123688,California
667,2014,Mono,male,10122,7341,6833,14174,1.3788312219043728,California
669,2015,Mono,male,11341,7341,6833,14174,1.5448848930663397,California
671,2016,Mono,male,5943,7341,6833,14174,0.8095627298733142,California
673,2009,Monterey,male,27363,220967,212245,433212,0.12383297053406164,California
675,2010,Monterey,male,55245,220967,212245,433212,0.2500147080785819,California
677,2011,Monterey,male,49122,220967,212245,433212,0.22230468803033937,California
679,2012,Monterey,male,50098,220967,212245,433212,0.22672163716754085,California
681,2013,Monterey,male,42571,220967,212245,433212,0.19265772717193064,California
683,2014,Monterey,male,40552,220967,212245,433212,0.18352061620060914,California
685,2015,Monterey,male,40997,220967,212245,433212,0.18553449157566515,California
687,2016,Monterey,male,18278,220967,212245,433212,0.08271823394443514,California
689,2009,Napa,male,7611,70082,70448,140530,0.10860135270112155,California
691,2010,Napa,male,16920,70082,70448,140530,0.24143146599697496,California
693,2011,Napa,male,16204,70082,70448,140530,0.23121486258953797,California
695,2012,Napa,male,14295,70082,70448,140530,0.20397534316943008,California
697,2013,Napa,male,16739,70082,70448,140530,0.2388487771467709,California
699,2014,Napa,male,15460,70082,70448,140530,0.22059872720527382,California
701,2015,Napa,male,17318,70082,70448,140530,0.2471105276675894,California
703,2016,Napa,male,8135,70082,70448,140530,0.11607830826745812,California
706,2009,Nevada,male,11779,4425,4015,8440,2.6619209039548024,California
707,2009,Nevada,male,11779,48889,50203,99092,0.24093354333285605,California
710,2010,Nevada,male,24366,4425,4015,8440,5.5064406779661015,California
711,2010,Nevada,male,24366,48889,50203,99092,0.49839432183108673,California
714,2011,Nevada,male,18928,4425,4015,8440,4.277514124293785,California
715,2011,Nevada,male,18928,48889,50203,99092,0.3871627564482808,California
718,2012,Nevada,male,15518,4425,4015,8440,3.5068926553672317,California
719,2012,Nevada,male,15518,48889,50203,99092,0.3174129149706478,California
722,2013,Nevada,male,19627,4425,4015,8440,4.435480225988701,California
723,2013,Nevada,male,19627,48889,50203,99092,0.40146045122624724,California
726,2014,Nevada,male,19255,4425,4015,8440,4.351412429378531,California
727,2014,Nevada,male,19255,48889,50203,99092,0.3938513776105054,California
730,2015,Nevada,male,20024,4425,4015,8440,4.525197740112994,California
731,2015,Nevada,male,20024,48889,50203,99092,0.4095808873161652,California
734,2016,Nevada,male,9000,4425,4015,8440,2.0338983050847457,California
735,2016,Nevada,male,9000,48889,50203,99092,0.18409049070343023,California
744,2009,Orange,male,77136,1562429,1601753,3164182,0.04936928334023498,California
745,2009,Orange,male,77136,648446,672748,1321194,0.1189551635756871,California
746,2009,Orange,male,77136,9727,9820,19547,7.930091497892464,California
747,2009,Orange,male,77136,189484,188743,378227,0.40708450317704925,California
748,2009,Orange,male,77136,68187,74751,142938,1.131242025606054,California
749,2009,Orange,male,77136,41630,42417,84047,1.8528945472015375,California
750,2009,Orange,male,77136,14357,14580,28937,5.372710176220659,California
751,2009,Orange,male,77136,17418,18194,35612,4.428522218394764,California
760,2010,Orange,male,157678,1562429,1601753,3164182,0.10091850573690068,California
761,2010,Orange,male,157678,648446,672748,1321194,0.24316288480459436,California
762,2010,Orange,male,157678,9727,9820,19547,16.210342346047085,California
763,2010,Orange,male,157678,189484,188743,378227,0.8321441388191088,California
764,2010,Orange,male,157678,68187,74751,142938,2.312434921612624,California
765,2010,Orange,male,157678,41630,42417,84047,3.7876050924813836,California
766,2010,Orange,male,157678,14357,14580,28937,10.982656543846208,California
767,2010,Orange,male,157678,17418,18194,35612,9.052589275462166,California
776,2011,Orange,male,170543,1562429,1601753,3164182,0.10915247988868614,California
777,2011,Orange,male,170543,648446,672748,1321194,0.2630026247366781,California
778,2011,Orange,male,170543,9727,9820,19547,17.532949521949213,California
779,2011,Orange,male,170543,189484,188743,378227,0.9000390534293133,California
780,2011,Orange,male,170543,68187,74751,142938,2.5011072491823954,California
781,2011,Orange,male,170543,41630,42417,84047,4.096637040595724,California
782,2011,Orange,male,170543,14357,14580,28937,11.878735111792157,California
783,2011,Orange,male,170543,17418,18194,35612,9.791193018716271,California
792,2012,Orange,male,148893,1562429,1601753,3164182,0.09529585024343507,California
793,2012,Orange,male,148893,648446,672748,1321194,0.22961511058746603,California
794,2012,Orange,male,148893,9727,9820,19547,15.307186182790172,California
795,2012,Orange,male,148893,189484,188743,378227,0.7857813852356927,California
796,2012,Orange,male,148893,68187,74751,142938,2.1835980465484623,California
797,2012,Orange,male,148893,41630,42417,84047,3.5765793898630793,California
798,2012,Orange,male,148893,14357,14580,28937,10.370759908058787,California
799,2012,Orange,male,148893,17418,18194,35612,8.548225973131244,California
808,2013,Orange,male,131896,1562429,1601753,3164182,0.08441727592101785,California
809,2013,Orange,male,131896,648446,672748,1321194,0.20340321322053032,California
810,2013,Orange,male,131896,9727,9820,19547,13.559782049964017,California
811,2013,Orange,male,131896,189484,188743,378227,0.696079880095417,California
812,2013,Orange,male,131896,68187,74751,142938,1.9343276577646766,California
813,2013,Orange,male,131896,41630,42417,84047,3.1682920970454,California
814,2013,Orange,male,131896,14357,14580,28937,9.186877481367974,California
815,2013,Orange,male,131896,17418,18194,35612,7.57239637156964,California
824,2014,Orange,male,132721,1562429,1601753,3164182,0.08494529991442812,California
825,2014,Orange,male,132721,648446,672748,1321194,0.20467548569965732,California
826,2014,Orange,male,132721,9727,9820,19547,13.644597512079779,California
827,2014,Orange,male,132721,189484,188743,378227,0.7004338097148044,California
828,2014,Orange,male,132721,68187,74751,142938,1.9464267382345608,California
829,2014,Orange,male,132721,41630,42417,84047,3.188109536392025,California
830,2014,Orange,male,132721,14357,14580,28937,9.244340739708854,California
831,2014,Orange,male,132721,17418,18194,35612,7.619761166609255,California
840,2015,Orange,male,126320,1562429,1601753,3164182,0.08084847375464742,California
841,2015,Orange,male,126320,648446,672748,1321194,0.1948041934100912,California
842,2015,Orange,male,126320,9727,9820,19547,12.986532332682225,California
843,2015,Orange,male,126320,189484,188743,378227,0.666652593358806,California
844,2015,Orange,male,126320,68187,74751,142938,1.8525525393403435,California
845,2015,Orange,male,126320,41630,42417,84047,3.034350228200817,California
846,2015,Orange,male,126320,14357,14580,28937,8.798495507417984,California
847,2015,Orange,male,126320,17418,18194,35612,7.252267768974624,California
856,2016,Orange,male,60813,1562429,1601753,3164182,0.03892208861970688,California
857,2016,Orange,male,60813,648446,672748,1321194,0.09378267427048667,California
858,2016,Orange,male,60813,9727,9820,19547,6.251979027449368,California
859,2016,Orange,male,60813,189484,188743,378227,0.32094002659855186,California
860,2016,Orange,male,60813,68187,74751,142938,0.8918562189273616,California
861,2016,Orange,male,60813,41630,42417,84047,1.4607975018015853,California
862,2016,Orange,male,60813,14357,14580,28937,4.235773490283486,California
863,2016,Orange,male,60813,17418,18194,35612,3.4913882190837064,California
865,2009,Placer,male,12720,185511,194566,380077,0.06856736258227275,California
867,2010,Placer,male,19423,185511,194566,380077,0.10469999083612293,California
869,2011,Placer,male,16484,185511,194566,380077,0.08885726452878805,California
871,2012,Placer,male,17392,185511,194566,380077,0.09375185298984966,California
873,2013,Placer,male,15546,185511,194566,380077,0.08380096058993806,California
875,2014,Placer,male,14465,185511,194566,380077,0.07797381287363013,California
877,2015,Placer,male,13866,185511,194566,380077,0.07474489383378884,California
879,2016,Placer,male,6637,185511,194566,380077,0.035776854202715744,California
881,2009,Plumas,male,5242,9423,9276,18699,0.5562984187626021,California
883,2010,Plumas,male,8634,9423,9276,18699,0.9162687042343203,California
885,2011,Plumas,male,8305,9423,9276,18699,0.8813541335031306,California
887,2012,Plumas,male,6445,9423,9276,18699,0.683964767059323,California
889,2013,Plumas,male,5517,9423,9276,18699,0.5854823304680038,California
891,2014,Plumas,male,5578,9423,9276,18699,0.5919558527008384,California
893,2015,Plumas,male,5699,9423,9276,18699,0.6047967738512151,California
895,2016,Plumas,male,3430,9423,9276,18699,0.3640029714528282,California
897,2009,Riverside,male,63125,1186188,1197098,2383286,0.053216690777515875,California
899,2010,Riverside,male,128884,1186188,1197098,2383286,0.10865394018486109,California
901,2011,Riverside,male,127843,1186188,1197098,2383286,0.10777633899516771,California
903,2012,Riverside,male,122928,1186188,1197098,2383286,0.10363281368552034,California
905,2013,Riverside,male,115426,1186188,1197098,2383286,0.09730835247026609,California
907,2014,Riverside,male,115157,1186188,1197098,2383286,0.09708157560184388,California
909,2015,Riverside,male,106765,1186188,1197098,2383286,0.09000681173641953,California
911,2016,Riverside,male,53216,1186188,1197098,2383286,0.04486304026005996,California
913,2009,Sacramento,male,70866,737742,772281,1510023,0.09605797148596663,California
915,2010,Sacramento,male,144151,737742,772281,1510023,0.195394867040239,California
917,2011,Sacramento,male,130229,737742,772281,1510023,0.17652377118287965,California
919,2012,Sacramento,male,108398,737742,772281,1510023,0.1469321253229449,California
921,2013,Sacramento,male,100216,737742,772281,1510023,0.13584152725478554,California
923,2014,Sacramento,male,88639,737742,772281,1510023,0.12014904939667255,California
925,2015,Sacramento,male,97068,737742,772281,1510023,0.13157445285750302,California
927,2016,Sacramento,male,42258,737742,772281,1510023,0.0572801873825809,California
929,2009,San Benito,male,23590,29626,29790,59416,0.7962600418551272,California
931,2010,San Benito,male,51477,29626,29790,59416,1.7375616012961588,California
933,2011,San Benito,male,54648,29626,29790,59416,1.8445959630054682,California
935,2012,San Benito,male,53864,29626,29790,59416,1.8181327212583542,California
937,2013,San Benito,male,50562,29626,29790,59416,1.7066765678795652,California
939,2014,San Benito,male,43893,29626,29790,59416,1.4815702423546884,California
941,2015,San Benito,male,45706,29626,29790,59416,1.5427664888948895,California
943,2016,San Benito,male,22716,29626,29790,59416,0.7667589279686762,California
945,2009,San Bernardino,male,121874,1062472,1072941,2135413,0.11470796406870017,California
947,2010,San Bernardino,male,229097,1062472,1072941,2135413,0.21562638827187916,California
949,2011,San Bernardino,male,229617,1062472,1072941,2135413,0.21611581293436438,California
951,2012,San Bernardino,male,202933,1062472,1072941,2135413,0.19100079813868037,California
953,2013,San Bernardino,male,188086,1062472,1072941,2135413,0.17702678282345324,California
955,2014,San Bernardino,male,175367,1062472,1072941,2135413,0.16505564381931948,California
957,2015,San Bernardino,male,170805,1062472,1072941,2135413,0.16076188360728566,California
959,2016,San Bernardino,male,90305,1062472,1072941,2135413,0.08499518104947706,California
961,2009,San Diego,male,147771,1661931,1640902,3302833,0.08891524377365848,California
963,2010,San Diego,male,302340,1661931,1640902,3302833,0.18192091007388395,California
965,2011,San Diego,male,297556,1661931,1640902,3302833,0.1790423308789595,California
967,2012,San Diego,male,268000,1661931,1640902,3302833,0.1612581990467715,California
969,2013,San Diego,male,262764,1661931,1640902,3302833,0.1581076470683801,California
971,2014,San Diego,male,261711,1661931,1640902,3302833,0.1574740467564538,California
973,2015,San Diego,male,248703,1661931,1640902,3302833,0.14964700700570602,California
975,2016,San Diego,male,113163,1661931,1640902,3302833,0.06809127454749926,California
977,2009,San Francisco,male,20423,443970,426074,870044,0.04600085591368786,California
979,2010,San Francisco,male,45291,443970,426074,870044,0.10201364957091695,California
981,2011,San Francisco,male,47962,443970,426074,870044,0.10802982183480866,California
983,2012,San Francisco,male,42801,443970,426074,870044,0.09640516251098047,California
985,2013,San Francisco,male,42761,443970,426074,870044,0.09631506633331081,California
987,2014,San Francisco,male,39535,443970,426074,870044,0.08904880960425254,California
989,2015,San Francisco,male,40792,443970,426074,870044,0.09188008198752168,California
991,2016,San Francisco,male,16106,443970,426074,870044,0.03627722593868955,California
993,2009,San Joaquin,male,34931,364612,367600,732212,0.09580320998760326,California
995,2010,San Joaquin,male,62335,364612,367600,732212,0.17096255745833927,California
997,2011,San Joaquin,male,57676,364612,367600,732212,0.15818459074303642,California
999,2012,San Joaquin,male,52165,364612,367600,732212,0.14306989347580443,California
1001,2013,San Joaquin,male,51720,364612,367600,732212,0.14184941801147521,California
1003,2014,San Joaquin,male,48238,364612,367600,732212,0.13229954033328578,California
1005,2015,San Joaquin,male,49692,364612,367600,732212,0.13628734106392548,California
1007,2016,San Joaquin,male,24786,364612,367600,732212,0.06797911204239027,California
1009,2009,San Luis Obispo,male,17089,142769,138686,281455,0.11969685295827526,California
1011,2010,San Luis Obispo,male,31448,142769,138686,281455,0.2202719077670923,California
1013,2011,San Luis Obispo,male,30074,142769,138686,281455,0.21064796979736497,California
1015,2012,San Luis Obispo,male,30495,142769,138686,281455,0.2135967892189481,California
1017,2013,San Luis Obispo,male,25838,142769,138686,281455,0.18097766321820563,California
1019,2014,San Luis Obispo,male,25812,142769,138686,281455,0.18079555085487745,California
1021,2015,San Luis Obispo,male,30545,142769,138686,281455,0.2139470053022715,California
1023,2016,San Luis Obispo,male,15442,142769,138686,281455,0.10816073517360211,California
1025,2009,San Mateo,male,23442,377851,388084,765935,0.062040328065824886,California
1027,2010,San Mateo,male,47170,377851,388084,765935,0.12483756824780139,California
1029,2011,San Mateo,male,52143,377851,388084,765935,0.13799884081291303,California
1031,2012,San Mateo,male,46106,377851,388084,765935,0.12202164345204856,California
1033,2013,San Mateo,male,47380,377851,388084,765935,0.12539334287854206,California
1035,2014,San Mateo,male,45279,377851,388084,765935,0.11983295002527451,California
1037,2015,San Mateo,male,39106,377851,388084,765935,0.10349582242735893,California
1039,2016,San Mateo,male,17344,377851,388084,765935,0.045901691407459554,California
1041,2009,Santa Barbara,male,72250,222208,221530,443738,0.3251458093317972,California
1043,2010,Santa Barbara,male,135474,222208,221530,443738,0.6096720190092166,California
1045,2011,Santa Barbara,male,139018,222208,221530,443738,0.6256210397465438,California
1047,2012,Santa Barbara,male,130931,222208,221530,443738,0.5892272105414746,California
1049,2013,Santa Barbara,male,124789,222208,221530,443738,0.5615864415322581,California
1051,2014,Santa Barbara,male,124122,222208,221530,443738,0.5585847494239631,California
1053,2015,Santa Barbara,male,121203,222208,221530,443738,0.5454484086981567,California
1055,2016,Santa Barbara,male,59357,222208,221530,443738,0.26712359591013823,California
1057,2009,Santa Clara,male,33070,970469,951731,1922200,0.034076307434858816,California
1059,2010,Santa Clara,male,62989,970469,951731,1922200,0.0649057311464869,California
1061,2011,Santa Clara,male,72027,970469,951731,1922200,0.07421875402511569,California
1063,2012,Santa Clara,male,69943,970469,951731,1922200,0.07207133870324554,California
1065,2013,Santa Clara,male,59768,970469,951731,1922200,0.06158671735006476,California
1067,2014,Santa Clara,male,57387,970469,951731,1922200,0.05913326443193961,California
1069,2015,Santa Clara,male,54396,970469,951731,1922200,0.05605124944743212,California
1071,2016,Santa Clara,male,28402,970469,951731,1922200,0.02926626198260841,California
1074,2009,Santa Cruz,male,13235,22285,24299,46584,0.5938972402961633,California
1075,2009,Santa Cruz,male,13235,135727,138038,273765,0.09751191730458936,California
1078,2010,Santa Cruz,male,29962,22285,24299,46584,1.3444918106349562,California
1079,2010,Santa Cruz,male,29962,135727,138038,273765,0.22075195060673264,California
1082,2011,Santa Cruz,male,30032,22285,24299,46584,1.3476329369531075,California
1083,2011,Santa Cruz,male,30032,135727,138038,273765,0.22126769176361372,California
1086,2012,Santa Cruz,male,28335,22285,24299,46584,1.2714830603544987,California
1087,2012,Santa Cruz,male,28335,135727,138038,273765,0.20876465257465354,California
1090,2013,Santa Cruz,male,27726,22285,24299,46584,1.244155261386583,California
1091,2013,Santa Cruz,male,27726,135727,138038,273765,0.20427770450978802,California
1094,2014,Santa Cruz,male,23750,22285,24299,46584,1.0657392865155935,California
1095,2014,Santa Cruz,male,23750,135727,138038,273765,0.17498360679894198,California
1098,2015,Santa Cruz,male,25227,22285,24299,46584,1.1320170518285841,California
1099,2015,Santa Cruz,male,25227,135727,138038,273765,0.18586574520913304,California
1102,2016,Santa Cruz,male,10970,22285,24299,46584,0.49225936728741304,California
1103,2016,Santa Cruz,male,10970,135727,138038,273765,0.08082400701407973,California
1105,2009,Shasta,male,19395,87859,91226,179085,0.22075143127055852,California
1107,2010,Shasta,male,41979,87859,91226,179085,0.4777996562674285,California
1109,2011,Shasta,male,37442,87859,91226,179085,0.4261600974288348,California
1111,2012,Shasta,male,38490,87859,91226,179085,0.43808830057250825,California
1113,2013,Shasta,male,32676,87859,91226,179085,0.3719140896208698,California
1115,2014,Shasta,male,32575,87859,91226,179085,0.3707645204247715,California
1117,2015,Shasta,male,34671,87859,91226,179085,0.3946209267121183,California
1119,2016,Shasta,male,16535,87859,91226,179085,0.18819927383648802,California
1122,2009,Sierra,male,14890,1542,1388,2930,9.656290531776913,California
1123,2009,Sierra,male,14890,5516,5619,11135,2.699419869470631,California
1126,2010,Sierra,male,25955,1542,1388,2930,16.832036316472113,California
1127,2010,Sierra,male,25955,5516,5619,11135,4.70540246555475,California
1130,2011,Sierra,male,23558,1542,1388,2930,15.277561608300909,California
1131,2011,Sierra,male,23558,5516,5619,11135,4.2708484408992025,California
1134,2012,Sierra,male,22317,1542,1388,2930,14.472762645914397,California
1135,2012,Sierra,male,22317,5516,5619,11135,4.045866569978245,California
1138,2013,Sierra,male,21685,1542,1388,2930,14.06290531776913,California
1139,2013,Sierra,male,21685,5516,5619,11135,3.9312907904278465,California
1142,2014,Sierra,male,23483,1542,1388,2930,15.228923476005187,California
1143,2014,Sierra,male,23483,5516,5619,11135,4.257251631617114,California
1146,2015,Sierra,male,20862,1542,1388,2930,13.529182879377432,California
1147,2015,Sierra,male,20862,5516,5619,11135,3.782088469905729,California
1150,2016,Sierra,male,7812,1542,1388,2930,5.066147859922179,California
1151,2016,Sierra,male,7812,5516,5619,11135,1.416243654822335,California
1153,2009,Siskiyou,male,18807,21706,21834,43540,0.866442458306459,California
1155,2010,Siskiyou,male,38899,21706,21834,43540,1.792085137749931,California
1157,2011,Siskiyou,male,34650,21706,21834,43540,1.5963328112042754,California
1159,2012,Siskiyou,male,29376,21706,21834,43540,1.3533585183820143,California
1161,2013,Siskiyou,male,33776,21706,21834,43540,1.5560674467889062,California
1163,2014,Siskiyou,male,31418,21706,21834,43540,1.4474338892472127,California
1165,2015,Siskiyou,male,30314,21706,21834,43540,1.3965723763014835,California
1167,2016,Siskiyou,male,13937,21706,21834,43540,0.6420805307288308,California
1169,2009,Solano,male,32521,217931,220599,438530,0.14922613120666633,California
1171,2010,Solano,male,66180,217931,220599,438530,0.3036740986826105,California
1173,2011,Solano,male,68172,217931,220599,438530,0.31281460645800735,California
1175,2012,Solano,male,63687,217931,220599,438530,0.2922346981384016,California
1177,2013,Solano,male,62145,217931,220599,438530,0.28515906410744685,California
1179,2014,Solano,male,52721,217931,220599,438530,0.24191601929050938,California
1181,2015,Solano,male,55782,217931,220599,438530,0.2559617493610363,California
1183,2016,Solano,male,28658,217931,220599,438530,0.1315003372627116,California
1185,2009,Sonoma,male,21236,245196,256121,501317,0.08660826440888106,California
1187,2010,Sonoma,male,45991,245196,256121,501317,0.18756831269678134,California
1189,2011,Sonoma,male,43920,245196,256121,501317,0.17912200851563648,California
1191,2012,Sonoma,male,36514,245196,256121,501317,0.14891760061338685,California
1193,2013,Sonoma,male,32632,245196,256121,501317,0.13308536843994193,California
1195,2014,Sonoma,male,33713,245196,256121,501317,0.13749408636356222,California
1197,2015,Sonoma,male,34052,245196,256121,501317,0.1388766537790176,California
1199,2016,Sonoma,male,16153,245196,256121,501317,0.06587790991696439,California
1201,2009,Stanislaus,male,18147,266844,272457,539301,0.06800602599271484,California
1203,2010,Stanislaus,male,36434,266844,272457,539301,0.13653670309244353,California
1205,2011,Stanislaus,male,33619,266844,272457,539301,0.12598746833355817,California
1207,2012,Stanislaus,male,28836,266844,272457,539301,0.1080631380132212,California
1209,2013,Stanislaus,male,28823,266844,272457,539301,0.10801442041042707,California
1211,2014,Stanislaus,male,26291,266844,272457,539301,0.09852573038929112,California
1213,2015,Stanislaus,male,24868,266844,272457,539301,0.09319302663728621,California
1215,2016,Stanislaus,male,12070,266844,272457,539301,0.04523242044040713,California
1217,2009,Sutter,male,7284,47789,48083,95872,0.15242001297369687,California
1219,2010,Sutter,male,15707,47789,48083,95872,0.32867396262738285,California
1221,2011,Sutter,male,15373,47789,48083,95872,0.32168490656845716,California
1223,2012,Sutter,male,14515,47789,48083,95872,0.303730984117684,California
1225,2013,Sutter,male,15472,47789,48083,95872,0.32375651300508484,California
1227,2014,Sutter,male,17835,47789,48083,95872,0.3732030383561071,California
1229,2015,Sutter,male,15442,47789,48083,95872,0.323128753478834,California
1231,2016,Sutter,male,5578,47789,48083,95872,0.11672142124756743,California
1233,2009,Tehama,male,16929,31504,31869,63373,0.5373603351955307,California
1235,2010,Tehama,male,31649,31504,31869,63373,1.0046025901472828,California
1237,2011,Tehama,male,31538,31504,31869,63373,1.0010792280345353,California
1239,2012,Tehama,male,27032,31504,31869,63373,0.8580497714575926,California
1241,2013,Tehama,male,25121,31504,31869,63373,0.7973908075165058,California
1243,2014,Tehama,male,26493,31504,31869,63373,0.8409408329101067,California
1245,2015,Tehama,male,23505,31504,31869,63373,0.7460957338750634,California
1247,2016,Tehama,male,11016,31504,31869,63373,0.34966988318943626,California
1250,2009,Trinity,male,3718,6582,6280,12862,0.5648738985110908,California
1251,2009,Trinity,male,3718,7011,7558,14569,0.530309513621452,California
1254,2010,Trinity,male,5908,6582,6280,12862,0.8975995138255849,California
1255,2010,Trinity,male,5908,7011,7558,14569,0.8426757951790044,California
1258,2011,Trinity,male,5711,6582,6280,12862,0.8676694013977514,California
1259,2011,Trinity,male,5711,7011,7558,14569,0.8145770931393524,California
1262,2012,Trinity,male,4472,6582,6280,12862,0.6794287450622911,California
1263,2012,Trinity,male,4472,7011,7558,14569,0.6378547996006276,California
1266,2013,Trinity,male,4423,6582,6280,12862,0.6719841993315102,California
1267,2013,Trinity,male,4423,7011,7558,14569,0.6308657823420339,California
1270,2014,Trinity,male,4196,6582,6280,12862,0.6374962017623823,California
1271,2014,Trinity,male,4196,7011,7558,14569,0.5984880901440593,California
1274,2015,Trinity,male,3969,6582,6280,12862,0.6030082041932543,California
1275,2015,Trinity,male,3969,7011,7558,14569,0.5661103979460848,California
1278,2016,Trinity,male,2010,6582,6280,12862,0.3053783044667274,California
1279,2016,Trinity,male,2010,7011,7558,14569,0.2866923406076166,California
1281,2009,Tulare,male,21775,230255,230222,460477,0.0945690647325791,California
1283,2010,Tulare,male,44392,230255,230222,460477,0.1927949447351849,California
1285,2011,Tulare,male,45116,230255,230222,460477,0.19593928470608674,California
1287,2012,Tulare,male,42579,230255,230222,460477,0.18492106577490175,California
1289,2013,Tulare,male,40675,230255,230222,460477,0.17665197281275108,California
1291,2014,Tulare,male,36349,230255,230222,460477,0.15786410718551172,California
1293,2015,Tulare,male,35645,230255,230222,460477,0.15480662743480056,California
1295,2016,Tulare,male,17450,230255,230222,460477,0.07578554211634926,California
1297,2009,Tuolumne,male,5340,28102,25830,53932,0.19002206248665576,California
1299,2010,Tuolumne,male,11701,28102,25830,53932,0.4163760586435129,California
1301,2011,Tuolumne,male,10790,28102,25830,53932,0.383958437121913,California
1303,2012,Tuolumne,male,10541,28102,25830,53932,0.375097857803715,California
1305,2013,Tuolumne,male,11088,28102,25830,53932,0.3945626645790335,California
1307,2014,Tuolumne,male,9873,28102,25830,53932,0.35132730766493486,California
1309,2015,Tuolumne,male,9976,28102,25830,53932,0.35499252722226177,California
1311,2016,Tuolumne,male,5091,28102,25830,53932,0.18116148316845776,California
1313,2009,Yolo,male,6764,104375,110602,214977,0.06480479041916168,California
1315,2010,Yolo,male,11289,104375,110602,214977,0.10815808383233533,California
1317,2011,Yolo,male,12427,104375,110602,214977,0.11906107784431137,California
1319,2012,Yolo,male,13498,104375,110602,214977,0.12932215568862276,California
1321,2013,Yolo,male,16074,104375,110602,214977,0.15400239520958084,California
1323,2014,Yolo,male,14665,104375,110602,214977,0.14050299401197605,California
1325,2015,Yolo,male,13758,104375,110602,214977,0.1318131736526946,California
1327,2016,Yolo,male,6900,104375,110602,214977,0.06610778443113773,California
0,2009,Anderson,female,3618,3932,3920,7852,0.9229591836734694,Texas
1,2009,Anderson,female,3618,10873,11341,22214,0.31901948681774095,Texas
2,2009,Anderson,female,3618,94565,101430,195995,0.03566992014196983,Texas
3,2009,Anderson,female,3618,36904,38871,75775,0.09307710118082889,Texas
4,2009,Anderson,female,3618,35412,22451,57863,0.16115095095986814,Texas
10,2010,Anderson,female,3469,3932,3920,7852,0.8849489795918367,Texas
11,2010,Anderson,female,3469,10873,11341,22214,0.30588131558063664,Texas
12,2010,Anderson,female,3469,94565,101430,195995,0.0342009267475106,Texas
13,2010,Anderson,female,3469,36904,38871,75775,0.08924390934115407,Texas
14,2010,Anderson,female,3469,35412,22451,57863,0.15451427553338382,Texas
20,2011,Anderson,female,5589,3932,3920,7852,1.425765306122449,Texas
21,2011,Anderson,female,5589,10873,11341,22214,0.4928136848602416,Texas
22,2011,Anderson,female,5589,94565,101430,195995,0.05510204081632653,Texas
23,2011,Anderson,female,5589,36904,38871,75775,0.14378328316739986,Texas
24,2011,Anderson,female,5589,35412,22451,57863,0.24894214066188589,Texas
30,2012,Anderson,female,5170,3932,3920,7852,1.3188775510204083,Texas
31,2012,Anderson,female,5170,10873,11341,22214,0.45586808923375366,Texas
32,2012,Anderson,female,5170,94565,101430,195995,0.05097111308291433,Texas
33,2012,Anderson,female,5170,36904,38871,75775,0.13300403900079752,Texas
34,2012,Anderson,female,5170,35412,22451,57863,0.23027927486526212,Texas
40,2013,Anderson,female,4690,3932,3920,7852,1.1964285714285714,Texas
41,2013,Anderson,female,4690,10873,11341,22214,0.4135437792081827,Texas
42,2013,Anderson,female,4690,94565,101430,195995,0.04623878536922015,Texas
43,2013,Anderson,female,4690,36904,38871,75775,0.12065550153070412,Texas
44,2013,Anderson,female,4690,35412,22451,57863,0.20889938087390317,Texas
50,2014,Anderson,female,3823,3932,3920,7852,0.9752551020408163,Texas
51,2014,Anderson,female,3823,10873,11341,22214,0.3370954942244952,Texas
52,2014,Anderson,female,3823,94565,101430,195995,0.03769101843636005,Texas
53,2014,Anderson,female,3823,36904,38871,75775,0.09835095572534795,Texas
54,2014,Anderson,female,3823,35412,22451,57863,0.17028194735201105,Texas
60,2015,Anderson,female,2818,3932,3920,7852,0.7188775510204082,Texas
61,2015,Anderson,female,2818,10873,11341,22214,0.24847897010845604,Texas
62,2015,Anderson,female,2818,94565,101430,195995,0.027782707285812877,Texas
63,2015,Anderson,female,2818,36904,38871,75775,0.07249620539733992,Texas
64,2015,Anderson,female,2818,35412,22451,57863,0.12551779430760324,Texas
70,2016,Anderson,female,2986,3932,3920,7852,0.761734693877551,Texas
71,2016,Anderson,female,2986,10873,11341,22214,0.26329247861740585,Texas
72,2016,Anderson,female,2986,94565,101430,195995,0.029439021985605836,Texas
73,2016,Anderson,female,2986,36904,38871,75775,0.0768181935118726,Texas
74,2016,Anderson,female,2986,35412,22451,57863,0.13300075720457885,Texas
80,2009,Andrews,female,969,9102,8716,17818,0.11117485084901331,Texas
82,2010,Andrews,female,765,9102,8716,17818,0.0877696190913263,Texas
84,2011,Andrews,female,952,9102,8716,17818,0.10922441486920606,Texas
86,2012,Andrews,female,1078,9102,8716,17818,0.12368058742542451,Texas
88,2013,Andrews,female,492,9102,8716,17818,0.05644791188618632,Texas
90,2014,Andrews,female,253,9102,8716,17818,0.029027076640660853,Texas
92,2015,Andrews,female,421,9102,8716,17818,0.04830197338228545,Texas
94,2016,Andrews,female,864,9102,8716,17818,0.09912804038549794,Texas
96,2009,Angelina,female,4419,42659,44948,87607,0.09831360683456439,Texas
98,2010,Angelina,female,6057,42659,44948,87607,0.1347557177182522,Texas
100,2011,Angelina,female,5131,42659,44948,87607,0.1141541336655691,Texas
102,2012,Angelina,female,5614,42659,44948,87607,0.1248998843107591,Texas
104,2013,Angelina,female,4574,42659,44948,87607,0.10176203613063985,Texas
106,2014,Angelina,female,3708,42659,44948,87607,0.0824953279345021,Texas
108,2015,Angelina,female,4437,42659,44948,87607,0.098714069591528,Texas
110,2016,Angelina,female,4781,42659,44948,87607,0.10636735783572128,Texas
112,2009,Aransas,female,1243,12026,12737,24763,0.09758969930124833,Texas
114,2010,Aransas,female,820,12026,12737,24763,0.06437936719792729,Texas
116,2011,Aransas,female,760,12026,12737,24763,0.05966868179320091,Texas
118,2012,Aransas,female,1126,12026,12737,24763,0.08840386276203188,Texas
120,2013,Aransas,female,1365,12026,12737,24763,0.10716809295752532,Texas
122,2014,Aransas,female,964,12026,12737,24763,0.07568501216927064,Texas
124,2015,Aransas,female,749,12026,12737,24763,0.05880505613566774,Texas
126,2016,Aransas,female,858,12026,12737,24763,0.06736280128758734,Texas
128,2009,Archer,female,1918,4326,4463,8789,0.42975576966166257,Texas
130,2010,Archer,female,2424,4326,4463,8789,0.5431324221375756,Texas
132,2011,Archer,female,2491,4326,4463,8789,0.5581447456867578,Texas
134,2012,Archer,female,2198,4326,4463,8789,0.49249383822540893,Texas
136,2013,Archer,female,1889,4326,4463,8789,0.4232578982747031,Texas
138,2014,Archer,female,1095,4326,4463,8789,0.24535066099036523,Texas
140,2015,Archer,female,1256,4326,4463,8789,0.2814250504145194,Texas
142,2016,Archer,female,1768,4326,4463,8789,0.3961460900739413,Texas
144,2009,Armstrong,female,899,33003,33328,66331,0.026974315890542486,Texas
145,2009,Armstrong,female,899,960,956,1916,0.9403765690376569,Texas
148,2010,Armstrong,female,628,33003,33328,66331,0.01884301488238118,Texas
149,2010,Armstrong,female,628,960,956,1916,0.6569037656903766,Texas
152,2011,Armstrong,female,926,33003,33328,66331,0.027784445511281806,Texas
153,2011,Armstrong,female,926,960,956,1916,0.9686192468619247,Texas
156,2012,Armstrong,female,1460,33003,33328,66331,0.043807009121459434,Texas
157,2012,Armstrong,female,1460,960,956,1916,1.5271966527196652,Texas
160,2013,Armstrong,female,919,33003,33328,66331,0.027574411905904945,Texas
161,2013,Armstrong,female,919,960,956,1916,0.9612970711297071,Texas
164,2014,Armstrong,female,806,33003,33328,66331,0.02418386941910706,Texas
165,2014,Armstrong,female,806,960,956,1916,0.8430962343096234,Texas
168,2015,Armstrong,female,713,33003,33328,66331,0.021393422947671627,Texas
169,2015,Armstrong,female,713,960,956,1916,0.74581589958159,Texas
172,2016,Armstrong,female,470,33003,33328,66331,0.014102256361017763,Texas
173,2016,Armstrong,female,470,960,956,1916,0.4916317991631799,Texas
176,2009,Atascosa,female,3368,24398,24430,48828,0.13786328284895621,Texas
178,2010,Atascosa,female,3679,24398,24430,48828,0.15059353254195662,Texas
180,2011,Atascosa,female,4458,24398,24430,48828,0.18248055669259108,Texas
182,2012,Atascosa,female,4078,24398,24430,48828,0.16692591076545232,Texas
184,2013,Atascosa,female,3478,24398,24430,48828,0.14236594351207532,Texas
186,2014,Atascosa,female,3912,24398,24430,48828,0.160130986492018,Texas
188,2015,Atascosa,female,3646,24398,24430,48828,0.14924273434302088,Texas
190,2016,Atascosa,female,3195,24398,24430,48828,0.1307818256242325,Texas
192,2009,Austin,female,2560,14684,14881,29565,0.1720314494993616,Texas
194,2010,Austin,female,2874,14684,14881,29565,0.19313218197701768,Texas
196,2011,Austin,female,3103,14684,14881,29565,0.20852093273301525,Texas
198,2012,Austin,female,3115,14684,14881,29565,0.2093273301525435,Texas
200,2013,Austin,female,2749,14684,14881,29565,0.18473220885693165,Texas
202,2014,Austin,female,2255,14684,14881,29565,0.1515355150863517,Texas
204,2015,Austin,female,1251,14684,14881,29565,0.08406693098582084,Texas
206,2016,Austin,female,1493,14684,14881,29565,0.10032927894630737,Texas
208,2009,Bailey,female,873,3640,3452,7092,0.25289687137891076,Texas
210,2010,Bailey,female,670,3640,3452,7092,0.194090382387022,Texas
212,2011,Bailey,female,1462,3640,3452,7092,0.4235225955967555,Texas
214,2012,Bailey,female,1183,3640,3452,7092,0.34269988412514485,Texas
216,2013,Bailey,female,924,3640,3452,7092,0.26767091541135574,Texas
218,2014,Bailey,female,719,3640,3452,7092,0.2082850521436848,Texas
220,2015,Bailey,female,909,3640,3452,7092,0.26332560834298957,Texas
222,2016,Bailey,female,375,3640,3452,7092,0.10863267670915411,Texas
224,2009,Bandera,female,1566,11032,10731,21763,0.1459323455409561,Texas
226,2010,Bandera,female,1902,11032,10731,21763,0.17724350013978193,Texas
228,2011,Bandera,female,1891,11032,10731,21763,0.17621843257851086,Texas
230,2012,Bandera,female,2095,11032,10731,21763,0.1952287764420837,Texas
232,2013,Bandera,female,1898,11032,10731,21763,0.17687074829931973,Texas
234,2014,Bandera,female,1365,11032,10731,21763,0.12720156555772993,Texas
236,2015,Bandera,female,1213,11032,10731,21763,0.11303699562016588,Texas
238,2016,Bandera,female,1165,11032,10731,21763,0.10856397353461933,Texas
240,2009,Bastrop,female,3970,42014,40563,82577,0.09787244533195276,Texas
242,2010,Bastrop,female,5061,42014,40563,82577,0.12476887804156497,Texas
244,2011,Bastrop,female,5761,42014,40563,82577,0.14202598427138033,Texas
246,2012,Bastrop,female,7213,42014,40563,82577,0.1778221531937973,Texas
248,2013,Bastrop,female,7204,42014,40563,82577,0.1776002761136997,Texas
250,2014,Bastrop,female,4965,42014,40563,82577,0.1224021891871903,Texas
252,2015,Bastrop,female,2420,42014,40563,82577,0.05966028153736164,Texas
254,2016,Bastrop,female,2694,42014,40563,82577,0.06641520597588936,Texas
256,2009,Baylor,female,763,1752,1839,3591,0.4148994018488309,Texas
258,2010,Baylor,female,1010,1752,1839,3591,0.5492115280043501,Texas
260,2011,Baylor,female,796,1752,1839,3591,0.4328439369222403,Texas
262,2012,Baylor,female,747,1752,1839,3591,0.4061990212071778,Texas
264,2013,Baylor,female,455,1752,1839,3591,0.24741707449700925,Texas
266,2014,Baylor,female,373,1752,1839,3591,0.20282762370853724,Texas
268,2015,Baylor,female,557,1752,1839,3591,0.3028820010875476,Texas
270,2016,Baylor,female,227,1752,1839,3591,0.12343665035345297,Texas
272,2009,Bee,female,1317,19911,12780,32691,0.10305164319248826,Texas
274,2010,Bee,female,2003,19911,12780,32691,0.15672926447574334,Texas
276,2011,Bee,female,1697,19911,12780,32691,0.13278560250391236,Texas
278,2012,Bee,female,2689,19911,12780,32691,0.21040688575899844,Texas
280,2013,Bee,female,2139,19911,12780,32691,0.16737089201877933,Texas
282,2014,Bee,female,2245,19911,12780,32691,0.17566510172143976,Texas
284,2015,Bee,female,1630,19911,12780,32691,0.12754303599374023,Texas
286,2016,Bee,female,2117,19911,12780,32691,0.16564945226917058,Texas
288,2009,Bell,female,10085,13325,13863,27188,0.7274760152925053,Texas
289,2009,Bell,female,10085,170918,171318,342236,0.05886713596936691,Texas
292,2010,Bell,female,10633,13325,13863,27188,0.7670056986222319,Texas
293,2010,Bell,female,10633,170918,171318,342236,0.06206586581678516,Texas
296,2011,Bell,female,10858,13325,13863,27188,0.7832359518141816,Texas
297,2011,Bell,female,10858,170918,171318,342236,0.06337921292567039,Texas
300,2012,Bell,female,10068,13325,13863,27188,0.7262497294957801,Texas
301,2012,Bell,female,10068,170918,171318,342236,0.0587679052989178,Texas
304,2013,Bell,female,9613,13325,13863,27188,0.6934285508187261,Texas
305,2013,Bell,female,9613,170918,171318,342236,0.05611202558983878,Texas
308,2014,Bell,female,7689,13325,13863,27188,0.5546418524128977,Texas
309,2014,Bell,female,7689,170918,171318,342236,0.044881448534304626,Texas
312,2015,Bell,female,6050,13325,13863,27188,0.43641347471687225,Texas
313,2015,Bell,female,6050,170918,171318,342236,0.03531444448335843,Texas
316,2016,Bell,female,6412,13325,13863,27188,0.4625261487412537,Texas
317,2016,Bell,female,6412,170918,171318,342236,0.03742747405409823,Texas
320,2009,Bexar,female,4077,950030,975835,1925865,0.004177960413389558,Texas
322,2010,Bexar,female,4894,950030,975835,1925865,0.005015192117519868,Texas
324,2011,Bexar,female,5286,950030,975835,1925865,0.005416899373357176,Texas
326,2012,Bexar,female,7025,950030,975835,1925865,0.007198962939431359,Texas
328,2013,Bexar,female,6523,950030,975835,1925865,0.006684531708741745,Texas
330,2014,Bexar,female,5559,950030,975835,1925865,0.005696659783672444,Texas
332,2015,Bexar,female,4465,950030,975835,1925865,0.004575568615595874,Texas
334,2016,Bexar,female,3797,950030,975835,1925865,0.0038910266592200524,Texas
336,2009,Blanco,female,1656,5781,5498,11279,0.3012004365223718,Texas
338,2010,Blanco,female,1455,5781,5498,11279,0.26464168788650416,Texas
340,2011,Blanco,female,1666,5781,5498,11279,0.30301927973808657,Texas
342,2012,Blanco,female,1641,5781,5498,11279,0.2984721716987996,Texas
344,2013,Blanco,female,1228,5781,5498,11279,0.2233539468897781,Texas
346,2014,Blanco,female,869,5781,5498,11279,0.15805747544561657,Texas
348,2015,Blanco,female,794,5781,5498,11279,0.14441615132775554,Texas
350,2016,Blanco,female,990,5781,5498,11279,0.18006547835576572,Texas
352,2009,Borden,female,30,346,319,665,0.09404388714733543,Texas
354,2010,Borden,female,39,346,319,665,0.12225705329153605,Texas
356,2011,Borden,female,37,346,319,665,0.11598746081504702,Texas
358,2012,Borden,female,26,346,319,665,0.08150470219435736,Texas
360,2013,Borden,female,10,346,319,665,0.03134796238244514,Texas
362,2014,Borden,female,10,346,319,665,0.03134796238244514,Texas
364,2015,Borden,female,5,346,319,665,0.01567398119122257,Texas
366,2016,Borden,female,6,346,319,665,0.018808777429467086,Texas
368,2009,Bosque,female,1421,8935,9187,18122,0.15467508435833244,Texas
370,2010,Bosque,female,1467,8935,9187,18122,0.1596821595733101,Texas
372,2011,Bosque,female,1622,8935,9187,18122,0.17655382605856101,Texas
374,2012,Bosque,female,1674,8935,9187,18122,0.1822139980407097,Texas
376,2013,Bosque,female,1644,8935,9187,18122,0.1789485142048547,Texas
378,2014,Bosque,female,1457,8935,9187,18122,0.15859366496135843,Texas
380,2015,Bosque,female,869,8935,9187,18122,0.0945901817786002,Texas
382,2016,Bosque,female,844,8935,9187,18122,0.09186894524872102,Texas
384,2009,Bowie,female,7228,47275,46583,93858,0.15516390099392482,Texas
386,2010,Bowie,female,7199,47275,46583,93858,0.15454135628877488,Texas
388,2011,Bowie,female,6928,47275,46583,93858,0.1487237833544426,Texas
390,2012,Bowie,female,5347,47275,46583,93858,0.11478436339437134,Texas
392,2013,Bowie,female,4452,47275,46583,93858,0.09557134576991606,Texas
394,2014,Bowie,female,3953,47275,46583,93858,0.08485928342957731,Texas
396,2015,Bowie,female,3992,47275,46583,93858,0.08569649872271,Texas
398,2016,Bowie,female,4327,47275,46583,93858,0.09288796342013181,Texas
400,2009,Brazoria,female,12920,179060,174939,353999,0.07385431493263366,Texas
402,2010,Brazoria,female,13838,179060,174939,353999,0.07910185836205763,Texas
404,2011,Brazoria,female,15466,179060,174939,353999,0.08840795934582912,Texas
406,2012,Brazoria,female,11343,179060,174939,353999,0.06483974413938573,Texas
408,2013,Brazoria,female,10750,179060,174939,353999,0.06144999113976872,Texas
410,2014,Brazoria,female,8577,179060,174939,353999,0.0490285185121671,Texas
412,2015,Brazoria,female,7552,179060,174939,353999,0.04316933331046822,Texas
414,2016,Brazoria,female,8612,179060,174939,353999,0.04922858825076169,Texas
416,2009,Brazos,female,4460,111074,108119,219193,0.04125084397746927,Texas
418,2010,Brazos,female,6376,111074,108119,219193,0.058972058565099565,Texas
420,2011,Brazos,female,6174,111074,108119,219193,0.05710374679751015,Texas
422,2012,Brazos,female,5169,111074,108119,219193,0.04780843330034499,Texas
424,2013,Brazos,female,5667,111074,108119,219193,0.05241446924222384,Texas
426,2014,Brazos,female,4201,111074,108119,219193,0.03885533532496601,Texas
428,2015,Brazos,female,2973,111074,108119,219193,0.027497479628927384,Texas
430,2016,Brazos,female,4221,111074,108119,219193,0.03904031668809368,Texas
432,2009,Brewster,female,3186,4558,4658,9216,0.6839845427221983,Texas
434,2010,Brewster,female,2235,4558,4658,9216,0.4798196650923143,Texas
436,2011,Brewster,female,1923,4558,4658,9216,0.4128381279519107,Texas
438,2012,Brewster,female,1464,4558,4658,9216,0.3142979819665092,Texas
440,2013,Brewster,female,790,4558,4658,9216,0.1696006869901245,Texas
442,2014,Brewster,female,1294,4558,4658,9216,0.27780163160154575,Texas
444,2015,Brewster,female,1348,4558,4658,9216,0.28939458995276945,Texas
446,2016,Brewster,female,1758,4558,4658,9216,0.37741519965650494,Texas
448,2009,Briscoe,female,89,831,715,1546,0.12447552447552447,Texas
450,2010,Briscoe,female,157,831,715,1546,0.21958041958041957,Texas
452,2011,Briscoe,female,184,831,715,1546,0.2573426573426573,Texas
454,2012,Briscoe,female,119,831,715,1546,0.16643356643356644,Texas
456,2013,Briscoe,female,73,831,715,1546,0.1020979020979021,Texas
458,2014,Briscoe,female,126,831,715,1546,0.17622377622377622,Texas
460,2015,Briscoe,female,104,831,715,1546,0.14545454545454545,Texas
462,2016,Briscoe,female,165,831,715,1546,0.23076923076923078,Texas
464,2009,Brooks,female,3151,7608,8014,15622,0.39318692288495133,Texas
465,2009,Brooks,female,3151,3724,3456,7180,0.9117476851851852,Texas
468,2010,Brooks,female,2688,7608,8014,15622,0.3354130272023958,Texas
469,2010,Brooks,female,2688,3724,3456,7180,0.7777777777777778,Texas
472,2011,Brooks,female,1980,7608,8014,15622,0.24706763164462192,Texas
473,2011,Brooks,female,1980,3724,3456,7180,0.5729166666666666,Texas
476,2012,Brooks,female,1237,7608,8014,15622,0.15435487896181682,Texas
477,2012,Brooks,female,1237,3724,3456,7180,0.35792824074074076,Texas
480,2013,Brooks,female,1122,7608,8014,15622,0.14000499126528576,Texas
481,2013,Brooks,female,1122,3724,3456,7180,0.3246527777777778,Texas
484,2014,Brooks,female,884,7608,8014,15622,0.11030696281507361,Texas
485,2014,Brooks,female,884,3724,3456,7180,0.25578703703703703,Texas
488,2015,Brooks,female,1123,7608,8014,15622,0.1401297728974295,Texas
489,2015,Brooks,female,1123,3724,3456,7180,0.32494212962962965,Texas
492,2016,Brooks,female,2102,7608,8014,15622,0.26229099076615925,Texas
493,2016,Brooks,female,2102,3724,3456,7180,0.6082175925925926,Texas
496,2009,Brown,female,2849,4238,2437,6675,1.1690603200656544,Texas
497,2009,Brown,female,2849,7441,7593,15034,0.37521401290662454,Texas
498,2009,Brown,female,2849,4685,4979,9664,0.5722032536653947,Texas
499,2009,Brown,female,2849,12653,12558,25211,0.22686733556298774,Texas
500,2009,Brown,female,2849,1430,1558,2988,1.8286264441591784,Texas
501,2009,Brown,female,2849,21649,22030,43679,0.12932364956876985,Texas
502,2009,Brown,female,2849,19060,19780,38840,0.14403437815975734,Texas
503,2009,Brown,female,2849,18774,19060,37834,0.14947534102833157,Texas
504,2009,Brown,female,2849,128824,130962,259786,0.021754402040286495,Texas
514,2010,Brown,female,2509,4238,2437,6675,1.029544521953221,Texas
515,2010,Brown,female,2509,7441,7593,15034,0.33043592782826287,Texas
516,2010,Brown,female,2509,4685,4979,9664,0.5039164490861618,Texas
517,2010,Brown,female,2509,12653,12558,25211,0.1997929606625259,Texas
518,2010,Brown,female,2509,1430,1558,2988,1.610397946084724,Texas
519,2010,Brown,female,2509,21649,22030,43679,0.11389014979573309,Texas
520,2010,Brown,female,2509,19060,19780,38840,0.126845298281092,Texas
521,2010,Brown,female,2509,18774,19060,37834,0.13163693599160545,Texas
522,2010,Brown,female,2509,128824,130962,259786,0.01915822910462577,Texas
532,2011,Brown,female,2975,4238,2437,6675,1.2207632334837915,Texas
533,2011,Brown,female,2975,7441,7593,15034,0.3918082444356644,Texas
534,2011,Brown,female,2975,4685,4979,9664,0.5975095400682868,Texas
535,2011,Brown,female,2975,12653,12558,25211,0.23690078037904125,Texas
536,2011,Brown,female,2975,1430,1558,2988,1.9094993581514763,Texas
537,2011,Brown,female,2975,21649,22030,43679,0.13504312301407173,Texas
538,2011,Brown,female,2975,19060,19780,38840,0.15040444893832153,Texas
539,2011,Brown,female,2975,18774,19060,37834,0.15608604407135362,Texas
540,2011,Brown,female,2975,128824,130962,259786,0.022716513187031353,Texas
550,2012,Brown,female,2633,4238,2437,6675,1.0804267542059909,Texas
551,2012,Brown,female,2633,7441,7593,15034,0.34676675885684183,Texas
552,2012,Brown,female,2633,4685,4979,9664,0.5288210484032938,Texas
553,2012,Brown,female,2633,12653,12558,25211,0.20966714444975315,Texas
554,2012,Brown,female,2633,1430,1558,2988,1.6899871630295251,Texas
555,2012,Brown,female,2633,21649,22030,43679,0.11951883794825238,Texas
556,2012,Brown,female,2633,19060,19780,38840,0.13311425682507583,Texas
557,2012,Brown,female,2633,18774,19060,37834,0.13814270724029382,Texas
558,2012,Brown,female,2633,128824,130962,259786,0.02010506864586674,Texas
568,2013,Brown,female,2338,4238,2437,6675,0.9593762823143209,Texas
569,2013,Brown,female,2338,7441,7593,15034,0.30791518503885157,Texas
570,2013,Brown,female,2338,4685,4979,9664,0.4695722032536654,Texas
571,2013,Brown,female,2338,12653,12558,25211,0.18617614269788182,Texas
572,2013,Brown,female,2338,1430,1558,2988,1.5006418485237485,Texas
573,2013,Brown,female,2338,21649,22030,43679,0.10612800726282343,Texas
574,2013,Brown,female,2338,19060,19780,38840,0.11820020222446916,Texas
575,2013,Brown,female,2338,18774,19060,37834,0.12266526757607556,Texas
576,2013,Brown,female,2338,128824,130962,259786,0.017852506834043463,Texas
586,2014,Brown,female,1675,4238,2437,6675,0.687320475995076,Texas
587,2014,Brown,female,1675,7441,7593,15034,0.22059791913604637,Texas
588,2014,Brown,female,1675,4685,4979,9664,0.33641293432416147,Texas
589,2014,Brown,female,1675,12653,12558,25211,0.13338111164198121,Texas
590,2014,Brown,female,1675,1430,1558,2988,1.0750962772785622,Texas
591,2014,Brown,female,1675,21649,22030,43679,0.07603268270540173,Texas
592,2014,Brown,female,1675,19060,19780,38840,0.08468149646107179,Texas
593,2014,Brown,female,1675,18774,19060,37834,0.0878803777544596,Texas
594,2014,Brown,female,1675,128824,130962,259786,0.012789969609505047,Texas
604,2015,Brown,female,1052,4238,2437,6675,0.43167829298317606,Texas
605,2015,Brown,female,1052,7441,7593,15034,0.13854866324246015,Texas
606,2015,Brown,female,1052,4685,4979,9664,0.2112874071098614,Texas
607,2015,Brown,female,1052,12653,12558,25211,0.0837713011626055,Texas
608,2015,Brown,female,1052,1430,1558,2988,0.675224646983312,Texas
609,2015,Brown,female,1052,21649,22030,43679,0.04775306400363141,Texas
610,2015,Brown,female,1052,19060,19780,38840,0.053185035389282105,Texas
611,2015,Brown,female,1052,18774,19060,37834,0.05519412381951731,Texas
612,2015,Brown,female,1052,128824,130962,259786,0.008032864495044364,Texas
622,2016,Brown,female,1546,4238,2437,6675,0.634386540828888,Texas
623,2016,Brown,female,1546,7441,7593,15034,0.20360858685631503,Texas
624,2016,Brown,female,1546,4685,4979,9664,0.31050411729262906,Texas
625,2016,Brown,female,1546,12653,12558,25211,0.12310877528268832,Texas
626,2016,Brown,female,1546,1430,1558,2988,0.9922978177150192,Texas
627,2016,Brown,female,1546,21649,22030,43679,0.07017703132092601,Texas
628,2016,Brown,female,1546,19060,19780,38840,0.078159757330637,Texas
629,2016,Brown,female,1546,18774,19060,37834,0.08111227701993703,Texas
630,2016,Brown,female,1546,128824,130962,259786,0.01180495105450436,Texas
640,2009,Burleson,female,2525,8977,8886,17863,0.28415485032635607,Texas
642,2010,Burleson,female,3414,8977,8886,17863,0.38419986495611075,Texas
644,2011,Burleson,female,4918,8977,8886,17863,0.5534548728336709,Texas
646,2012,Burleson,female,3483,8977,8886,17863,0.39196488858879136,Texas
648,2013,Burleson,female,1488,8977,8886,17863,0.1674544226873734,Texas
650,2014,Burleson,female,1522,8977,8886,17863,0.17128066621652036,Texas
652,2015,Burleson,female,1750,8977,8886,17863,0.19693900517668242,Texas
654,2016,Burleson,female,2227,8977,8886,17863,0.2506189511591267,Texas
656,2009,Burnet,female,2663,22642,23108,45750,0.11524147481391726,Texas
658,2010,Burnet,female,3288,22642,23108,45750,0.14228838497490046,Texas
660,2011,Burnet,female,3311,22642,23108,45750,0.14328371126882464,Texas
662,2012,Burnet,female,3580,22642,23108,45750,0.15492470140211181,Texas
664,2013,Burnet,female,4618,22642,23108,45750,0.19984420979747275,Texas
666,2014,Burnet,female,2779,22642,23108,45750,0.12026138133979575,Texas
668,2015,Burnet,female,2148,22642,23108,45750,0.09295482084126709,Texas
670,2016,Burnet,female,1581,22642,23108,45750,0.06841786394322312,Texas
672,2009,Caldwell,female,1780,6168,6559,12727,0.27138283274889463,Texas
673,2009,Caldwell,female,1780,5277,4719,9996,0.3771985590167408,Texas
674,2009,Caldwell,female,1780,4585,4464,9049,0.39874551971326166,Texas
675,2009,Caldwell,female,1780,40354,41425,81779,0.04296922148461074,Texas
676,2009,Caldwell,female,1780,20893,20508,41401,0.0867953969182758,Texas
682,2010,Caldwell,female,1987,6168,6559,12727,0.3029425217258728,Texas
683,2010,Caldwell,female,1987,5277,4719,9996,0.4210637847001483,Texas
684,2010,Caldwell,female,1987,4585,4464,9049,0.4451164874551971,Texas
685,2010,Caldwell,female,1987,40354,41425,81779,0.047966203983101995,Texas
686,2010,Caldwell,female,1987,20893,20508,41401,0.09688901891944607,Texas
692,2011,Caldwell,female,3150,6168,6559,12727,0.48025613660619,Texas
693,2011,Caldwell,female,3150,5277,4719,9996,0.6675143038779402,Texas
694,2011,Caldwell,female,3150,4585,4464,9049,0.7056451612903226,Texas
695,2011,Caldwell,female,3150,40354,41425,81779,0.07604103802051901,Texas
696,2011,Caldwell,female,3150,20893,20508,41401,0.15359859566998244,Texas
702,2012,Caldwell,female,2696,6168,6559,12727,0.4110382680286629,Texas
703,2012,Caldwell,female,2696,5277,4719,9996,0.5713074803983895,Texas
704,2012,Caldwell,female,2696,4585,4464,9049,0.6039426523297491,Texas
705,2012,Caldwell,female,2696,40354,41425,81779,0.06508147254073628,Texas
706,2012,Caldwell,female,2696,20893,20508,41401,0.13146089330992783,Texas
712,2013,Caldwell,female,2328,6168,6559,12727,0.3549321542918128,Texas
713,2013,Caldwell,female,2328,5277,4719,9996,0.4933248569612206,Texas
714,2013,Caldwell,female,2328,4585,4464,9049,0.521505376344086,Texas
715,2013,Caldwell,female,2328,40354,41425,81779,0.05619794809897405,Texas
716,2013,Caldwell,female,2328,20893,20508,41401,0.11351667641895846,Texas
722,2014,Caldwell,female,2831,6168,6559,12727,0.4316206738832139,Texas
723,2014,Caldwell,female,2831,5277,4719,9996,0.5999152362788727,Texas
724,2014,Caldwell,female,2831,4585,4464,9049,0.6341845878136201,Texas
725,2014,Caldwell,female,2831,40354,41425,81779,0.06834037417018708,Texas
726,2014,Caldwell,female,2831,20893,20508,41401,0.1380436902672128,Texas
732,2015,Caldwell,female,1587,6168,6559,12727,0.24195761549016617,Texas
733,2015,Caldwell,female,1587,5277,4719,9996,0.33630006357279085,Texas
734,2015,Caldwell,female,1587,4585,4464,9049,0.35551075268817206,Texas
735,2015,Caldwell,female,1587,40354,41425,81779,0.038310199155099575,Texas
736,2015,Caldwell,female,1587,20893,20508,41401,0.07738443534230544,Texas
742,2016,Caldwell,female,1972,6168,6559,12727,0.3006555877420338,Texas
743,2016,Caldwell,female,1972,5277,4719,9996,0.41788514515787245,Texas
744,2016,Caldwell,female,1972,4585,4464,9049,0.44175627240143367,Texas
745,2016,Caldwell,female,1972,40354,41425,81779,0.0476041038020519,Texas
746,2016,Caldwell,female,1972,20893,20508,41401,0.0961575970353033,Texas
752,2009,Calhoun,female,1517,55315,59783,115098,0.025375106635665657,Texas
753,2009,Calhoun,female,1517,2607,2595,5202,0.5845857418111753,Texas
754,2009,Calhoun,female,1517,8048,6396,14444,0.23717948717948717,Texas
755,2009,Calhoun,female,1517,3875,2553,6428,0.5942028985507246,Texas
756,2009,Calhoun,female,1517,2435,2423,4858,0.6260833677259595,Texas
757,2009,Calhoun,female,1517,5044,4736,9780,0.3203125,Texas
758,2009,Calhoun,female,1517,65782,68691,134473,0.02208440698199182,Texas
759,2009,Calhoun,female,1517,6991,7580,14571,0.20013192612137204,Texas
760,2009,Calhoun,female,1517,7013,7700,14713,0.197012987012987,Texas
761,2009,Calhoun,female,1517,11062,10745,21807,0.1411819450907399,Texas
762,2009,Calhoun,female,1517,3642,3754,7396,0.4041022908897176,Texas
774,2010,Calhoun,female,1379,55315,59783,115098,0.02306675810849238,Texas
775,2010,Calhoun,female,1379,2607,2595,5202,0.5314065510597302,Texas
776,2010,Calhoun,female,1379,8048,6396,14444,0.21560350218886803,Texas
777,2010,Calhoun,female,1379,3875,2553,6428,0.5401488444966706,Texas
778,2010,Calhoun,female,1379,2435,2423,4858,0.5691291787040859,Texas
779,2010,Calhoun,female,1379,5044,4736,9780,0.2911739864864865,Texas
780,2010,Calhoun,female,1379,65782,68691,134473,0.02007541017018241,Texas
781,2010,Calhoun,female,1379,6991,7580,14571,0.18192612137203165,Texas
782,2010,Calhoun,female,1379,7013,7700,14713,0.17909090909090908,Texas
783,2010,Calhoun,female,1379,11062,10745,21807,0.12833876221498372,Texas
784,2010,Calhoun,female,1379,3642,3754,7396,0.36734150239744273,Texas
796,2011,Calhoun,female,1795,55315,59783,115098,0.030025258016492983,Texas
797,2011,Calhoun,female,1795,2607,2595,5202,0.6917148362235067,Texas
798,2011,Calhoun,female,1795,8048,6396,14444,0.2806441525953721,Texas
799,2011,Calhoun,female,1795,3875,2553,6428,0.7030943987465726,Texas
800,2011,Calhoun,female,1795,2435,2423,4858,0.7408171687990095,Texas
801,2011,Calhoun,female,1795,5044,4736,9780,0.37901182432432434,Texas
802,2011,Calhoun,female,1795,65782,68691,134473,0.026131516501433957,Texas
803,2011,Calhoun,female,1795,6991,7580,14571,0.23680738786279684,Texas
804,2011,Calhoun,female,1795,7013,7700,14713,0.2331168831168831,Texas
805,2011,Calhoun,female,1795,11062,10745,21807,0.1670544439274081,Texas
806,2011,Calhoun,female,1795,3642,3754,7396,0.47815663292488014,Texas
818,2012,Calhoun,female,1938,55315,59783,115098,0.03241724235986819,Texas
819,2012,Calhoun,female,1938,2607,2595,5202,0.7468208092485549,Texas
820,2012,Calhoun,female,1938,8048,6396,14444,0.3030018761726079,Texas
821,2012,Calhoun,female,1938,3875,2553,6428,0.7591069330199764,Texas
822,2012,Calhoun,female,1938,2435,2423,4858,0.7998349153941395,Texas
823,2012,Calhoun,female,1938,5044,4736,9780,0.4092060810810811,Texas
824,2012,Calhoun,female,1938,65782,68691,134473,0.02821330305280168,Texas
825,2012,Calhoun,female,1938,6991,7580,14571,0.25567282321899737,Texas
826,2012,Calhoun,female,1938,7013,7700,14713,0.2516883116883117,Texas
827,2012,Calhoun,female,1938,11062,10745,21807,0.18036295951605397,Texas
828,2012,Calhoun,female,1938,3642,3754,7396,0.5162493340436868,Texas
840,2013,Calhoun,female,1510,55315,59783,115098,0.025258016492982954,Texas
841,2013,Calhoun,female,1510,2607,2595,5202,0.581888246628131,Texas
842,2013,Calhoun,female,1510,8048,6396,14444,0.2360850531582239,Texas
843,2013,Calhoun,female,1510,3875,2553,6428,0.591461026243635,Texas
844,2013,Calhoun,female,1510,2435,2423,4858,0.6231943871234007,Texas
845,2013,Calhoun,female,1510,5044,4736,9780,0.3188344594594595,Texas
846,2013,Calhoun,female,1510,65782,68691,134473,0.021982501346610183,Texas
847,2013,Calhoun,female,1510,6991,7580,14571,0.19920844327176782,Texas
848,2013,Calhoun,female,1510,7013,7700,14713,0.1961038961038961,Texas
849,2013,Calhoun,female,1510,11062,10745,21807,0.14053047929269427,Texas
850,2013,Calhoun,female,1510,3642,3754,7396,0.40223761321257323,Texas
862,2014,Calhoun,female,1283,55315,59783,115098,0.02146095043741532,Texas
863,2014,Calhoun,female,1283,2607,2595,5202,0.49441233140655105,Texas
864,2014,Calhoun,female,1283,8048,6396,14444,0.20059412132582866,Texas
865,2014,Calhoun,female,1283,3875,2553,6428,0.5025460242851547,Texas
866,2014,Calhoun,female,1283,2435,2423,4858,0.529508873297565,Texas
867,2014,Calhoun,female,1283,5044,4736,9780,0.27090371621621623,Texas
868,2014,Calhoun,female,1283,65782,68691,134473,0.018677847170662825,Texas
869,2014,Calhoun,female,1283,6991,7580,14571,0.16926121372031663,Texas
870,2014,Calhoun,female,1283,7013,7700,14713,0.16662337662337662,Texas
871,2014,Calhoun,female,1283,11062,10745,21807,0.11940437412750117,Texas
872,2014,Calhoun,female,1283,3642,3754,7396,0.3417687799680341,Texas
884,2015,Calhoun,female,742,55315,59783,115098,0.01241155512436646,Texas
885,2015,Calhoun,female,742,2607,2595,5202,0.2859344894026975,Texas
886,2015,Calhoun,female,742,8048,6396,14444,0.1160100062539087,Texas
887,2015,Calhoun,female,742,3875,2553,6428,0.29063846455150805,Texas
888,2015,Calhoun,female,742,2435,2423,4858,0.306231943871234,Texas
889,2015,Calhoun,female,742,5044,4736,9780,0.15667229729729729,Texas
890,2015,Calhoun,female,742,65782,68691,134473,0.01080199735045348,Texas
891,2015,Calhoun,female,742,6991,7580,14571,0.09788918205804749,Texas
892,2015,Calhoun,female,742,7013,7700,14713,0.09636363636363636,Texas
893,2015,Calhoun,female,742,11062,10745,21807,0.06905537459283388,Texas
894,2015,Calhoun,female,742,3642,3754,7396,0.1976558337773042,Texas
906,2016,Calhoun,female,739,55315,59783,115098,0.0123613736346453,Texas
907,2016,Calhoun,female,739,2607,2595,5202,0.28477842003853565,Texas
908,2016,Calhoun,female,739,8048,6396,14444,0.11554096310193872,Texas
909,2016,Calhoun,female,739,3875,2553,6428,0.28946337641989817,Texas
910,2016,Calhoun,female,739,2435,2423,4858,0.3049938093272802,Texas
911,2016,Calhoun,female,739,5044,4736,9780,0.15603885135135134,Texas
912,2016,Calhoun,female,739,65782,68691,134473,0.010758323506718494,Texas
913,2016,Calhoun,female,739,6991,7580,14571,0.0974934036939314,Texas
914,2016,Calhoun,female,739,7013,7700,14713,0.09597402597402598,Texas
915,2016,Calhoun,female,739,11062,10745,21807,0.06877617496510005,Texas
916,2016,Calhoun,female,739,3642,3754,7396,0.1968566862013852,Texas
928,2009,Callahan,female,3124,6763,7007,13770,0.44583987441130296,Texas
930,2010,Callahan,female,3980,6763,7007,13770,0.5680034251462823,Texas
932,2011,Callahan,female,4402,6763,7007,13770,0.6282289139431997,Texas
934,2012,Callahan,female,3346,6763,7007,13770,0.4775224775224775,Texas
936,2013,Callahan,female,2027,6763,7007,13770,0.28928214642500355,Texas
938,2014,Callahan,female,2341,6763,7007,13770,0.3340944769516198,Texas
940,2015,Callahan,female,1992,6763,7007,13770,0.28428714142999856,Texas
942,2016,Callahan,female,2354,6763,7007,13770,0.3359497645211931,Texas
944,2009,Cameron,female,12461,3357,3511,6868,3.549131301623469,Texas
945,2009,Cameron,female,12461,2369,2317,4686,5.378075097108329,Texas
946,2009,Cameron,female,12461,204788,216962,421750,0.05743402070408643,Texas
950,2010,Cameron,female,14930,3357,3511,6868,4.2523497579037315,Texas
951,2010,Cameron,female,14930,2369,2317,4686,6.443677168752697,Texas
952,2010,Cameron,female,14930,204788,216962,421750,0.0688138936772338,Texas
956,2011,Cameron,female,16029,3357,3511,6868,4.565365992594702,Texas
957,2011,Cameron,female,16029,2369,2317,4686,6.91799741044454,Texas
958,2011,Cameron,female,16029,204788,216962,421750,0.07387929683539053,Texas
962,2012,Cameron,female,13336,3357,3511,6868,3.798348048988892,Texas
963,2012,Cameron,female,13336,2369,2317,4686,5.7557186016400514,Texas
964,2012,Cameron,female,13336,204788,216962,421750,0.061466985001981916,Texas
968,2013,Cameron,female,14649,3357,3511,6868,4.172315579606949,Texas
969,2013,Cameron,female,14649,2369,2317,4686,6.322399654725939,Texas
970,2013,Cameron,female,14649,204788,216962,421750,0.0675187359998525,Texas
974,2014,Cameron,female,8872,3357,3511,6868,2.5269154087154657,Texas
975,2014,Cameron,female,8872,2369,2317,4686,3.8290893396633576,Texas
976,2014,Cameron,female,8872,204788,216962,421750,0.04089195342963284,Texas
980,2015,Cameron,female,6210,3357,3511,6868,1.7687268584448874,Texas
981,2015,Cameron,female,6210,2369,2317,4686,2.6801899007337076,Texas
982,2015,Cameron,female,6210,204788,216962,421750,0.028622523759921092,Texas
986,2016,Cameron,female,10002,3357,3511,6868,2.848761036741669,Texas
987,2016,Cameron,female,10002,2369,2317,4686,4.316788951230039,Texas
988,2016,Cameron,female,10002,204788,216962,421750,0.04610023875148644,Texas
992,2009,Camp,female,766,6220,6593,12813,0.11618383133626574,Texas
994,2010,Camp,female,824,6220,6593,12813,0.12498104049749735,Texas
996,2011,Camp,female,1590,6220,6593,12813,0.2411648718337631,Texas
998,2012,Camp,female,1375,6220,6593,12813,0.20855452752919765,Texas
1000,2013,Camp,female,1021,6220,6593,12813,0.15486121644168058,Texas
1002,2014,Camp,female,1089,6220,6593,12813,0.1651751858031245,Texas
1004,2015,Camp,female,406,6220,6593,12813,0.06158046412862127,Texas
1006,2016,Camp,female,362,6220,6593,12813,0.05490671924768694,Texas
1008,2009,Carson,female,3281,2820,3212,6032,1.0214819427148194,Texas
1010,2010,Carson,female,3215,2820,3212,6032,1.0009339975093399,Texas
1012,2011,Carson,female,2702,2820,3212,6032,0.8412204234122043,Texas
1014,2012,Carson,female,2769,2820,3212,6032,0.862079701120797,Texas
1016,2013,Carson,female,2375,2820,3212,6032,0.7394146948941469,Texas
1018,2014,Carson,female,1865,2820,3212,6032,0.5806351183063512,Texas
1020,2015,Carson,female,1432,2820,3212,6032,0.44582814445828145,Texas
1022,2016,Carson,female,1729,2820,3212,6032,0.538293897882939,Texas
1024,2009,Cass,female,4036,6353,6312,12665,0.6394169835234474,Texas
1025,2009,Cass,female,4036,19082,19002,38084,0.21239869487422378,Texas
1026,2009,Cass,female,4036,6547,6644,13191,0.6074653822998194,Texas
1027,2009,Cass,female,4036,25789,25671,51460,0.15722020957500682,Texas
1028,2009,Cass,female,4036,14798,14224,29022,0.28374578177727783,Texas
1029,2009,Cass,female,4036,50364,52314,102678,0.07714952020491647,Texas
1030,2009,Cass,female,4036,12929,12773,25702,0.3159790182416034,Texas
1031,2009,Cass,female,4036,88346,85856,174202,0.047008945210585164,Texas
1032,2009,Cass,female,4036,14692,15395,30087,0.2621630399480351,Texas
1042,2010,Cass,female,4193,6353,6312,12665,0.6642902408111534,Texas
1043,2010,Cass,female,4193,19082,19002,38084,0.22066098305441534,Texas
1044,2010,Cass,female,4193,6547,6644,13191,0.6310957254665864,Texas
1045,2010,Cass,female,4193,25789,25671,51460,0.1633360601456897,Texas
1046,2010,Cass,female,4193,14798,14224,29022,0.2947834645669291,Texas
1047,2010,Cass,female,4193,50364,52314,102678,0.08015062889475093,Texas
1048,2010,Cass,female,4193,12929,12773,25702,0.32827057073514443,Texas
1049,2010,Cass,female,4193,88346,85856,174202,0.048837588520313086,Texas
1050,2010,Cass,female,4193,14692,15395,30087,0.2723611562195518,Texas
1060,2011,Cass,female,3930,6353,6312,12665,0.6226235741444867,Texas
1061,2011,Cass,female,3930,19082,19002,38084,0.20682033470161035,Texas
1062,2011,Cass,female,3930,6547,6644,13191,0.5915111378687538,Texas
1063,2011,Cass,female,3930,25789,25671,51460,0.15309103657824003,Texas
1064,2011,Cass,female,3930,14798,14224,29022,0.27629358830146233,Texas
1065,2011,Cass,female,3930,50364,52314,102678,0.07512329395572886,Texas
1066,2011,Cass,female,3930,12929,12773,25702,0.3076802630548814,Texas
1067,2011,Cass,female,3930,88346,85856,174202,0.04577431979127842,Texas
1068,2011,Cass,female,3930,14692,15395,30087,0.2552776875608964,Texas
1078,2012,Cass,female,4129,6353,6312,12665,0.6541508238276299,Texas
1079,2012,Cass,female,4129,19082,19002,38084,0.21729291653510158,Texas
1080,2012,Cass,female,4129,6547,6644,13191,0.6214629741119807,Texas
1081,2012,Cass,female,4129,25789,25671,51460,0.16084297456273616,Texas
1082,2012,Cass,female,4129,14798,14224,29022,0.2902840269966254,Texas
1083,2012,Cass,female,4129,50364,52314,102678,0.07892724700844898,Texas
1084,2012,Cass,female,4129,12929,12773,25702,0.32326000156580287,Texas
1085,2012,Cass,female,4129,88346,85856,174202,0.048092154304882596,Texas
1086,2012,Cass,female,4129,14692,15395,30087,0.2682039623254303,Texas
1096,2013,Cass,female,3685,6353,6312,12665,0.583808618504436,Texas
1097,2013,Cass,female,3685,19082,19002,38084,0.19392695505736238,Texas
1098,2013,Cass,female,3685,6547,6644,13191,0.554635761589404,Texas
1099,2013,Cass,female,3685,25789,25671,51460,0.14354719333099605,Texas
1100,2013,Cass,female,3685,14798,14224,29022,0.2590691788526434,Texas
1101,2013,Cass,female,3685,50364,52314,102678,0.07044003517222923,Texas
1102,2013,Cass,female,3685,12929,12773,25702,0.28849917795349567,Texas
1103,2013,Cass,female,3685,88346,85856,174202,0.04292070443533358,Texas
1104,2013,Cass,female,3685,14692,15395,30087,0.23936342968496266,Texas
1114,2014,Cass,female,2997,6353,6312,12665,0.47480988593155893,Texas
1115,2014,Cass,female,2997,19082,19002,38084,0.1577202399747395,Texas
1116,2014,Cass,female,2997,6547,6644,13191,0.4510836845273931,Texas
1117,2014,Cass,female,2997,25789,25671,51460,0.11674652331424565,Texas
1118,2014,Cass,female,2997,14798,14224,29022,0.2107002249718785,Texas
1119,2014,Cass,female,2997,50364,52314,102678,0.05728867989448331,Texas
1120,2014,Cass,female,2997,12929,12773,25702,0.23463555938307368,Texas
1121,2014,Cass,female,2997,88346,85856,174202,0.03490728661945583,Texas
1122,2014,Cass,female,2997,14692,15395,30087,0.19467359532315687,Texas
1132,2015,Cass,female,2452,6353,6312,12665,0.3884664131812421,Texas
1133,2015,Cass,female,2452,19082,19002,38084,0.1290390485212083,Texas
1134,2015,Cass,female,2452,6547,6644,13191,0.3690547862733293,Texas
1135,2015,Cass,female,2452,25789,25671,51460,0.09551634139690701,Texas
1136,2015,Cass,female,2452,14798,14224,29022,0.17238470191226096,Texas
1137,2015,Cass,female,2452,50364,52314,102678,0.04687081851894331,Texas
1138,2015,Cass,female,2452,12929,12773,25702,0.19196743130039928,Texas
1139,2015,Cass,female,2452,88346,85856,174202,0.02855944837868058,Texas
1140,2015,Cass,female,2452,14692,15395,30087,0.15927249106852875,Texas
1150,2016,Cass,female,2786,6353,6312,12665,0.4413814955640051,Texas
1151,2016,Cass,female,2786,19082,19002,38084,0.14661614566887696,Texas
1152,2016,Cass,female,2786,6547,6644,13191,0.4193257074051776,Texas
1153,2016,Cass,female,2786,25789,25671,51460,0.10852713178294573,Texas
1154,2016,Cass,female,2786,14798,14224,29022,0.19586614173228348,Texas
1155,2016,Cass,female,2786,50364,52314,102678,0.053255342738081586,Texas
1156,2016,Cass,female,2786,12929,12773,25702,0.21811633915290066,Texas
1157,2016,Cass,female,2786,88346,85856,174202,0.03244968319045844,Texas
1158,2016,Cass,female,2786,14692,15395,30087,0.18096784670347515,Texas
1168,2009,Castro,female,1002,3905,3882,7787,0.2581143740340031,Texas
1170,2010,Castro,female,1121,3905,3882,7787,0.288768675940237,Texas
1172,2011,Castro,female,1025,3905,3882,7787,0.26403915507470377,Texas
1174,2012,Castro,female,1312,3905,3882,7787,0.3379701184956208,Texas
1176,2013,Castro,female,1126,3905,3882,7787,0.2900566718186502,Texas
1178,2014,Castro,female,967,3905,3882,7787,0.24909840288511076,Texas
1180,2015,Castro,female,810,3905,3882,7787,0.20865533230293662,Texas
1182,2016,Castro,female,902,3905,3882,7787,0.23235445646573932,Texas
1184,2009,Chambers,female,4393,16257,17569,33826,0.25004268882691105,Texas
1185,2009,Chambers,female,4393,20377,19915,40292,0.22058749686166207,Texas
1188,2010,Chambers,female,6154,16257,17569,33826,0.3502760544140247,Texas
1189,2010,Chambers,female,6154,20377,19915,40292,0.3090133065528496,Texas
1192,2011,Chambers,female,6857,16257,17569,33826,0.3902897148386362,Texas
1193,2011,Chambers,female,6857,20377,19915,40292,0.3443133316595531,Texas
1196,2012,Chambers,female,6916,16257,17569,33826,0.39364790255563775,Texas
1197,2012,Chambers,female,6916,20377,19915,40292,0.34727592267135327,Texas
1200,2013,Chambers,female,6637,16257,17569,33826,0.3777676589447322,Texas
1201,2013,Chambers,female,6637,20377,19915,40292,0.3332663821240271,Texas
1204,2014,Chambers,female,5491,16257,17569,33826,0.31253913142466844,Texas
1205,2014,Chambers,female,5491,20377,19915,40292,0.27572181772533266,Texas
1208,2015,Chambers,female,5068,16257,17569,33826,0.2884626330468439,Texas
1209,2015,Chambers,female,5068,20377,19915,40292,0.254481546572935,Texas
1212,2016,Chambers,female,3994,16257,17569,33826,0.22733223291023963,Texas
1213,2016,Chambers,female,3994,20377,19915,40292,0.2005523474767763,Texas
1216,2009,Cherokee,female,2498,12820,13033,25853,0.19166730606920893,Texas
1217,2009,Cherokee,female,2498,119270,122640,241910,0.020368558382257013,Texas
1218,2009,Cherokee,female,2498,5796,5672,11468,0.44040902679830746,Texas
1219,2009,Cherokee,female,2498,9998,10333,20331,0.24174973386238266,Texas
1220,2009,Cherokee,female,2498,13583,14085,27668,0.17735179268725595,Texas
1221,2009,Cherokee,female,2498,23863,24736,48599,0.10098641655886158,Texas
1222,2009,Cherokee,female,2498,27529,29182,56711,0.08560071276814475,Texas
1223,2009,Cherokee,female,2498,26607,25296,51903,0.09875079063883618,Texas
1232,2010,Cherokee,female,3291,12820,13033,25853,0.2525128519910995,Texas
1233,2010,Cherokee,female,3291,119270,122640,241910,0.026834637964774952,Texas
1234,2010,Cherokee,female,3291,5796,5672,11468,0.5802186177715092,Texas
1235,2010,Cherokee,female,3291,9998,10333,20331,0.31849414497241846,Texas
1236,2010,Cherokee,female,3291,13583,14085,27668,0.2336528221512247,Texas
1237,2010,Cherokee,female,3291,23863,24736,48599,0.13304495472186287,Texas
1238,2010,Cherokee,female,3291,27529,29182,56711,0.11277499828661504,Texas
1239,2010,Cherokee,female,3291,26607,25296,51903,0.13009962049335863,Texas
1248,2011,Cherokee,female,4218,12820,13033,25853,0.3236399907926034,Texas
1249,2011,Cherokee,female,4218,119270,122640,241910,0.03439334637964775,Texas
1250,2011,Cherokee,female,4218,5796,5672,11468,0.7436530324400564,Texas
1251,2011,Cherokee,female,4218,9998,10333,20331,0.40820671634568856,Texas
1252,2011,Cherokee,female,4218,13583,14085,27668,0.29946751863684773,Texas
1253,2011,Cherokee,female,4218,23863,24736,48599,0.17052069857697283,Texas
1254,2011,Cherokee,female,4218,27529,29182,56711,0.14454115550681929,Texas
1255,2011,Cherokee,female,4218,26607,25296,51903,0.16674573055028463,Texas
1264,2012,Cherokee,female,5112,12820,13033,25853,0.3922350955267398,Texas
1265,2012,Cherokee,female,5112,119270,122640,241910,0.04168297455968689,Texas
1266,2012,Cherokee,female,5112,5796,5672,11468,0.9012693935119888,Texas
1267,2012,Cherokee,female,5112,9998,10333,20331,0.49472563631084876,Texas
1268,2012,Cherokee,female,5112,13583,14085,27668,0.36293929712460066,Texas
1269,2012,Cherokee,female,5112,23863,24736,48599,0.20666235446313067,Texas
1270,2012,Cherokee,female,5112,27529,29182,56711,0.17517647865122335,Texas
1271,2012,Cherokee,female,5112,26607,25296,51903,0.20208728652751423,Texas
1280,2013,Cherokee,female,4856,12820,13033,25853,0.3725926494283741,Texas
1281,2013,Cherokee,female,4856,119270,122640,241910,0.0395955642530985,Texas
1282,2013,Cherokee,female,4856,5796,5672,11468,0.8561354019746121,Texas
1283,2013,Cherokee,female,4856,9998,10333,20331,0.4699506435691474,Texas
1284,2013,Cherokee,female,4856,13583,14085,27668,0.34476393326233584,Texas
1285,2013,Cherokee,female,4856,23863,24736,48599,0.1963130659767141,Texas
1286,2013,Cherokee,female,4856,27529,29182,56711,0.16640394763895552,Texas
1287,2013,Cherokee,female,4856,26607,25296,51903,0.19196710942441492,Texas
1296,2014,Cherokee,female,3340,12820,13033,25853,0.2562725389396148,Texas
1297,2014,Cherokee,female,3340,119270,122640,241910,0.027234181343770383,Texas
1298,2014,Cherokee,female,3340,5796,5672,11468,0.5888575458392101,Texas
1299,2014,Cherokee,female,3340,9998,10333,20331,0.32323623342688473,Texas
1300,2014,Cherokee,female,3340,13583,14085,27668,0.23713170039048634,Texas
1301,2014,Cherokee,female,3340,23863,24736,48599,0.13502587322121604,Texas
1302,2014,Cherokee,female,3340,27529,29182,56711,0.11445411555068193,Texas
1303,2014,Cherokee,female,3340,26607,25296,51903,0.13203668564199875,Texas
1312,2015,Cherokee,female,2371,12820,13033,25853,0.18192281132509783,Texas
1313,2015,Cherokee,female,2371,119270,122640,241910,0.01933300717547293,Texas
1314,2015,Cherokee,female,2371,5796,5672,11468,0.41801833568406205,Texas
1315,2015,Cherokee,female,2371,9998,10333,20331,0.22945901480692926,Texas
1316,2015,Cherokee,female,2371,13583,14085,27668,0.1683351082712105,Texas
1317,2015,Cherokee,female,2371,23863,24736,48599,0.09585219922380336,Texas
1318,2015,Cherokee,female,2371,27529,29182,56711,0.0812487149612775,Texas
1319,2015,Cherokee,female,2371,26607,25296,51903,0.09373023402909551,Texas
1328,2016,Cherokee,female,2717,12820,13033,25853,0.2084708048799202,Texas
1329,2016,Cherokee,female,2717,119270,122640,241910,0.0221542726679713,Texas
1330,2016,Cherokee,female,2717,5796,5672,11468,0.4790197461212976,Texas
1331,2016,Cherokee,female,2717,9998,10333,20331,0.26294396593438496,Texas
1332,2016,Cherokee,female,2717,13583,14085,27668,0.1929002484913028,Texas
1333,2016,Cherokee,female,2717,23863,24736,48599,0.10983990944372575,Texas
1334,2016,Cherokee,female,2717,27529,29182,56711,0.09310533890754574,Texas
1335,2016,Cherokee,female,2717,26607,25296,51903,0.10740828589500316,Texas
1344,2009,Childress,female,1696,4449,2777,7226,0.6107310046813108,Texas
1346,2010,Childress,female,1350,4449,2777,7226,0.48613611811307167,Texas
1348,2011,Childress,female,1513,4449,2777,7226,0.5448325531148721,Texas
1350,2012,Childress,female,1878,4449,2777,7226,0.6762693554195175,Texas
1352,2013,Childress,female,1308,4449,2777,7226,0.4710118833273316,Texas
1354,2014,Childress,female,902,4449,2777,7226,0.32481094706517827,Texas
1356,2015,Childress,female,861,4449,2777,7226,0.3100468131076701,Texas
1358,2016,Childress,female,842,4449,2777,7226,0.30320489737126394,Texas
1360,2009,Clay,female,3162,6464,6914,13378,0.45733294764246457,Texas
1361,2009,Clay,female,3162,7414,7647,15061,0.41349548842683403,Texas
1362,2009,Clay,female,3162,102225,105066,207291,0.03009536862543544,Texas
1363,2009,Clay,female,3162,1473,1528,3001,2.069371727748691,Texas
1364,2009,Clay,female,3162,6586,6752,13338,0.46830568720379145,Texas
1365,2009,Clay,female,3162,12935,13333,26268,0.23715592889822246,Texas
1366,2009,Clay,female,3162,8051,8262,16313,0.38271604938271603,Texas
1367,2009,Clay,female,3162,4078,4064,8142,0.7780511811023622,Texas
1368,2009,Clay,female,3162,10827,9794,20621,0.3228507249336328,Texas
1369,2009,Clay,female,3162,31010,31791,62801,0.09946211191846749,Texas
1370,2009,Clay,female,3162,9177,10631,19808,0.29743203837832755,Texas
1371,2009,Clay,female,3162,117296,121868,239164,0.02594610562247678,Texas
1372,2009,Clay,female,3162,3165,3067,6232,1.0309748940332573,Texas
1373,2009,Clay,female,3162,5125,5688,10813,0.5559071729957806,Texas
1374,2009,Clay,female,3162,6879,7046,13925,0.44876525688333807,Texas
1375,2009,Clay,female,3162,3771,3915,7686,0.8076628352490421,Texas
1376,2009,Clay,female,3162,5195,5192,10387,0.6090138674884438,Texas
1377,2009,Clay,female,3162,4388,4397,8785,0.7191266772799636,Texas
1396,2010,Clay,female,2518,6464,6914,13378,0.3641886028348279,Texas
1397,2010,Clay,female,2518,7414,7647,15061,0.3292794559958154,Texas
1398,2010,Clay,female,2518,102225,105066,207291,0.023965888108427084,Texas
1399,2010,Clay,female,2518,1473,1528,3001,1.6479057591623036,Texas
1400,2010,Clay,female,2518,6586,6752,13338,0.3729265402843602,Texas
1401,2010,Clay,female,2518,12935,13333,26268,0.1888547213680342,Texas
1402,2010,Clay,female,2518,8051,8262,16313,0.3047688211086904,Texas
1403,2010,Clay,female,2518,4078,4064,8142,0.6195866141732284,Texas
1404,2010,Clay,female,2518,10827,9794,20621,0.25709618133551154,Texas
1405,2010,Clay,female,2518,31010,31791,62801,0.0792048063917461,Texas
1406,2010,Clay,female,2518,9177,10631,19808,0.2368544821747719,Texas
1407,2010,Clay,female,2518,117296,121868,239164,0.020661699543768668,Texas
1408,2010,Clay,female,2518,3165,3067,6232,0.820997717639387,Texas
1409,2010,Clay,female,2518,5125,5688,10813,0.4426863572433193,Texas
1410,2010,Clay,female,2518,6879,7046,13925,0.3573658813511212,Texas
1411,2010,Clay,female,2518,3771,3915,7686,0.6431673052362707,Texas
1412,2010,Clay,female,2518,5195,5192,10387,0.4849768875192604,Texas
1413,2010,Clay,female,2518,4388,4397,8785,0.5726631794405276,Texas
1432,2011,Clay,female,2745,6464,6914,13378,0.3970205380387619,Texas
1433,2011,Clay,female,2745,7414,7647,15061,0.3589642997253825,Texas
1434,2011,Clay,female,2745,102225,105066,207291,0.02612643481240363,Texas
1435,2011,Clay,female,2745,1473,1528,3001,1.7964659685863875,Texas
1436,2011,Clay,female,2745,6586,6752,13338,0.4065462085308057,Texas
1437,2011,Clay,female,2745,12935,13333,26268,0.2058801470036751,Texas
1438,2011,Clay,female,2745,8051,8262,16313,0.332244008714597,Texas
1439,2011,Clay,female,2745,4078,4064,8142,0.6754429133858267,Texas
1440,2011,Clay,female,2745,10827,9794,20621,0.2802736369205636,Texas
1441,2011,Clay,female,2745,31010,31791,62801,0.08634519203548174,Texas
1442,2011,Clay,female,2745,9177,10631,19808,0.2582071300912426,Texas
1443,2011,Clay,female,2745,117296,121868,239164,0.022524370630518264,Texas
1444,2011,Clay,female,2745,3165,3067,6232,0.8950114118030649,Texas
1445,2011,Clay,female,2745,5125,5688,10813,0.4825949367088608,Texas
1446,2011,Clay,female,2745,6879,7046,13925,0.38958274198126597,Texas
1447,2011,Clay,female,2745,3771,3915,7686,0.7011494252873564,Texas
1448,2011,Clay,female,2745,5195,5192,10387,0.5286979969183359,Texas
1449,2011,Clay,female,2745,4388,4397,8785,0.624289288151012,Texas
1468,2012,Clay,female,2466,6464,6914,13378,0.35666763089383857,Texas
1469,2012,Clay,female,2466,7414,7647,15061,0.32247940368772066,Texas
1470,2012,Clay,female,2466,102225,105066,207291,0.023470961110159328,Texas
1471,2012,Clay,female,2466,1473,1528,3001,1.6138743455497382,Texas
1472,2012,Clay,female,2466,6586,6752,13338,0.3652251184834123,Texas
1473,2012,Clay,female,2466,12935,13333,26268,0.18495462386559663,Texas
1474,2012,Clay,female,2466,8051,8262,16313,0.2984749455337691,Texas
1475,2012,Clay,female,2466,4078,4064,8142,0.6067913385826772,Texas
1476,2012,Clay,female,2466,10827,9794,20621,0.2517868082499489,Texas
1477,2012,Clay,female,2466,31010,31791,62801,0.07756912333679343,Texas
1478,2012,Clay,female,2466,9177,10631,19808,0.2319631267049196,Texas
1479,2012,Clay,female,2466,117296,121868,239164,0.020235008369711493,Texas
1480,2012,Clay,female,2466,3165,3067,6232,0.8040430388001304,Texas
1481,2012,Clay,female,2466,5125,5688,10813,0.43354430379746833,Texas
1482,2012,Clay,female,2466,6879,7046,13925,0.3499858075503832,Texas
1483,2012,Clay,female,2466,3771,3915,7686,0.6298850574712643,Texas
1484,2012,Clay,female,2466,5195,5192,10387,0.47496147919876736,Texas
1485,2012,Clay,female,2466,4388,4397,8785,0.5608369342733682,Texas
1504,2013,Clay,female,2747,6464,6914,13378,0.39730980619033845,Texas
1505,2013,Clay,female,2747,7414,7647,15061,0.35922584019877074,Texas
1506,2013,Clay,female,2747,102225,105066,207291,0.026145470466183162,Texas
1507,2013,Clay,female,2747,1473,1528,3001,1.7977748691099475,Texas
1508,2013,Clay,female,2747,6586,6752,13338,0.4068424170616114,Texas
1509,2013,Clay,female,2747,12935,13333,26268,0.20603015075376885,Texas
1510,2013,Clay,female,2747,8051,8262,16313,0.3324860808520939,Texas
1511,2013,Clay,female,2747,4078,4064,8142,0.6759350393700787,Texas
1512,2013,Clay,female,2747,10827,9794,20621,0.2804778435777006,Texas
1513,2013,Clay,female,2747,31010,31791,62801,0.08640810292221068,Texas
1514,2013,Clay,female,2747,9177,10631,19808,0.2583952591477754,Texas
1515,2013,Clay,female,2747,117296,121868,239164,0.022540781829520466,Texas
1516,2013,Clay,female,2747,3165,3067,6232,0.895663514835344,Texas
1517,2013,Clay,female,2747,5125,5688,10813,0.48294655414908577,Texas
1518,2013,Clay,female,2747,6879,7046,13925,0.38986659097360205,Texas
1519,2013,Clay,female,2747,3771,3915,7686,0.7016602809706258,Texas
1520,2013,Clay,female,2747,5195,5192,10387,0.5290832049306625,Texas
1521,2013,Clay,female,2747,4388,4397,8785,0.6247441437343644,Texas
1540,2014,Clay,female,2117,6464,6914,13378,0.30619033844373733,Texas
1541,2014,Clay,female,2117,7414,7647,15061,0.27684059108146986,Texas
1542,2014,Clay,female,2117,102225,105066,207291,0.020149239525631506,Texas
1543,2014,Clay,female,2117,1473,1528,3001,1.3854712041884816,Texas
1544,2014,Clay,female,2117,6586,6752,13338,0.3135367298578199,Texas
1545,2014,Clay,female,2117,12935,13333,26268,0.15877896947423686,Texas
1546,2014,Clay,female,2117,8051,8262,16313,0.2562333575405471,Texas
1547,2014,Clay,female,2117,4078,4064,8142,0.5209153543307087,Texas
1548,2014,Clay,female,2117,10827,9794,20621,0.21615274657953848,Texas
1549,2014,Clay,female,2117,31010,31791,62801,0.06659117360259192,Texas
1550,2014,Clay,female,2117,9177,10631,19808,0.1991346063399492,Texas
1551,2014,Clay,female,2117,117296,121868,239164,0.017371254143827747,Texas
1552,2014,Clay,female,2117,3165,3067,6232,0.6902510596674275,Texas
1553,2014,Clay,female,2117,5125,5688,10813,0.3721870604781997,Texas
1554,2014,Clay,female,2117,6879,7046,13925,0.3004541583877377,Texas
1555,2014,Clay,female,2117,3771,3915,7686,0.5407407407407407,Texas
1556,2014,Clay,female,2117,5195,5192,10387,0.4077426810477658,Texas
1557,2014,Clay,female,2117,4388,4397,8785,0.48146463497839437,Texas
1576,2015,Clay,female,1455,6464,6914,13378,0.21044258027191207,Texas
1577,2015,Clay,female,1455,7414,7647,15061,0.19027069438995683,Texas
1578,2015,Clay,female,1455,102225,105066,207291,0.01384843812460739,Texas
1579,2015,Clay,female,1455,1473,1528,3001,0.9522251308900523,Texas
1580,2015,Clay,female,1455,6586,6752,13338,0.21549170616113744,Texas
1581,2015,Clay,female,1455,12935,13333,26268,0.10912772819320483,Texas
1582,2015,Clay,female,1455,8051,8262,16313,0.17610748002904866,Texas
1583,2015,Clay,female,1455,4078,4064,8142,0.35802165354330706,Texas
1584,2015,Clay,female,1455,10827,9794,20621,0.148560343067184,Texas
1585,2015,Clay,female,1455,31010,31791,62801,0.04576767009530999,Texas
1586,2015,Clay,female,1455,9177,10631,19808,0.13686388862759855,Texas
1587,2015,Clay,female,1455,117296,121868,239164,0.011939147274099846,Texas
1588,2015,Clay,female,1455,3165,3067,6232,0.47440495598304533,Texas
1589,2015,Clay,female,1455,5125,5688,10813,0.2558016877637131,Texas
1590,2015,Clay,female,1455,6879,7046,13925,0.20650014192449617,Texas
1591,2015,Clay,female,1455,3771,3915,7686,0.3716475095785441,Texas
1592,2015,Clay,female,1455,5195,5192,10387,0.2802388289676425,Texas
1593,2015,Clay,female,1455,4388,4397,8785,0.3309074368887878,Texas
1612,2016,Clay,female,1854,6464,6914,13378,0.26815157651142607,Texas
1613,2016,Clay,female,1854,7414,7647,15061,0.24244801883091407,Texas
1614,2016,Clay,female,1854,102225,105066,207291,0.01764605105362344,Texas
1615,2016,Clay,female,1854,1473,1528,3001,1.213350785340314,Texas
1616,2016,Clay,female,1854,6586,6752,13338,0.27458530805687204,Texas
1617,2016,Clay,female,1854,12935,13333,26268,0.13905347633690843,Texas
1618,2016,Clay,female,1854,8051,8262,16313,0.22440087145969498,Texas
1619,2016,Clay,female,1854,4078,4064,8142,0.4562007874015748,Texas
1620,2016,Clay,female,1854,10827,9794,20621,0.18929957116602,Texas
1621,2016,Clay,female,1854,31010,31791,62801,0.05831839199773521,Texas
1622,2016,Clay,female,1854,9177,10631,19808,0.17439563540588843,Texas
1623,2016,Clay,female,1854,117296,121868,239164,0.015213181475038567,Texas
1624,2016,Clay,female,1854,3165,3067,6232,0.6044995109227258,Texas
1625,2016,Clay,female,1854,5125,5688,10813,0.3259493670886076,Texas
1626,2016,Clay,female,1854,6879,7046,13925,0.2631280158955436,Texas
1627,2016,Clay,female,1854,3771,3915,7686,0.4735632183908046,Texas
1628,2016,Clay,female,1854,5195,5192,10387,0.3570878274268105,Texas
1629,2016,Clay,female,1854,4388,4397,8785,0.4216511257675688,Texas
1648,2009,Cochran,female,83,1491,1413,2904,0.05874026893135174,Texas
1650,2010,Cochran,female,140,1491,1413,2904,0.09907997169143666,Texas
1652,2011,Cochran,female,41,1491,1413,2904,0.029016277423920735,Texas
1654,2012,Cochran,female,60,1491,1413,2904,0.04246284501061571,Texas
1656,2013,Cochran,female,90,1491,1413,2904,0.06369426751592357,Texas
1658,2014,Cochran,female,48,1491,1413,2904,0.03397027600849257,Texas
1660,2015,Cochran,female,36,1491,1413,2904,0.025477707006369428,Texas
1662,2016,Cochran,female,20,1491,1413,2904,0.014154281670205236,Texas
1664,2009,Coke,female,762,1606,1669,3275,0.45656081485919714,Texas
1666,2010,Coke,female,245,1606,1669,3275,0.14679448771719592,Texas
1668,2011,Coke,female,392,1606,1669,3275,0.23487118034751348,Texas
1670,2012,Coke,female,243,1606,1669,3275,0.14559616536848413,Texas
1672,2013,Coke,female,41,1606,1669,3275,0.02456560814859197,Texas
1674,2014,Coke,female,200,1606,1669,3275,0.11983223487118035,Texas
1676,2015,Coke,female,339,1606,1669,3275,0.20311563810665068,Texas
1678,2016,Coke,female,270,1606,1669,3275,0.16177351707609347,Texas
1680,2009,Coleman,female,840,4220,4171,8391,0.20139055382402302,Texas
1682,2010,Coleman,female,1304,4220,4171,8391,0.3126348597458643,Texas
1684,2011,Coleman,female,1190,4220,4171,8391,0.2853032845840326,Texas
1686,2012,Coleman,female,1178,4220,4171,8391,0.28242627667226083,Texas
1688,2013,Coleman,female,1041,4220,4171,8391,0.24958043634619995,Texas
1690,2014,Coleman,female,827,4220,4171,8391,0.19827379525293695,Texas
1692,2015,Coleman,female,583,4220,4171,8391,0.13977463438024454,Texas
1694,2016,Coleman,female,635,4220,4171,8391,0.15224166866458883,Texas
1696,2009,Collin,female,13265,464248,480102,944350,0.02762954538827166,Texas
1698,2010,Collin,female,10133,464248,480102,944350,0.021105931656189725,Texas
1700,2011,Collin,female,11091,464248,480102,944350,0.023101340965044927,Texas
1702,2012,Collin,female,12562,464248,480102,944350,0.02616527321277562,Texas
1704,2013,Collin,female,10210,464248,480102,944350,0.021266314241557,Texas
1706,2014,Collin,female,6247,464248,480102,944350,0.01301181832193992,Texas
1708,2015,Collin,female,9332,464248,480102,944350,0.019437536190226243,Texas
1710,2016,Collin,female,8438,464248,480102,944350,0.017575431887390598,Texas
1712,2009,Collingsworth,female,279,1496,1500,2996,0.186,Texas
1714,2010,Collingsworth,female,201,1496,1500,2996,0.134,Texas
1716,2011,Collingsworth,female,166,1496,1500,2996,0.11066666666666666,Texas
1718,2012,Collingsworth,female,231,1496,1500,2996,0.154,Texas
1720,2013,Collingsworth,female,92,1496,1500,2996,0.06133333333333333,Texas
1722,2014,Collingsworth,female,105,1496,1500,2996,0.07,Texas
1724,2015,Collingsworth,female,360,1496,1500,2996,0.24,Texas
1726,2016,Collingsworth,female,293,1496,1500,2996,0.19533333333333333,Texas
1728,2009,Colorado,female,4202,10538,10484,21022,0.40080122090805037,Texas
1730,2010,Colorado,female,5168,10538,10484,21022,0.49294162533384206,Texas
1732,2011,Colorado,female,4531,10538,10484,21022,0.4321823731400229,Texas
1734,2012,Colorado,female,3661,10538,10484,21022,0.34919877909194963,Texas
1736,2013,Colorado,female,2760,10538,10484,21022,0.2632582983594048,Texas
1738,2014,Colorado,female,3470,10538,10484,21022,0.33098054177794733,Texas
1740,2015,Colorado,female,3478,10538,10484,21022,0.33174360930942387,Texas
1742,2016,Colorado,female,3181,10538,10484,21022,0.3034147272033575,Texas
1744,2009,Comal,female,3853,66793,68304,135097,0.05640958069805575,Texas
1746,2010,Comal,female,4135,66793,68304,135097,0.06053818224408527,Texas
1748,2011,Comal,female,4852,66793,68304,135097,0.07103537128133053,Texas
1750,2012,Comal,female,4987,66793,68304,135097,0.07301182946825954,Texas
1752,2013,Comal,female,4131,66793,68304,135097,0.06047962052002811,Texas
1754,2014,Comal,female,4107,66793,68304,135097,0.06012825017568517,Texas
1756,2015,Comal,female,3446,66793,68304,135097,0.0504509252752401,Texas
1758,2016,Comal,female,3345,66793,68304,135097,0.04897224174279691,Texas
1760,2009,Comanche,female,1144,912,868,1780,1.3179723502304148,Texas
1761,2009,Comanche,female,1144,63585,58976,122561,0.01939772110689094,Texas
1762,2009,Comanche,female,1144,6738,6757,13495,0.16930590498742046,Texas
1766,2010,Comanche,female,1549,912,868,1780,1.7845622119815667,Texas
1767,2010,Comanche,female,1549,63585,58976,122561,0.026264921323928377,Texas
1768,2010,Comanche,female,1549,6738,6757,13495,0.2292437472250999,Texas
1772,2011,Comanche,female,1495,912,868,1780,1.7223502304147464,Texas
1773,2011,Comanche,female,1495,63585,58976,122561,0.025349294628323384,Texas
1774,2011,Comanche,female,1495,6738,6757,13495,0.22125203492674264,Texas
1778,2012,Comanche,female,1653,912,868,1780,1.9043778801843319,Texas
1779,2012,Comanche,female,1653,63585,58976,122561,0.02802835051546392,Texas
1780,2012,Comanche,female,1653,6738,6757,13495,0.2446351931330472,Texas
1784,2013,Comanche,female,1040,912,868,1780,1.1981566820276497,Texas
1785,2013,Comanche,female,1040,63585,58976,122561,0.0176342919153554,Texas
1786,2013,Comanche,female,1040,6738,6757,13495,0.15391445907947313,Texas
1790,2014,Comanche,female,684,912,868,1780,0.7880184331797235,Texas
1791,2014,Comanche,female,684,63585,58976,122561,0.011597938144329897,Texas
1792,2014,Comanche,female,684,6738,6757,13495,0.10122835577919195,Texas
1796,2015,Comanche,female,689,912,868,1780,0.793778801843318,Texas
1797,2015,Comanche,female,689,63585,58976,122561,0.011682718393922951,Texas
1798,2015,Comanche,female,689,6738,6757,13495,0.10196832914015096,Texas
1802,2016,Comanche,female,700,912,868,1780,0.8064516129032258,Texas
1803,2016,Comanche,female,700,63585,58976,122561,0.011869234943027673,Texas
1804,2016,Comanche,female,700,6738,6757,13495,0.10359627053426076,Texas
1808,2009,Concho,female,1332,2802,1431,4233,0.9308176100628931,Texas
1810,2010,Concho,female,889,2802,1431,4233,0.6212438853948288,Texas
1812,2011,Concho,female,798,2802,1431,4233,0.5576519916142557,Texas
1814,2012,Concho,female,832,2802,1431,4233,0.5814116002795248,Texas
1816,2013,Concho,female,568,2802,1431,4233,0.3969252271139064,Texas
1818,2014,Concho,female,669,2802,1431,4233,0.46750524109014674,Texas
1820,2015,Concho,female,396,2802,1431,4233,0.27672955974842767,Texas
1822,2016,Concho,female,285,2802,1431,4233,0.19916142557651992,Texas
1824,2009,Cooke,female,4866,19660,19911,39571,0.2443875244839536,Texas
1826,2010,Cooke,female,4558,19660,19911,39571,0.22891868816232233,Texas
1828,2011,Cooke,female,4922,19660,19911,39571,0.24720004017879563,Texas
1830,2012,Cooke,female,4844,19660,19911,39571,0.24328260760383708,Texas
1832,2013,Cooke,female,4733,19660,19911,39571,0.23770779970870373,Texas
1834,2014,Cooke,female,3621,19660,19911,39571,0.1818592737682688,Texas
1836,2015,Cooke,female,2692,19660,19911,39571,0.13520164733062126,Texas
1838,2016,Cooke,female,3357,19660,19911,39571,0.16860027120687057,Texas
1840,2009,Coryell,female,1611,37630,37759,75389,0.042665324823220954,Texas
1842,2010,Coryell,female,2209,37630,37759,75389,0.058502608649593474,Texas
1844,2011,Coryell,female,2082,37630,37759,75389,0.055139172117905665,Texas
1846,2012,Coryell,female,2044,37630,37759,75389,0.05413278953362112,Texas
1848,2013,Coryell,female,2070,37630,37759,75389,0.05482136709128949,Texas
1850,2014,Coryell,female,1583,37630,37759,75389,0.04192377976111655,Texas
1852,2015,Coryell,female,1141,37630,37759,75389,0.030217961280754258,Texas
1854,2016,Coryell,female,1521,37630,37759,75389,0.04028178712359967,Texas
1856,2009,Cottle,female,426,792,831,1623,0.5126353790613718,Texas
1858,2010,Cottle,female,699,792,831,1623,0.8411552346570397,Texas
1860,2011,Cottle,female,680,792,831,1623,0.8182912154031288,Texas
1862,2012,Cottle,female,549,792,831,1623,0.6606498194945848,Texas
1864,2013,Cottle,female,165,792,831,1623,0.19855595667870035,Texas
1866,2014,Cottle,female,226,792,831,1623,0.2719614921780987,Texas
1868,2015,Cottle,female,113,792,831,1623,0.13598074608904934,Texas
1870,2016,Cottle,female,163,792,831,1623,0.19614921780986763,Texas
1872,2009,Crane,female,365,2511,2328,4839,0.156786941580756,Texas
1874,2010,Crane,female,197,2511,2328,4839,0.08462199312714777,Texas
1876,2011,Crane,female,330,2511,2328,4839,0.14175257731958762,Texas
1878,2012,Crane,female,362,2511,2328,4839,0.15549828178694158,Texas
1880,2013,Crane,female,188,2511,2328,4839,0.08075601374570447,Texas
1882,2014,Crane,female,164,2511,2328,4839,0.070446735395189,Texas
1884,2015,Crane,female,143,2511,2328,4839,0.06142611683848797,Texas
1886,2016,Crane,female,232,2511,2328,4839,0.09965635738831616,Texas
1888,2009,Crockett,female,2935,6907,7592,14499,0.38659114857745,Texas
1889,2009,Crockett,female,2935,1771,1862,3633,1.5762620837808807,Texas
1892,2010,Crockett,female,2313,6907,7592,14499,0.3046628029504742,Texas
1893,2010,Crockett,female,2313,1771,1862,3633,1.2422126745435016,Texas
1896,2011,Crockett,female,2202,6907,7592,14499,0.29004214963119074,Texas
1897,2011,Crockett,female,2202,1771,1862,3633,1.1825993555316863,Texas
1900,2012,Crockett,female,1623,6907,7592,14499,0.2137776606954689,Texas
1901,2012,Crockett,female,1623,1771,1862,3633,0.8716433941997852,Texas
1904,2013,Crockett,female,1248,6907,7592,14499,0.1643835616438356,Texas
1905,2013,Crockett,female,1248,1771,1862,3633,0.6702470461868958,Texas
1908,2014,Crockett,female,1389,6907,7592,14499,0.18295574288724975,Texas
1909,2014,Crockett,female,1389,1771,1862,3633,0.7459720730397422,Texas
1912,2015,Crockett,female,1940,6907,7592,14499,0.2555321390937829,Texas
1913,2015,Crockett,female,1940,1771,1862,3633,1.0418904403866809,Texas
1916,2016,Crockett,female,2335,6907,7592,14499,0.30756059009483666,Texas
1917,2016,Crockett,female,2335,1771,1862,3633,1.2540279269602579,Texas
1920,2009,Crosby,female,1205,2921,2940,5861,0.4098639455782313,Texas
1922,2010,Crosby,female,1088,2921,2940,5861,0.37006802721088433,Texas
1924,2011,Crosby,female,1106,2921,2940,5861,0.3761904761904762,Texas
1926,2012,Crosby,female,847,2921,2940,5861,0.28809523809523807,Texas
1928,2013,Crosby,female,332,2921,2940,5861,0.11292517006802721,Texas
1930,2014,Crosby,female,349,2921,2940,5861,0.11870748299319728,Texas
1932,2015,Crosby,female,382,2921,2940,5861,0.12993197278911564,Texas
1934,2016,Crosby,female,578,2921,2940,5861,0.19659863945578232,Texas
1936,2009,Culberson,female,2668,1231,1010,2241,2.6415841584158417,Texas
1938,2010,Culberson,female,2491,1231,1010,2241,2.4663366336633663,Texas
1940,2011,Culberson,female,2359,1231,1010,2241,2.3356435643564355,Texas
1942,2012,Culberson,female,1312,1231,1010,2241,1.299009900990099,Texas
1944,2013,Culberson,female,1807,1231,1010,2241,1.7891089108910891,Texas
1946,2014,Culberson,female,1454,1231,1010,2241,1.4396039603960396,Texas
1948,2015,Culberson,female,3114,1231,1010,2241,3.0831683168316832,Texas
1950,2016,Culberson,female,3750,1231,1010,2241,3.712871287128713,Texas
1952,2009,Dallam,female,751,3795,3448,7243,0.2178074245939675,Texas
1954,2010,Dallam,female,982,3795,3448,7243,0.2848027842227378,Texas
1956,2011,Dallam,female,1556,3795,3448,7243,0.45127610208816704,Texas
1958,2012,Dallam,female,963,3795,3448,7243,0.279292343387471,Texas
1960,2013,Dallam,female,932,3795,3448,7243,0.2703016241299304,Texas
1962,2014,Dallam,female,692,3795,3448,7243,0.20069605568445475,Texas
1964,2015,Dallam,female,633,3795,3448,7243,0.183584686774942,Texas
1966,2016,Dallam,female,529,3795,3448,7243,0.15342227378190254,Texas
1968,2009,Dallas,female,5322,18448,21581,40029,0.24660581066679024,Texas
1969,2009,Dallas,female,5322,3618,3814,7432,1.3953854221289985,Texas
1970,2009,Dallas,female,5322,41367,42635,84002,0.12482702005394629,Texas
1971,2009,Dallas,female,5322,8212,8287,16499,0.642210691444431,Texas
1972,2009,Dallas,female,5322,1275226,1311326,2586552,0.00405848736317285,Texas
1978,2010,Dallas,female,4657,18448,21581,40029,0.21579166859737733,Texas
1979,2010,Dallas,female,4657,3618,3814,7432,1.2210277923439958,Texas
1980,2010,Dallas,female,4657,41367,42635,84002,0.10922950627418787,Texas
1981,2010,Dallas,female,4657,8212,8287,16499,0.5619645227464704,Texas
1982,2010,Dallas,female,4657,1275226,1311326,2586552,0.003551367089495671,Texas
1988,2011,Dallas,female,6940,18448,21581,40029,0.32157916685973775,Texas
1989,2011,Dallas,female,6940,3618,3814,7432,1.8196119559517567,Texas
1990,2011,Dallas,female,6940,41367,42635,84002,0.16277706110003518,Texas
1991,2011,Dallas,female,6940,8212,8287,16499,0.8374562567877398,Texas
1992,2011,Dallas,female,6940,1275226,1311326,2586552,0.0052923529313076995,Texas
1998,2012,Dallas,female,10455,18448,21581,40029,0.4844539177980631,Texas
1999,2012,Dallas,female,10455,3618,3814,7432,2.7412165705296276,Texas
2000,2012,Dallas,female,10455,41367,42635,84002,0.24522106250732967,Texas
2001,2012,Dallas,female,10455,8212,8287,16499,1.261614577048389,Texas
2002,2012,Dallas,female,10455,1275226,1311326,2586552,0.007972845806458502,Texas
2008,2013,Dallas,female,8318,18448,21581,40029,0.3854316296742505,Texas
2009,2013,Dallas,female,8318,3618,3814,7432,2.180912427897221,Texas
2010,2013,Dallas,female,8318,41367,42635,84002,0.19509792424064737,Texas
2011,2013,Dallas,female,8318,8212,8287,16499,1.003740798841559,Texas
2012,2013,Dallas,female,8318,1275226,1311326,2586552,0.006343197648792139,Texas
2018,2014,Dallas,female,4027,18448,21581,40029,0.18659932347898614,Texas
2019,2014,Dallas,female,4027,3618,3814,7432,1.0558468799160985,Texas
2020,2014,Dallas,female,4027,41367,42635,84002,0.09445291427231148,Texas
2021,2014,Dallas,female,4027,8212,8287,16499,0.48594183661156026,Texas
2022,2014,Dallas,female,4027,1275226,1311326,2586552,0.0030709373565383437,Texas
2028,2015,Dallas,female,4910,18448,21581,40029,0.22751494370047728,Texas
2029,2015,Dallas,female,4910,3618,3814,7432,1.2873623492396433,Texas
2030,2015,Dallas,female,4910,41367,42635,84002,0.11516359798287791,Texas
2031,2015,Dallas,female,4910,8212,8287,16499,0.5924942681308073,Texas
2032,2015,Dallas,female,4910,1275226,1311326,2586552,0.0037443015695563116,Texas
2038,2016,Dallas,female,3733,18448,21581,40029,0.17297622909040358,Texas
2039,2016,Dallas,female,3733,3618,3814,7432,0.9787624541164132,Texas
2040,2016,Dallas,female,3733,41367,42635,84002,0.0875571713381025,Texas
2041,2016,Dallas,female,3733,8212,8287,16499,0.45046458308193554,Texas
2042,2016,Dallas,female,3733,1275226,1311326,2586552,0.002846736814491591,Texas
2048,2009,Dawson,female,1031,11774,12087,23861,0.08529825432282617,Texas
2049,2009,Dawson,female,1031,4877,4314,9191,0.23898933704218822,Texas
2050,2009,Dawson,female,1031,12241,11563,23804,0.08916371183948803,Texas
2051,2009,Dawson,female,1031,7235,5729,12964,0.1799615988828766,Texas
2056,2010,Dawson,female,1438,11774,12087,23861,0.11897079506908248,Texas
2057,2010,Dawson,female,1438,4877,4314,9191,0.3333333333333333,Texas
2058,2010,Dawson,female,1438,12241,11563,23804,0.12436218974314624,Texas
2059,2010,Dawson,female,1438,7235,5729,12964,0.25100366556118,Texas
2064,2011,Dawson,female,2108,11774,12087,23861,0.17440225035161744,Texas
2065,2011,Dawson,female,2108,4877,4314,9191,0.48864163189615206,Texas
2066,2011,Dawson,female,2108,12241,11563,23804,0.18230563002680966,Texas
2067,2011,Dawson,female,2108,7235,5729,12964,0.36795252225519287,Texas
2072,2012,Dawson,female,1863,11774,12087,23861,0.154132539091586,Texas
2073,2012,Dawson,female,1863,4877,4314,9191,0.4318497913769124,Texas
2074,2012,Dawson,female,1863,12241,11563,23804,0.1611173570872611,Texas
2075,2012,Dawson,female,1863,7235,5729,12964,0.3251876418223076,Texas
2080,2013,Dawson,female,949,11774,12087,23861,0.07851410606436668,Texas
2081,2013,Dawson,female,949,4877,4314,9191,0.21998145572554473,Texas
2082,2013,Dawson,female,949,12241,11563,23804,0.08207212661074116,Texas
2083,2013,Dawson,female,949,7235,5729,12964,0.16564845522778845,Texas
2088,2014,Dawson,female,473,11774,12087,23861,0.03913295275916274,Texas
2089,2014,Dawson,female,473,4877,4314,9191,0.1096430227167362,Texas
2090,2014,Dawson,female,473,12241,11563,23804,0.04090633918533253,Texas
2091,2014,Dawson,female,473,7235,5729,12964,0.08256240181532554,Texas
2096,2015,Dawson,female,752,11774,12087,23861,0.06221560354099446,Texas
2097,2015,Dawson,female,752,4877,4314,9191,0.1743161798794622,Texas
2098,2015,Dawson,female,752,12241,11563,23804,0.06503502551241028,Texas
2099,2015,Dawson,female,752,7235,5729,12964,0.13126200034910107,Texas
2104,2016,Dawson,female,609,11774,12087,23861,0.05038471084636386,Texas
2105,2016,Dawson,female,609,4877,4314,9191,0.1411682892906815,Texas
2106,2016,Dawson,female,609,12241,11563,23804,0.052667992735449275,Texas
2107,2016,Dawson,female,609,7235,5729,12964,0.10630127421888637,Texas
2112,2009,Deaf Smith,female,1683,9507,9392,18899,0.17919505962521295,Texas
2114,2010,Deaf Smith,female,1934,9507,9392,18899,0.2059199318568995,Texas
2116,2011,Deaf Smith,female,1275,9507,9392,18899,0.13575383304940375,Texas
2118,2012,Deaf Smith,female,1006,9507,9392,18899,0.10711243611584327,Texas
2120,2013,Deaf Smith,female,1271,9507,9392,18899,0.13532793867120954,Texas
2122,2014,Deaf Smith,female,1051,9507,9392,18899,0.1119037478705281,Texas
2124,2015,Deaf Smith,female,753,9507,9392,18899,0.08017461669505963,Texas
2126,2016,Deaf Smith,female,1237,9507,9392,18899,0.13170783645655879,Texas
2128,2009,Delta,female,519,15235,15111,30346,0.034345840778241016,Texas
2129,2009,Delta,female,519,17998,18192,36190,0.028529023746701847,Texas
2130,2009,Delta,female,519,2527,2688,5215,0.19308035714285715,Texas
2134,2010,Delta,female,585,15235,15111,30346,0.03871351995235259,Texas
2135,2010,Delta,female,585,17998,18192,36190,0.03215699208443272,Texas
2136,2010,Delta,female,585,2527,2688,5215,0.21763392857142858,Texas
2140,2011,Delta,female,497,15235,15111,30346,0.03288994772020382,Texas
2141,2011,Delta,female,497,17998,18192,36190,0.027319700967458223,Texas
2142,2011,Delta,female,497,2527,2688,5215,0.18489583333333334,Texas
2146,2012,Delta,female,439,15235,15111,30346,0.02905168420356032,Texas
2147,2012,Delta,female,439,17998,18192,36190,0.024131486367634125,Texas
2148,2012,Delta,female,439,2527,2688,5215,0.16331845238095238,Texas
2152,2013,Delta,female,308,15235,15111,30346,0.02038250281252068,Texas
2153,2013,Delta,female,308,17998,18192,36190,0.01693051890941073,Texas
2154,2013,Delta,female,308,2527,2688,5215,0.11458333333333333,Texas
2158,2014,Delta,female,234,15235,15111,30346,0.015485407980941036,Texas
2159,2014,Delta,female,234,17998,18192,36190,0.012862796833773086,Texas
2160,2014,Delta,female,234,2527,2688,5215,0.08705357142857142,Texas
2164,2015,Delta,female,229,15235,15111,30346,0.015154523195023493,Texas
2165,2015,Delta,female,229,17998,18192,36190,0.012587950747581355,Texas
2166,2015,Delta,female,229,2527,2688,5215,0.08519345238095238,Texas
2170,2016,Delta,female,180,15235,15111,30346,0.011911852293031567,Texas
2171,2016,Delta,female,180,17998,18192,36190,0.009894459102902375,Texas
2172,2016,Delta,female,180,2527,2688,5215,0.06696428571428571,Texas
2176,2009,Denton,female,8906,397140,409907,807047,0.021726879511694115,Texas
2178,2010,Denton,female,8844,397140,409907,807047,0.021575625690705452,Texas
2180,2011,Denton,female,9826,397140,409907,807047,0.02397129104894525,Texas
2182,2012,Denton,female,9070,397140,409907,807047,0.02212697026398671,Texas
2184,2013,Denton,female,7308,397140,409907,807047,0.017828434254599214,Texas
2186,2014,Denton,female,5902,397140,409907,807047,0.014398387927017592,Texas
2188,2015,Denton,female,6287,397140,409907,807047,0.015337625363802032,Texas
2190,2016,Denton,female,6601,397140,409907,807047,0.016103652779776875,Texas
2192,2009,Dickens,female,1146,1143,1073,2216,1.0680335507921714,Texas
2194,2010,Dickens,female,1055,1143,1073,2216,0.983224603914259,Texas
2196,2011,Dickens,female,1188,1143,1073,2216,1.1071761416589003,Texas
2198,2012,Dickens,female,830,1143,1073,2216,0.7735321528424977,Texas
2200,2013,Dickens,female,286,1143,1073,2216,0.26654240447343897,Texas
2202,2014,Dickens,female,361,1143,1073,2216,0.3364398881640261,Texas
2204,2015,Dickens,female,142,1143,1073,2216,0.13233923578751164,Texas
2206,2016,Dickens,female,501,1143,1073,2216,0.46691519105312207,Texas
2208,2009,Dimmit,female,1114,5186,5477,10663,0.20339601971882418,Texas
2210,2010,Dimmit,female,997,5186,5477,10663,0.18203396019718823,Texas
2212,2011,Dimmit,female,607,5186,5477,10663,0.11082709512506847,Texas
2214,2012,Dimmit,female,628,5186,5477,10663,0.11466131093664415,Texas
2216,2013,Dimmit,female,353,5186,5477,10663,0.06445134197553405,Texas
2218,2014,Dimmit,female,238,5186,5477,10663,0.04345444586452438,Texas
2220,2015,Dimmit,female,709,5186,5477,10663,0.1294504290670075,Texas
2222,2016,Dimmit,female,1013,5186,5477,10663,0.1849552674821983,Texas
2224,2009,Donley,female,1427,1634,1753,3387,0.814033086138049,Texas
2226,2010,Donley,female,1323,1634,1753,3387,0.7547062179121506,Texas
2228,2011,Donley,female,1491,1634,1753,3387,0.8505419281232174,Texas
2230,2012,Donley,female,1739,1634,1753,3387,0.9920136908157444,Texas
2232,2013,Donley,female,1949,1634,1753,3387,1.111808328579578,Texas
2234,2014,Donley,female,1887,1634,1753,3387,1.0764403879064461,Texas
2236,2015,Donley,female,1816,1634,1753,3387,1.03593839132915,Texas
2238,2016,Donley,female,1946,1634,1753,3387,1.1100969766115232,Texas
2240,2009,Duval,female,1643,448163,476066,924229,0.0034512021442405045,Texas
2241,2009,Duval,female,1643,5758,5597,11355,0.293550116133643,Texas
2244,2010,Duval,female,982,448163,476066,924229,0.002062739200026887,Texas
2245,2010,Duval,female,982,5758,5597,11355,0.17545113453635877,Texas
2248,2011,Duval,female,549,448163,476066,924229,0.0011532014468582088,Texas
2249,2011,Duval,female,549,5758,5597,11355,0.09808826156869752,Texas
2252,2012,Duval,female,436,448163,476066,924229,0.0009158394004192696,Texas
2253,2012,Duval,female,436,5758,5597,11355,0.07789887439699839,Texas
2256,2013,Duval,female,603,448163,476066,924229,0.0012666310973688522,Texas
2257,2013,Duval,female,603,5758,5597,11355,0.10773628729676613,Texas
2260,2014,Duval,female,1052,448163,476066,924229,0.0022097776358740175,Texas
2261,2014,Duval,female,1052,5758,5597,11355,0.1879578345542255,Texas
2264,2015,Duval,female,987,448163,476066,924229,0.002073241945444539,Texas
2265,2015,Duval,female,987,5758,5597,11355,0.17634447025192068,Texas
2268,2016,Duval,female,960,448163,476066,924229,0.0020165271201892172,Texas
2269,2016,Duval,female,960,5758,5597,11355,0.17152045738788638,Texas
2272,2009,Eastland,female,3367,9245,9025,18270,0.37307479224376733,Texas
2274,2010,Eastland,female,4081,9245,9025,18270,0.45218836565096954,Texas
2276,2011,Eastland,female,4516,9245,9025,18270,0.500387811634349,Texas
2278,2012,Eastland,female,4247,9245,9025,18270,0.47058171745152355,Texas
2280,2013,Eastland,female,3271,9245,9025,18270,0.3624376731301939,Texas
2282,2014,Eastland,female,3127,9245,9025,18270,0.3464819944598338,Texas
2284,2015,Eastland,female,1834,9245,9025,18270,0.20321329639889196,Texas
2286,2016,Eastland,female,2736,9245,9025,18270,0.3031578947368421,Texas
2288,2009,Ector,female,4090,80249,78093,158342,0.052373452166007195,Texas
2290,2010,Ector,female,3951,80249,78093,158342,0.05059352310706466,Texas
2292,2011,Ector,female,3506,80249,78093,158342,0.04489518906944284,Texas
2294,2012,Ector,female,2890,80249,78093,158342,0.037007158131970856,Texas
2296,2013,Ector,female,2218,80249,78093,158342,0.028402033472910503,Texas
2298,2014,Ector,female,3350,80249,78093,158342,0.04289757084501812,Texas
2300,2015,Ector,female,2582,80249,78093,158342,0.03306314266323486,Texas
2302,2016,Ector,female,2845,80249,78093,158342,0.03643092210569449,Texas
2304,2009,Edwards,female,73,3231,3276,6507,0.022283272283272284,Texas
2305,2009,Edwards,female,73,1494,1431,2925,0.05101327742837177,Texas
2306,2009,Edwards,female,73,1062,993,2055,0.07351460221550855,Texas
2310,2010,Edwards,female,55,3231,3276,6507,0.016788766788766788,Texas
2311,2010,Edwards,female,55,1494,1431,2925,0.03843466107617051,Texas
2312,2010,Edwards,female,55,1062,993,2055,0.0553877139979859,Texas
2316,2011,Edwards,female,49,3231,3276,6507,0.014957264957264958,Texas
2317,2011,Edwards,female,49,1494,1431,2925,0.03424178895877009,Texas
2318,2011,Edwards,female,49,1062,993,2055,0.04934541792547835,Texas
2322,2012,Edwards,female,12,3231,3276,6507,0.003663003663003663,Texas
2323,2012,Edwards,female,12,1494,1431,2925,0.008385744234800839,Texas
2324,2012,Edwards,female,12,1062,993,2055,0.012084592145015106,Texas
2328,2013,Edwards,female,67,3231,3276,6507,0.020451770451770452,Texas
2329,2013,Edwards,female,67,1494,1431,2925,0.04682040531097135,Texas
2330,2013,Edwards,female,67,1062,993,2055,0.06747230614300101,Texas
2334,2014,Edwards,female,15,3231,3276,6507,0.004578754578754579,Texas
2335,2014,Edwards,female,15,1494,1431,2925,0.010482180293501049,Texas
2336,2014,Edwards,female,15,1062,993,2055,0.015105740181268883,Texas
2340,2015,Edwards,female,30,3231,3276,6507,0.009157509157509158,Texas
2341,2015,Edwards,female,30,1494,1431,2925,0.020964360587002098,Texas
2342,2015,Edwards,female,30,1062,993,2055,0.030211480362537766,Texas
2346,2016,Edwards,female,99,3231,3276,6507,0.03021978021978022,Texas
2347,2016,Edwards,female,99,1494,1431,2925,0.06918238993710692,Texas
2348,2016,Edwards,female,99,1062,993,2055,0.09969788519637462,Texas
2352,2009,El Paso,female,9267,347478,340675,688153,0.027201878623321348,Texas
2353,2009,El Paso,female,9267,411682,425972,837654,0.021754951029645142,Texas
2356,2010,El Paso,female,11744,347478,340675,688153,0.03447273794672342,Texas
2357,2010,El Paso,female,11744,411682,425972,837654,0.027569887222634353,Texas
2360,2011,El Paso,female,11894,347478,340675,688153,0.0349130402876642,Texas
2361,2011,El Paso,female,11894,411682,425972,837654,0.027922023043768136,Texas
2364,2012,El Paso,female,11264,347478,340675,688153,0.033063770455712925,Texas
2365,2012,El Paso,female,11264,411682,425972,837654,0.026443052595006244,Texas
2368,2013,El Paso,female,9232,347478,340675,688153,0.027099141410435165,Texas
2369,2013,El Paso,female,9232,411682,425972,837654,0.021672786004713923,Texas
2372,2014,El Paso,female,7514,347478,340675,688153,0.02205621193219344,Texas
2373,2014,El Paso,female,7514,411682,425972,837654,0.01763965706666166,Texas
2376,2015,El Paso,female,13269,347478,340675,688153,0.03894914507962134,Texas
2377,2015,El Paso,female,13269,411682,425972,837654,0.031149934737494483,Texas
2380,2016,El Paso,female,16023,347478,340675,688153,0.047033096059294045,Texas
2381,2016,El Paso,female,16023,411682,425972,837654,0.03761514841351075,Texas
2384,2009,Ellis,female,5924,14394,14484,28878,0.40900303783485226,Texas
2385,2009,Ellis,female,5924,1954,2118,4072,2.796978281397545,Texas
2386,2009,Ellis,female,5924,83184,85654,168838,0.06916197725733766,Texas
2390,2010,Ellis,female,3539,14394,14484,28878,0.24433858050262358,Texas
2391,2010,Ellis,female,3539,1954,2118,4072,1.6709159584513693,Texas
2392,2010,Ellis,female,3539,83184,85654,168838,0.04131739323324071,Texas
2396,2011,Ellis,female,3782,14394,14484,28878,0.26111571389119026,Texas
2397,2011,Ellis,female,3782,1954,2118,4072,1.785646836638338,Texas
2398,2011,Ellis,female,3782,83184,85654,168838,0.04415438858663927,Texas
2402,2012,Ellis,female,3056,14394,14484,28878,0.21099143882905275,Texas
2403,2012,Ellis,female,3056,1954,2118,4072,1.4428706326723324,Texas
2404,2012,Ellis,female,3056,83184,85654,168838,0.03567842716043618,Texas
2408,2013,Ellis,female,3478,14394,14484,28878,0.24012703673018504,Texas
2409,2013,Ellis,female,3478,1954,2118,4072,1.6421152030217185,Texas
2410,2013,Ellis,female,3478,83184,85654,168838,0.04060522567539169,Texas
2414,2014,Ellis,female,3753,14394,14484,28878,0.2591135045567523,Texas
2415,2014,Ellis,female,3753,1954,2118,4072,1.771954674220963,Texas
2416,2014,Ellis,female,3753,83184,85654,168838,0.04381581712471105,Texas
2420,2015,Ellis,female,2509,14394,14484,28878,0.17322562827948082,Texas
2421,2015,Ellis,female,2509,1954,2118,4072,1.184608120868744,Texas
2422,2015,Ellis,female,2509,83184,85654,168838,0.02929226889579004,Texas
2426,2016,Ellis,female,3280,14394,14484,28878,0.2264567798950566,Texas
2427,2016,Ellis,female,3280,1954,2118,4072,1.5486307837582625,Texas
2428,2016,Ellis,female,3280,83184,85654,168838,0.038293599831881756,Texas
2432,2009,Erath,female,3009,20216,21266,41482,0.14149346374494498,Texas
2434,2010,Erath,female,4050,20216,21266,41482,0.1904448415310825,Texas
2436,2011,Erath,female,4278,20216,21266,41482,0.20116618075801748,Texas
2438,2012,Erath,female,4347,20216,21266,41482,0.2044107965766952,Texas
2440,2013,Erath,female,3992,20216,21266,41482,0.18771748330668672,Texas
2442,2014,Erath,female,3168,20216,21266,41482,0.1489701871532023,Texas
2444,2015,Erath,female,2416,20216,21266,41482,0.11360857707138154,Texas
2446,2016,Erath,female,2516,20216,21266,41482,0.11831091883758112,Texas
2448,2009,Falls,female,2184,8189,9110,17299,0.23973655323819978,Texas
2450,2010,Falls,female,2554,8189,9110,17299,0.28035126234906693,Texas
2452,2011,Falls,female,1723,8189,9110,17299,0.18913282107574095,Texas
2454,2012,Falls,female,1697,8189,9110,17299,0.1862788144895719,Texas
2456,2013,Falls,female,1215,8189,9110,17299,0.13336992316136115,Texas
2458,2014,Falls,female,823,8189,9110,17299,0.09034028540065862,Texas
2460,2015,Falls,female,940,8189,9110,17299,0.10318331503841932,Texas
2462,2016,Falls,female,1090,8189,9110,17299,0.11964873765093303,Texas
2464,2009,Fannin,female,2285,12086,12839,24925,0.17797336241140277,Texas
2465,2009,Fannin,female,2285,18034,16141,34175,0.14156495880057,Texas
2468,2010,Fannin,female,2055,12086,12839,24925,0.1600591946413272,Texas
2469,2010,Fannin,female,2055,18034,16141,34175,0.1273155318753485,Texas
2472,2011,Fannin,female,1743,12086,12839,24925,0.13575823662278994,Texas
2473,2011,Fannin,female,1743,18034,16141,34175,0.107985874481135,Texas
2476,2012,Fannin,female,1265,12086,12839,24925,0.09852792273541552,Texas
2477,2012,Fannin,female,1265,18034,16141,34175,0.07837184808871817,Texas
2480,2013,Fannin,female,1720,12086,12839,24925,0.13396681984578238,Texas
2481,2013,Fannin,female,1720,18034,16141,34175,0.10656093178861285,Texas
2484,2014,Fannin,female,1390,12086,12839,24925,0.1082638834800218,Texas
2485,2014,Fannin,female,1390,18034,16141,34175,0.0861161018524255,Texas
2488,2015,Fannin,female,1441,12086,12839,24925,0.11223615546382117,Texas
2489,2015,Fannin,female,1441,18034,16141,34175,0.08927575738801809,Texas
2492,2016,Fannin,female,1495,12086,12839,24925,0.11644209050549108,Texas
2493,2016,Fannin,female,1495,18034,16141,34175,0.09262127501393966,Texas
2496,2009,Fayette,female,3139,8170,8415,16585,0.3730243612596554,Texas
2497,2009,Fayette,female,3139,54055,57314,111369,0.05476846843703109,Texas
2498,2009,Fayette,female,3139,11580,10144,21724,0.30944400630914826,Texas
2499,2009,Fayette,female,3139,11474,11785,23259,0.2663555366991939,Texas
2500,2009,Fayette,female,3139,9998,9931,19929,0.31608095861443963,Texas
2501,2009,Fayette,female,3139,156453,162281,318734,0.019342991477745392,Texas
2502,2009,Fayette,female,3139,13960,14685,28645,0.21375553285665644,Texas
2503,2009,Fayette,female,3139,65327,66962,132289,0.0468773334129805,Texas
2504,2009,Fayette,female,3139,19510,20182,39692,0.1555346348231097,Texas
2505,2009,Fayette,female,3139,12351,12715,25066,0.246873771136453,Texas
2506,2009,Fayette,female,3139,22099,22027,44126,0.14250692332137832,Texas
2518,2010,Fayette,female,2466,8170,8415,16585,0.293048128342246,Texas
2519,2010,Fayette,female,2466,54055,57314,111369,0.04302613672052204,Texas
2520,2010,Fayette,female,2466,11580,10144,21724,0.2430993690851735,Texas
2521,2010,Fayette,female,2466,11474,11785,23259,0.2092490453966907,Texas
2522,2010,Fayette,female,2466,9998,9931,19929,0.2483133621991743,Texas
2523,2010,Fayette,female,2466,156453,162281,318734,0.01519586396435812,Texas
2524,2010,Fayette,female,2466,13960,14685,28645,0.167926455566905,Texas
2525,2010,Fayette,female,2466,65327,66962,132289,0.0368268570233864,Texas
2526,2010,Fayette,female,2466,19510,20182,39692,0.12218808839560004,Texas
2527,2010,Fayette,female,2466,12351,12715,25066,0.1939441604404247,Texas
2528,2010,Fayette,female,2466,22099,22027,44126,0.11195351159940073,Texas
2540,2011,Fayette,female,3318,8170,8415,16585,0.3942959001782531,Texas
2541,2011,Fayette,female,3318,54055,57314,111369,0.05789161461423038,Texas
2542,2011,Fayette,female,3318,11580,10144,21724,0.32708990536277605,Texas
2543,2011,Fayette,female,3318,11474,11785,23259,0.2815443360203649,Texas
2544,2011,Fayette,female,3318,9998,9931,19929,0.3341053267546068,Texas
2545,2011,Fayette,female,3318,156453,162281,318734,0.02044601647759134,Texas
2546,2011,Fayette,female,3318,13960,14685,28645,0.22594484167517875,Texas
2547,2011,Fayette,female,3318,65327,66962,132289,0.049550491323437175,Texas
2548,2011,Fayette,female,3318,19510,20182,39692,0.16440392428897038,Texas
2549,2011,Fayette,female,3318,12351,12715,25066,0.2609516319307904,Texas
2550,2011,Fayette,female,3318,22099,22027,44126,0.15063331366050756,Texas
2562,2012,Fayette,female,3163,8170,8415,16585,0.37587641117052883,Texas
2563,2012,Fayette,female,3163,54055,57314,111369,0.05518721429319189,Texas
2564,2012,Fayette,female,3163,11580,10144,21724,0.3118099369085173,Texas
2565,2012,Fayette,female,3163,11474,11785,23259,0.2683920237590157,Texas
2566,2012,Fayette,female,3163,9998,9931,19929,0.31849763367233913,Texas
2567,2012,Fayette,female,3163,156453,162281,318734,0.01949088309783647,Texas
2568,2012,Fayette,female,3163,13960,14685,28645,0.21538985359210078,Texas
2569,2012,Fayette,female,3163,65327,66962,132289,0.047235745646784746,Texas
2570,2012,Fayette,female,3163,19510,20182,39692,0.15672381329897928,Texas
2571,2012,Fayette,female,3163,12351,12715,25066,0.24876130554463233,Texas
2572,2012,Fayette,female,3163,22099,22027,44126,0.14359649521042356,Texas
2584,2013,Fayette,female,2746,8170,8415,16585,0.3263220439691028,Texas
2585,2013,Fayette,female,2746,54055,57314,111369,0.047911505042398016,Texas
2586,2013,Fayette,female,2746,11580,10144,21724,0.2707018927444795,Texas
2587,2013,Fayette,female,2746,11474,11785,23259,0.2330080610946118,Texas
2588,2013,Fayette,female,2746,9998,9931,19929,0.2765079045413352,Texas
2589,2013,Fayette,female,2746,156453,162281,318734,0.016921266198754014,Texas
2590,2013,Fayette,female,2746,13960,14685,28645,0.18699353081375553,Texas
2591,2013,Fayette,female,2746,65327,66962,132289,0.041008333084435945,Texas
2592,2013,Fayette,female,2746,19510,20182,39692,0.13606183728074522,Texas
2593,2013,Fayette,female,2746,12351,12715,25066,0.2159653952025167,Texas
2594,2013,Fayette,female,2746,22099,22027,44126,0.12466518363826214,Texas
2606,2014,Fayette,female,2945,8170,8415,16585,0.34997029114676176,Texas
2607,2014,Fayette,female,2945,54055,57314,111369,0.051383606099731305,Texas
2608,2014,Fayette,female,2945,11580,10144,21724,0.2903194006309148,Texas
2609,2014,Fayette,female,2945,11474,11785,23259,0.24989393296563428,Texas
2610,2014,Fayette,female,2945,9998,9931,19929,0.2965461685630853,Texas
2611,2014,Fayette,female,2945,156453,162281,318734,0.01814753421534252,Texas
2612,2014,Fayette,female,2945,13960,14685,28645,0.20054477357848144,Texas
2613,2014,Fayette,female,2945,65327,66962,132289,0.04398016785639616,Texas
2614,2014,Fayette,female,2945,19510,20182,39692,0.14592210880983053,Texas
2615,2014,Fayette,female,2945,12351,12715,25066,0.23161620133700353,Texas
2616,2014,Fayette,female,2945,22099,22027,44126,0.13369955055159577,Texas
2628,2015,Fayette,female,2786,8170,8415,16585,0.3310754604872252,Texas
2629,2015,Fayette,female,2786,54055,57314,111369,0.048609414802666014,Texas
2630,2015,Fayette,female,2786,11580,10144,21724,0.27464511041009465,Texas
2631,2015,Fayette,female,2786,11474,11785,23259,0.23640220619431482,Texas
2632,2015,Fayette,female,2786,9998,9931,19929,0.28053569630450104,Texas
2633,2015,Fayette,female,2786,156453,162281,318734,0.01716775223223914,Texas
2634,2015,Fayette,female,2786,13960,14685,28645,0.18971739870616275,Texas
2635,2015,Fayette,female,2786,65327,66962,132289,0.041605686807443025,Texas
2636,2015,Fayette,female,2786,19510,20182,39692,0.13804380140719452,Texas
2637,2015,Fayette,female,2786,12351,12715,25066,0.21911128588281556,Texas
2638,2015,Fayette,female,2786,22099,22027,44126,0.12648113678667092,Texas
2650,2016,Fayette,female,2006,8170,8415,16585,0.2383838383838384,Texas
2651,2016,Fayette,female,2006,54055,57314,111369,0.03500017447744007,Texas
2652,2016,Fayette,female,2006,11580,10144,21724,0.19775236593059936,Texas
2653,2016,Fayette,female,2006,11474,11785,23259,0.17021637675010606,Texas
2654,2016,Fayette,female,2006,9998,9931,19929,0.20199375692276708,Texas
2655,2016,Fayette,female,2006,156453,162281,318734,0.012361274579279151,Texas
2656,2016,Fayette,female,2006,13960,14685,28645,0.13660197480422198,Texas
2657,2016,Fayette,female,2006,65327,66962,132289,0.029957289208804992,Texas
2658,2016,Fayette,female,2006,19510,20182,39692,0.09939550094143296,Texas
2659,2016,Fayette,female,2006,12351,12715,25066,0.15776641761698781,Texas
2660,2016,Fayette,female,2006,22099,22027,44126,0.09107005039269987,Texas
2672,2009,Fisher,female,338,1879,2004,3883,0.1686626746506986,Texas
2674,2010,Fisher,female,339,1879,2004,3883,0.1691616766467066,Texas
2676,2011,Fisher,female,299,1879,2004,3883,0.14920159680638723,Texas
2678,2012,Fisher,female,452,1879,2004,3883,0.22554890219560877,Texas
2680,2013,Fisher,female,346,1879,2004,3883,0.17265469061876249,Texas
2682,2014,Fisher,female,265,1879,2004,3883,0.13223552894211577,Texas
2684,2015,Fisher,female,195,1879,2004,3883,0.09730538922155689,Texas
2686,2016,Fisher,female,328,1879,2004,3883,0.16367265469061876,Texas
2688,2009,Floyd,female,385,46810,50014,96824,0.007697844603511017,Texas
2689,2009,Floyd,female,385,37135,39674,76809,0.009704088319806422,Texas
2690,2009,Floyd,female,385,7766,8092,15858,0.04757785467128028,Texas
2691,2009,Floyd,female,385,18070,18856,36926,0.020417904115400932,Texas
2692,2009,Floyd,female,385,2885,2987,5872,0.12889186474723804,Texas
2693,2009,Floyd,female,385,7824,7842,15666,0.04909461871971436,Texas
2700,2010,Floyd,female,390,46810,50014,96824,0.007797816611348822,Texas
2701,2010,Floyd,female,390,37135,39674,76809,0.00983011544084287,Texas
2702,2010,Floyd,female,390,7766,8092,15858,0.04819574888779041,Texas
2703,2010,Floyd,female,390,18070,18856,36926,0.020683071701315232,Texas
2704,2010,Floyd,female,390,2885,2987,5872,0.13056578506863073,Texas
2705,2010,Floyd,female,390,7824,7842,15666,0.04973221117061974,Texas
2712,2011,Floyd,female,451,46810,50014,96824,0.009017475106970048,Texas
2713,2011,Floyd,female,451,37135,39674,76809,0.011367646317487523,Texas
2714,2011,Floyd,female,451,7766,8092,15858,0.05573405832921404,Texas
2715,2011,Floyd,female,451,18070,18856,36926,0.023918116249469663,Texas
2716,2011,Floyd,female,451,2885,2987,5872,0.15098761298962168,Texas
2717,2011,Floyd,female,451,7824,7842,15666,0.05751083907166539,Texas
2724,2012,Floyd,female,505,46810,50014,96824,0.010097172791618347,Texas
2725,2012,Floyd,female,505,37135,39674,76809,0.012728739224681151,Texas
2726,2012,Floyd,female,505,7766,8092,15858,0.06240731586752348,Texas
2727,2012,Floyd,female,505,18070,18856,36926,0.02678192617734408,Texas
2728,2012,Floyd,female,505,2885,2987,5872,0.16906595246066286,Texas
2729,2012,Floyd,female,505,7824,7842,15666,0.06439683754144351,Texas
2736,2013,Floyd,female,99,46810,50014,96824,0.0019794457551885474,Texas
2737,2013,Floyd,female,99,37135,39674,76809,0.0024953369965216516,Texas
2738,2013,Floyd,female,99,7766,8092,15858,0.012234305486900642,Texas
2739,2013,Floyd,female,99,18070,18856,36926,0.005250318201103097,Texas
2740,2013,Floyd,female,99,2885,2987,5872,0.033143622363575494,Texas
2741,2013,Floyd,female,99,7824,7842,15666,0.01262433052792655,Texas
2748,2014,Floyd,female,182,46810,50014,96824,0.0036389810852961173,Texas
2749,2014,Floyd,female,182,37135,39674,76809,0.004587387205726673,Texas
2750,2014,Floyd,female,182,7766,8092,15858,0.02249134948096886,Texas
2751,2014,Floyd,female,182,18070,18856,36926,0.009652100127280442,Texas
2752,2014,Floyd,female,182,2885,2987,5872,0.06093069969869434,Texas
2753,2014,Floyd,female,182,7824,7842,15666,0.02320836521295588,Texas
2760,2015,Floyd,female,217,46810,50014,96824,0.004338785140160755,Texas
2761,2015,Floyd,female,217,37135,39674,76809,0.005469577052981802,Texas
2762,2015,Floyd,female,217,7766,8092,15858,0.026816608996539794,Texas
2763,2015,Floyd,female,217,18070,18856,36926,0.011508273228680525,Texas
2764,2015,Floyd,female,217,2885,2987,5872,0.07264814194844325,Texas
2765,2015,Floyd,female,217,7824,7842,15666,0.027671512369293546,Texas
2772,2016,Floyd,female,352,46810,50014,96824,0.007038029351781501,Texas
2773,2016,Floyd,female,352,37135,39674,76809,0.008872309320965872,Texas
2774,2016,Floyd,female,352,7766,8092,15858,0.043499752842313395,Texas
2775,2016,Floyd,female,352,18070,18856,36926,0.018667798048366567,Texas
2776,2016,Floyd,female,352,2885,2987,5872,0.1178439906260462,Texas
2777,2016,Floyd,female,352,7824,7842,15666,0.044886508543738844,Texas
2784,2009,Foard,female,73,712,696,1408,0.10488505747126436,Texas
2786,2010,Foard,female,106,712,696,1408,0.15229885057471265,Texas
2788,2011,Foard,female,101,712,696,1408,0.14511494252873564,Texas
2790,2012,Foard,female,77,712,696,1408,0.11063218390804598,Texas
2792,2013,Foard,female,36,712,696,1408,0.05172413793103448,Texas
2794,2014,Foard,female,64,712,696,1408,0.09195402298850575,Texas
2796,2015,Foard,female,57,712,696,1408,0.08189655172413793,Texas
2798,2016,Foard,female,83,712,696,1408,0.11925287356321838,Texas
2800,2009,Fort Bend,female,10449,363177,376165,739342,0.027777703933114458,Texas
2802,2010,Fort Bend,female,10432,363177,376165,739342,0.027732510999162602,Texas
2804,2011,Fort Bend,female,13924,363177,376165,739342,0.03701567131444978,Texas
2806,2012,Fort Bend,female,15064,363177,376165,739342,0.04004625629710366,Texas
2808,2013,Fort Bend,female,11755,363177,376165,739342,0.031249584623768825,Texas
2810,2014,Fort Bend,female,9117,363177,376165,739342,0.024236704637592546,Texas
2812,2015,Fort Bend,female,9249,363177,376165,739342,0.024587614477689312,Texas
2814,2016,Fort Bend,female,9163,363177,376165,739342,0.02435899140005051,Texas
2816,2009,Franklin,female,2130,15602,15940,31542,0.13362609786700125,Texas
2817,2009,Franklin,female,2130,8675,9105,17780,0.23393739703459637,Texas
2818,2009,Franklin,female,2130,6714,5022,11736,0.4241338112305854,Texas
2819,2009,Franklin,female,2130,10853,11661,22514,0.18266014921533316,Texas
2820,2009,Franklin,female,2130,6787,6492,13279,0.32809611829944546,Texas
2821,2009,Franklin,female,2130,19285,19842,39127,0.10734804959177502,Texas
2822,2009,Franklin,female,2130,11426,11416,22842,0.1865802382620883,Texas
2823,2009,Franklin,female,2130,5117,5128,10245,0.4153666146645866,Texas
2824,2009,Franklin,female,2130,12567,12996,25563,0.16389658356417358,Texas
2825,2009,Franklin,female,2130,24390,25906,50296,0.08222033505751564,Texas
2826,2009,Franklin,female,2130,9981,10341,20322,0.2059762111981433,Texas
2827,2009,Franklin,female,2130,14651,15368,30019,0.1385996876626757,Texas
2828,2009,Franklin,female,2130,34601,36334,70935,0.05862277756371443,Texas
2829,2009,Franklin,female,2130,3706,4051,7757,0.5257960997284621,Texas
2830,2009,Franklin,female,2130,51339,51442,102781,0.041405855137825125,Texas
2831,2009,Franklin,female,2130,1490,1516,3006,1.4050131926121372,Texas
2832,2009,Franklin,female,2130,27816,22876,50692,0.09311068368595908,Texas
2833,2009,Franklin,female,2130,32281,32621,64902,0.06529536188344931,Texas
2834,2009,Franklin,female,2130,622353,652980,1275333,0.0032619682072957826,Texas
2835,2009,Franklin,female,2130,75503,78248,153751,0.027221143032409773,Texas
2836,2009,Franklin,female,2130,20414,21098,41512,0.10095743672386008,Texas
2837,2009,Franklin,female,2130,5362,5317,10679,0.40060184314463043,Texas
2838,2009,Franklin,female,2130,24357,24668,49025,0.08634668396302903,Texas
2839,2009,Franklin,female,2130,27532,28701,56233,0.07421344204034702,Texas
2840,2009,Franklin,female,2130,47145,43515,90660,0.04894863840055153,Texas
2866,2010,Franklin,female,1755,15602,15940,31542,0.11010037641154329,Texas
2867,2010,Franklin,female,1755,8675,9105,17780,0.1927512355848435,Texas
2868,2010,Franklin,female,1755,6714,5022,11736,0.34946236559139787,Texas
2869,2010,Franklin,female,1755,10853,11661,22514,0.1505016722408027,Texas
2870,2010,Franklin,female,1755,6787,6492,13279,0.27033271719038815,Texas
2871,2010,Franklin,female,1755,19285,19842,39127,0.08844874508618082,Texas
2872,2010,Franklin,female,1755,11426,11416,22842,0.15373160476524175,Texas
2873,2010,Franklin,female,1755,5117,5128,10245,0.3422386895475819,Texas
2874,2010,Franklin,female,1755,12567,12996,25563,0.13504155124653738,Texas
2875,2010,Franklin,female,1755,24390,25906,50296,0.06774492395584035,Texas
2876,2010,Franklin,female,1755,9981,10341,20322,0.16971279373368145,Texas
2877,2010,Franklin,female,1755,14651,15368,30019,0.11419833420093702,Texas
2878,2010,Franklin,female,1755,34601,36334,70935,0.04830186602080696,Texas
2879,2010,Franklin,female,1755,3706,4051,7757,0.4332263638607751,Texas
2880,2010,Franklin,female,1755,51339,51442,102781,0.03411609190933478,Texas
2881,2010,Franklin,female,1755,1490,1516,3006,1.1576517150395778,Texas
2882,2010,Franklin,female,1755,27816,22876,50692,0.07671795768490995,Texas
2883,2010,Franklin,female,1755,32281,32621,64902,0.05379969958002514,Texas
2884,2010,Franklin,female,1755,622353,652980,1275333,0.0026876780299549758,Texas
2885,2010,Franklin,female,1755,75503,78248,153751,0.0224286882731827,Texas
2886,2010,Franklin,female,1755,20414,21098,41512,0.08318324011754669,Texas
2887,2010,Franklin,female,1755,5362,5317,10679,0.33007334963325186,Texas
2888,2010,Franklin,female,1755,24357,24668,49025,0.07114480298362251,Texas
2889,2010,Franklin,female,1755,27532,28701,56233,0.06114769520225776,Texas
2890,2010,Franklin,female,1755,47145,43515,90660,0.04033092037228542,Texas
2916,2011,Franklin,female,1423,15602,15940,31542,0.08927227101631116,Texas
2917,2011,Franklin,female,1423,8675,9105,17780,0.15628775398132894,Texas
2918,2011,Franklin,female,1423,6714,5022,11736,0.28335324571883713,Texas
2919,2011,Franklin,female,1423,10853,11661,22514,0.12203070062601835,Texas
2920,2011,Franklin,female,1423,6787,6492,13279,0.21919285274183611,Texas
2921,2011,Franklin,female,1423,19285,19842,39127,0.07171656083056144,Texas
2922,2011,Franklin,female,1423,11426,11416,22842,0.12464961457603364,Texas
2923,2011,Franklin,female,1423,5117,5128,10245,0.27749609984399376,Texas
2924,2011,Franklin,female,1423,12567,12996,25563,0.10949522930132348,Texas
2925,2011,Franklin,female,1423,24390,25906,50296,0.054929359993823826,Texas
2926,2011,Franklin,female,1423,9981,10341,20322,0.13760758147181124,Texas
2927,2011,Franklin,female,1423,14651,15368,30019,0.09259500260281103,Texas
2928,2011,Franklin,female,1423,34601,36334,70935,0.03916441900148621,Texas
2929,2011,Franklin,female,1423,3706,4051,7757,0.3512712910392496,Texas
2930,2011,Franklin,female,1423,51339,51442,102781,0.02766222153104467,Texas
2931,2011,Franklin,female,1423,1490,1516,3006,0.9386543535620053,Texas
2932,2011,Franklin,female,1423,27816,22876,50692,0.062204930931981116,Texas
2933,2011,Franklin,female,1423,32281,32621,64902,0.04362220655406027,Texas
2934,2011,Franklin,female,1423,622353,652980,1275333,0.0021792397929492483,Texas
2935,2011,Franklin,female,1423,75503,78248,153751,0.018185768326347,Texas
2936,2011,Franklin,female,1423,20414,21098,41512,0.06744715138875723,Texas
2937,2011,Franklin,female,1423,5362,5317,10679,0.26763212337784464,Texas
2938,2011,Franklin,female,1423,24357,24668,49025,0.057686071023187936,Texas
2939,2011,Franklin,female,1423,27532,28701,56233,0.04958015400160273,Texas
2940,2011,Franklin,female,1423,47145,43515,90660,0.03270136734459382,Texas
2966,2012,Franklin,female,1669,15602,15940,31542,0.1047051442910916,Texas
2967,2012,Franklin,female,1669,8675,9105,17780,0.18330587589236683,Texas
2968,2012,Franklin,female,1669,6714,5022,11736,0.33233771405814416,Texas
2969,2012,Franklin,female,1669,10853,11661,22514,0.14312666152131034,Texas
2970,2012,Franklin,female,1669,6787,6492,13279,0.2570856438693777,Texas
2971,2012,Franklin,female,1669,19285,19842,39127,0.08411450458623122,Texas
2972,2012,Franklin,female,1669,11426,11416,22842,0.14619831814996495,Texas
2973,2012,Franklin,female,1669,5117,5128,10245,0.3254680187207488,Texas
2974,2012,Franklin,female,1669,12567,12996,25563,0.12842413050169282,Texas
2975,2012,Franklin,female,1669,24390,25906,50296,0.06442522967652281,Texas
2976,2012,Franklin,female,1669,9981,10341,20322,0.1613963833284982,Texas
2977,2012,Franklin,female,1669,14651,15368,30019,0.1086022904737116,Texas
2978,2012,Franklin,female,1669,34601,36334,70935,0.04593493697363351,Texas
2979,2012,Franklin,female,1669,3706,4051,7757,0.41199703776845226,Texas
2980,2012,Franklin,female,1669,51339,51442,102781,0.032444306208934334,Texas
2981,2012,Franklin,female,1669,1490,1516,3006,1.1009234828496042,Texas
2982,2012,Franklin,female,1669,27816,22876,50692,0.07295855918866935,Texas
2983,2012,Franklin,female,1669,32281,32621,64902,0.051163361025106525,Texas
2984,2012,Franklin,female,1669,622353,652980,1275333,0.0025559741492848175,Texas
2985,2012,Franklin,female,1669,75503,78248,153751,0.02132961864839996,Texas
2986,2012,Franklin,female,1669,20414,21098,41512,0.07910702436249882,Texas
2987,2012,Franklin,female,1669,5362,5317,10679,0.313898815121309,Texas
2988,2012,Franklin,female,1669,24357,24668,49025,0.06765850494567861,Texas
2989,2012,Franklin,female,1669,27532,28701,56233,0.05815128392738929,Texas
2990,2012,Franklin,female,1669,47145,43515,90660,0.038354590371136386,Texas
3016,2013,Franklin,female,1869,15602,15940,31542,0.11725219573400252,Texas
3017,2013,Franklin,female,1869,8675,9105,17780,0.20527182866556837,Texas
3018,2013,Franklin,female,1869,6714,5022,11736,0.37216248506571087,Texas
3019,2013,Franklin,female,1869,10853,11661,22514,0.16027784924105995,Texas
3020,2013,Franklin,female,1869,6787,6492,13279,0.28789279112754157,Texas
3021,2013,Franklin,female,1869,19285,19842,39127,0.09419413365588146,Texas
3022,2013,Franklin,female,1869,11426,11416,22842,0.16371758934828312,Texas
3023,2013,Franklin,female,1869,5117,5128,10245,0.36446957878315134,Texas
3024,2013,Franklin,female,1869,12567,12996,25563,0.1438134810710988,Texas
3025,2013,Franklin,female,1869,24390,25906,50296,0.07214544893074963,Texas
3026,2013,Franklin,female,1869,9981,10341,20322,0.18073687264287785,Texas
3027,2013,Franklin,female,1869,14651,15368,30019,0.12161634565330556,Texas
3028,2013,Franklin,female,1869,34601,36334,70935,0.05143942312985083,Texas
3029,2013,Franklin,female,1869,3706,4051,7757,0.46136756356455194,Texas
3030,2013,Franklin,female,1869,51339,51442,102781,0.03633217993079585,Texas
3031,2013,Franklin,female,1869,1490,1516,3006,1.232849604221636,Texas
3032,2013,Franklin,female,1869,27816,22876,50692,0.08170134638922888,Texas
3033,2013,Franklin,female,1869,32281,32621,64902,0.057294380920266084,Texas
3034,2013,Franklin,female,1869,622353,652980,1275333,0.002862262243866581,Texas
3035,2013,Franklin,female,1869,75503,78248,153751,0.023885594519987733,Texas
3036,2013,Franklin,female,1869,20414,21098,41512,0.08858659588586595,Texas
3037,2013,Franklin,female,1869,5362,5317,10679,0.35151401166071095,Texas
3038,2013,Franklin,female,1869,24357,24668,49025,0.0757661748013621,Texas
3039,2013,Franklin,female,1869,27532,28701,56233,0.0651196822410369,Texas
3040,2013,Franklin,female,1869,47145,43515,90660,0.04295070665287832,Texas
3066,2014,Franklin,female,1521,15602,15940,31542,0.09542032622333751,Texas
3067,2014,Franklin,female,1521,8675,9105,17780,0.16705107084019769,Texas
3068,2014,Franklin,female,1521,6714,5022,11736,0.30286738351254483,Texas
3069,2014,Franklin,female,1521,10853,11661,22514,0.13043478260869565,Texas
3070,2014,Franklin,female,1521,6787,6492,13279,0.2342883548983364,Texas
3071,2014,Franklin,female,1521,19285,19842,39127,0.07665557907469005,Texas
3072,2014,Franklin,female,1521,11426,11416,22842,0.13323405746320954,Texas
3073,2014,Franklin,female,1521,5117,5128,10245,0.296606864274571,Texas
3074,2014,Franklin,female,1521,12567,12996,25563,0.11703601108033242,Texas
3075,2014,Franklin,female,1521,24390,25906,50296,0.058712267428394964,Texas
3076,2014,Franklin,female,1521,9981,10341,20322,0.14708442123585727,Texas
3077,2014,Franklin,female,1521,14651,15368,30019,0.09897188964081208,Texas
3078,2014,Franklin,female,1521,34601,36334,70935,0.0418616172180327,Texas
3079,2014,Franklin,female,1521,3706,4051,7757,0.37546284867933843,Texas
3080,2014,Franklin,female,1521,51339,51442,102781,0.029567279654756813,Texas
3081,2014,Franklin,female,1521,1490,1516,3006,1.0032981530343008,Texas
3082,2014,Franklin,female,1521,27816,22876,50692,0.06648889666025529,Texas
3083,2014,Franklin,female,1521,32281,32621,64902,0.04662640630268845,Texas
3084,2014,Franklin,female,1521,622353,652980,1275333,0.002329320959294312,Texas
3085,2014,Franklin,female,1521,75503,78248,153751,0.019438196503425008,Texas
3086,2014,Franklin,female,1521,20414,21098,41512,0.07209214143520713,Texas
3087,2014,Franklin,female,1521,5362,5317,10679,0.2860635696821516,Texas
3088,2014,Franklin,female,1521,24357,24668,49025,0.06165882925247284,Texas
3089,2014,Franklin,female,1521,27532,28701,56233,0.05299466917529006,Texas
3090,2014,Franklin,female,1521,47145,43515,90660,0.034953464322647364,Texas
3116,2015,Franklin,female,1548,15602,15940,31542,0.09711417816813049,Texas
3117,2015,Franklin,female,1548,8675,9105,17780,0.1700164744645799,Texas
3118,2015,Franklin,female,1548,6714,5022,11736,0.30824372759856633,Texas
3119,2015,Franklin,female,1548,10853,11661,22514,0.13275019295086185,Texas
3120,2015,Franklin,female,1548,6787,6492,13279,0.23844731977818853,Texas
3121,2015,Franklin,female,1548,19285,19842,39127,0.07801632899909283,Texas
3122,2015,Franklin,female,1548,11426,11416,22842,0.1355991590749825,Texas
3123,2015,Franklin,female,1548,5117,5128,10245,0.30187207488299533,Texas
3124,2015,Franklin,female,1548,12567,12996,25563,0.11911357340720222,Texas
3125,2015,Franklin,female,1548,24390,25906,50296,0.05975449702771559,Texas
3126,2015,Franklin,female,1548,9981,10341,20322,0.1496953872932985,Texas
3127,2015,Franklin,female,1548,14651,15368,30019,0.10072878709005727,Texas
3128,2015,Franklin,female,1548,34601,36334,70935,0.042604722849122034,Texas
3129,2015,Franklin,female,1548,3706,4051,7757,0.3821278696618119,Texas
3130,2015,Franklin,female,1548,51339,51442,102781,0.03009214260720812,Texas
3131,2015,Franklin,female,1548,1490,1516,3006,1.0211081794195251,Texas
3132,2015,Franklin,female,1548,27816,22876,50692,0.06766917293233082,Texas
3133,2015,Franklin,female,1548,32281,32621,64902,0.04745409398853499,Texas
3134,2015,Franklin,female,1548,622353,652980,1275333,0.00237066985206285,Texas
3135,2015,Franklin,female,1548,75503,78248,153751,0.019783253246089358,Texas
3136,2015,Franklin,female,1548,20414,21098,41512,0.07337188359086169,Texas
3137,2015,Franklin,female,1548,5362,5317,10679,0.29114162121497084,Texas
3138,2015,Franklin,female,1548,24357,24668,49025,0.06275336468299011,Texas
3139,2015,Franklin,female,1548,27532,28701,56233,0.05393540294763249,Texas
3140,2015,Franklin,female,1548,47145,43515,90660,0.035573940020682523,Texas
3166,2016,Franklin,female,1341,15602,15940,31542,0.0841279799247177,Texas
3167,2016,Franklin,female,1341,8675,9105,17780,0.1472817133443163,Texas
3168,2016,Franklin,female,1341,6714,5022,11736,0.2670250896057348,Texas
3169,2016,Franklin,female,1341,10853,11661,22514,0.11499871366092101,Texas
3170,2016,Franklin,female,1341,6787,6492,13279,0.20656192236598891,Texas
3171,2016,Franklin,female,1341,19285,19842,39127,0.06758391291200484,Texas
3172,2016,Franklin,female,1341,11426,11416,22842,0.1174667133847232,Texas
3173,2016,Franklin,female,1341,5117,5128,10245,0.26150546021840876,Texas
3174,2016,Franklin,female,1341,12567,12996,25563,0.10318559556786704,Texas
3175,2016,Franklin,female,1341,24390,25906,50296,0.05176407009959083,Texas
3176,2016,Franklin,female,1341,9981,10341,20322,0.12967798085291557,Texas
3177,2016,Franklin,female,1341,14651,15368,30019,0.0872592399791775,Texas
3178,2016,Franklin,female,1341,34601,36334,70935,0.03690757967743711,Texas
3179,2016,Franklin,female,1341,3706,4051,7757,0.33102937546284866,Texas
3180,2016,Franklin,female,1341,51339,51442,102781,0.02606819330508145,Texas
3181,2016,Franklin,female,1341,1490,1516,3006,0.8845646437994723,Texas
3182,2016,Franklin,female,1341,27816,22876,50692,0.0586203881797517,Texas
3183,2016,Franklin,female,1341,32281,32621,64902,0.04110848839704485,Texas
3184,2016,Franklin,female,1341,622353,652980,1275333,0.002053661674170725,Texas
3185,2016,Franklin,female,1341,75503,78248,153751,0.01713781821899601,Texas
3186,2016,Franklin,female,1341,20414,21098,41512,0.0635605270641767,Texas
3187,2016,Franklin,female,1341,5362,5317,10679,0.25220989279668987,Texas
3188,2016,Franklin,female,1341,24357,24668,49025,0.05436192638235771,Texas
3189,2016,Franklin,female,1341,27532,28701,56233,0.04672311069300721,Texas
3190,2016,Franklin,female,1341,47145,43515,90660,0.030816959669079626,Texas
3216,2009,Freestone,female,2003,10163,9546,19709,0.20982610517494238,Texas
3218,2010,Freestone,female,3609,10163,9546,19709,0.37806411062225015,Texas
3220,2011,Freestone,female,3268,10163,9546,19709,0.34234234234234234,Texas
3222,2012,Freestone,female,2423,10163,9546,19709,0.25382359103289337,Texas
3224,2013,Freestone,female,1912,10163,9546,19709,0.20029331657238633,Texas
3226,2014,Freestone,female,2618,10163,9546,19709,0.27425099518122775,Texas
3228,2015,Freestone,female,2822,10163,9546,19709,0.2956212025979468,Texas
3230,2016,Freestone,female,1868,10163,9546,19709,0.19568405614917242,Texas
3232,2009,Frio,female,3388,11580,7814,19394,0.43358075249552086,Texas
3234,2010,Frio,female,3362,11580,7814,19394,0.43025339134886104,Texas
3236,2011,Frio,female,4310,11580,7814,19394,0.5515740977732275,Texas
3238,2012,Frio,female,2577,11580,7814,19394,0.32979267980547733,Texas
3240,2013,Frio,female,2141,11580,7814,19394,0.27399539288456615,Texas
3242,2014,Frio,female,2869,11580,7814,19394,0.3671615049910417,Texas
3244,2015,Frio,female,1743,11580,7814,19394,0.22306117225492705,Texas
3246,2016,Frio,female,2454,11580,7814,19394,0.31405170207320193,Texas
3248,2009,Gaines,female,1380,10320,10001,20321,0.137986201379862,Texas
3250,2010,Gaines,female,1033,10320,10001,20321,0.10328967103289671,Texas
3252,2011,Gaines,female,1459,10320,10001,20321,0.14588541145885411,Texas
3254,2012,Gaines,female,1299,10320,10001,20321,0.12988701129887012,Texas
3256,2013,Gaines,female,780,10320,10001,20321,0.07799220077992201,Texas
3258,2014,Gaines,female,604,10320,10001,20321,0.0603939606039396,Texas
3260,2015,Gaines,female,1000,10320,10001,20321,0.0999900009999,Texas
3262,2016,Gaines,female,665,10320,10001,20321,0.0664933506649335,Texas
3264,2009,Galveston,female,5755,161269,165820,327089,0.03470630804486793,Texas
3266,2010,Galveston,female,6398,161269,165820,327089,0.0385840067543119,Texas
3268,2011,Galveston,female,6087,161269,165820,327089,0.036708479073694365,Texas
3270,2012,Galveston,female,6588,161269,165820,327089,0.03972982752382101,Texas
3272,2013,Galveston,female,5050,161269,165820,327089,0.030454709926426245,Texas
3274,2014,Galveston,female,5821,161269,165820,327089,0.03510432999638162,Texas
3276,2015,Galveston,female,5287,161269,165820,327089,0.03188397057049813,Texas
3278,2016,Galveston,female,5167,161269,165820,327089,0.031160294295018695,Texas
3280,2009,Garza,female,1569,4070,2218,6288,0.7073940486925158,Texas
3282,2010,Garza,female,821,4070,2218,6288,0.3701532912533814,Texas
3284,2011,Garza,female,1098,4070,2218,6288,0.4950405770964833,Texas
3286,2012,Garza,female,1658,4070,2218,6288,0.7475202885482417,Texas
3288,2013,Garza,female,1273,4070,2218,6288,0.5739404869251578,Texas
3290,2014,Garza,female,1006,4070,2218,6288,0.45356176735798015,Texas
3292,2015,Garza,female,819,4070,2218,6288,0.3692515779981966,Texas
3294,2016,Garza,female,1043,4070,2218,6288,0.47024346257889993,Texas
3296,2009,Gillespie,female,1523,12731,13477,26208,0.1130073458484826,Texas
3298,2010,Gillespie,female,2041,12731,13477,26208,0.15144319952511687,Texas
3300,2011,Gillespie,female,1653,12731,13477,26208,0.12265340951250278,Texas
3302,2012,Gillespie,female,2134,12731,13477,26208,0.15834384506937746,Texas
3304,2013,Gillespie,female,1869,12731,13477,26208,0.13868071529272094,Texas
3306,2014,Gillespie,female,1259,12731,13477,26208,0.09341841656154931,Texas
3308,2015,Gillespie,female,990,12731,13477,26208,0.07345848482599986,Texas
3310,2016,Gillespie,female,773,12731,13477,26208,0.05735697855605847,Texas
3312,2009,Glasscock,female,114,787,643,1430,0.17729393468118196,Texas
3314,2010,Glasscock,female,59,787,643,1430,0.09175738724727839,Texas
3316,2011,Glasscock,female,62,787,643,1430,0.09642301710730948,Texas
3318,2012,Glasscock,female,122,787,643,1430,0.18973561430793157,Texas
3320,2013,Glasscock,female,133,787,643,1430,0.20684292379471228,Texas
3322,2014,Glasscock,female,79,787,643,1430,0.12286158631415241,Texas
3324,2015,Glasscock,female,142,787,643,1430,0.2208398133748056,Texas
3326,2016,Glasscock,female,101,787,643,1430,0.15707620528771385,Texas
3328,2009,Goliad,female,1630,3734,3797,7531,0.4292862786410324,Texas
3330,2010,Goliad,female,789,3734,3797,7531,0.20779562812746905,Texas
3332,2011,Goliad,female,663,3734,3797,7531,0.17461153542270214,Texas
3334,2012,Goliad,female,610,3734,3797,7531,0.16065314722149066,Texas
3336,2013,Goliad,female,472,3734,3797,7531,0.12430866473531736,Texas
3338,2014,Goliad,female,229,3734,3797,7531,0.06031077166183829,Texas
3340,2015,Goliad,female,651,3734,3797,7531,0.17145114564129577,Texas
3342,2016,Goliad,female,323,3734,3797,7531,0.08506715828285488,Texas
3344,2009,Gonzales,female,4049,10448,10219,20667,0.3962227223798806,Texas
3346,2010,Gonzales,female,4314,10448,10219,20667,0.422154809668265,Texas
3348,2011,Gonzales,female,5005,10448,10219,20667,0.4897739504843918,Texas
3350,2012,Gonzales,female,4324,10448,10219,20667,0.42313337899990217,Texas
3352,2013,Gonzales,female,3803,10448,10219,20667,0.3721499168216068,Texas
3354,2014,Gonzales,female,3353,10448,10219,20667,0.3281142968979352,Texas
3356,2015,Gonzales,female,4123,10448,10219,20667,0.4034641354339955,Texas
3358,2016,Gonzales,female,3349,10448,10219,20667,0.3277228691652804,Texas
3360,2009,Gray,female,1442,3025,3012,6037,0.47875166002656044,Texas
3361,2009,Gray,female,1442,11903,10782,22685,0.13374142088666297,Texas
3364,2010,Gray,female,1946,3025,3012,6037,0.6460823373173971,Texas
3365,2010,Gray,female,1946,11903,10782,22685,0.18048599517714708,Texas
3368,2011,Gray,female,1221,3025,3012,6037,0.40537848605577687,Texas
3369,2011,Gray,female,1221,11903,10782,22685,0.1132442960489705,Texas
3372,2012,Gray,female,1642,3025,3012,6037,0.5451527224435591,Texas
3373,2012,Gray,female,1642,11903,10782,22685,0.15229085512891857,Texas
3376,2013,Gray,female,1541,3025,3012,6037,0.5116201859229748,Texas
3377,2013,Gray,female,1541,11903,10782,22685,0.14292339083657948,Texas
3380,2014,Gray,female,2128,3025,3012,6037,0.7065073041168659,Texas
3381,2014,Gray,female,2128,11903,10782,22685,0.1973659803375997,Texas
3384,2015,Gray,female,1056,3025,3012,6037,0.350597609561753,Texas
3385,2015,Gray,female,1056,11903,10782,22685,0.09794101279910963,Texas
3388,2016,Gray,female,1408,3025,3012,6037,0.4674634794156706,Texas
3389,2016,Gray,female,1408,11903,10782,22685,0.1305880170654795,Texas
3392,2009,Grayson,female,5592,13073,13105,26178,0.42670736360167877,Texas
3393,2009,Grayson,female,5592,62737,65823,128560,0.08495510687753521,Texas
3394,2009,Grayson,female,5592,7995,7816,15811,0.7154554759467758,Texas
3398,2010,Grayson,female,5682,13073,13105,26178,0.4335749713849676,Texas
3399,2010,Grayson,female,5682,62737,65823,128560,0.08632241009981313,Texas
3400,2010,Grayson,female,5682,7995,7816,15811,0.7269703172978506,Texas
3404,2011,Grayson,female,4933,13073,13105,26178,0.37642121327737504,Texas
3405,2011,Grayson,female,4933,62737,65823,128560,0.07494340883885572,Texas
3406,2011,Grayson,female,4933,7995,7816,15811,0.6311412487205732,Texas
3410,2012,Grayson,female,4667,13073,13105,26178,0.3561236169400992,Texas
3411,2012,Grayson,female,4667,62737,65823,128560,0.07090226820412318,Texas
3412,2012,Grayson,female,4667,7995,7816,15811,0.5971084953940634,Texas
3416,2013,Grayson,female,4429,13073,13105,26178,0.33796260969095765,Texas
3417,2013,Grayson,female,4429,62737,65823,128560,0.06728651079409932,Texas
3418,2013,Grayson,female,4429,7995,7816,15811,0.5666581371545547,Texas
3422,2014,Grayson,female,3511,13073,13105,26178,0.2679130103014117,Texas
3423,2014,Grayson,female,3511,62737,65823,128560,0.05334001792686447,Texas
3424,2014,Grayson,female,3511,7995,7816,15811,0.4492067553735926,Texas
3428,2015,Grayson,female,3375,13073,13105,26178,0.2575352918733308,Texas
3429,2015,Grayson,female,3375,62737,65823,128560,0.05127387083542227,Texas
3430,2015,Grayson,female,3375,7995,7816,15811,0.43180655066530194,Texas
3434,2016,Grayson,female,3983,13073,13105,26178,0.30392979778710416,Texas
3435,2016,Grayson,female,3983,62737,65823,128560,0.060510763714810935,Texas
3436,2016,Grayson,female,3983,7995,7816,15811,0.5095957011258956,Texas
3440,2009,Gregg,female,6754,60208,63286,123494,0.10672186581550422,Texas
3442,2010,Gregg,female,6292,60208,63286,123494,0.09942167303985083,Texas
3444,2011,Gregg,female,7706,60208,63286,123494,0.12176468729260816,Texas
3446,2012,Gregg,female,7953,60208,63286,123494,0.1256676042094618,Texas
3448,2013,Gregg,female,7074,60208,63286,123494,0.11177827639604336,Texas
3450,2014,Gregg,female,4921,60208,63286,123494,0.07775811395885346,Texas
3452,2015,Gregg,female,4917,60208,63286,123494,0.07769490882659671,Texas
3454,2016,Gregg,female,4368,60208,63286,123494,0.06902000442435925,Texas
3456,2009,Grimes,female,2129,14892,12738,27630,0.16713769822578112,Texas
3458,2010,Grimes,female,2134,14892,12738,27630,0.16753022452504318,Texas
3460,2011,Grimes,female,2164,14892,12738,27630,0.16988538232061548,Texas
3462,2012,Grimes,female,1957,14892,12738,27630,0.15363479353116657,Texas
3464,2013,Grimes,female,2194,14892,12738,27630,0.17224054011618778,Texas
3466,2014,Grimes,female,974,14892,12738,27630,0.07646412309624745,Texas
3468,2015,Grimes,female,681,14892,12738,27630,0.05346208195949129,Texas
3470,2016,Grimes,female,1441,14892,12738,27630,0.11312607944732297,Texas
3472,2009,Guadalupe,female,5391,2507,1875,4382,2.8752,Texas
3473,2009,Guadalupe,female,5391,76850,78287,155137,0.06886200774074878,Texas
3476,2010,Guadalupe,female,6132,2507,1875,4382,3.2704,Texas
3477,2010,Guadalupe,female,6132,76850,78287,155137,0.07832718075798026,Texas
3480,2011,Guadalupe,female,5981,2507,1875,4382,3.1898666666666666,Texas
3481,2011,Guadalupe,female,5981,76850,78287,155137,0.07639838031857141,Texas
3484,2012,Guadalupe,female,5740,2507,1875,4382,3.0613333333333332,Texas
3485,2012,Guadalupe,female,5740,76850,78287,155137,0.07331996372322352,Texas
3488,2013,Guadalupe,female,6752,2507,1875,4382,3.6010666666666666,Texas
3489,2013,Guadalupe,female,6752,76850,78287,155137,0.0862467587211159,Texas
3492,2014,Guadalupe,female,5211,2507,1875,4382,2.7792,Texas
3493,2014,Guadalupe,female,5211,76850,78287,155137,0.0665627754288707,Texas
3496,2015,Guadalupe,female,3831,2507,1875,4382,2.0432,Texas
3497,2015,Guadalupe,female,3831,76850,78287,155137,0.04893532770447201,Texas
3500,2016,Guadalupe,female,2989,2507,1875,4382,1.5941333333333334,Texas
3501,2016,Guadalupe,female,2989,76850,78287,155137,0.038180029890020055,Texas
3504,2009,Hale,female,4471,7019,7868,14887,0.5682511438739197,Texas
3505,2009,Hale,female,4471,17751,16362,34113,0.2732551032881066,Texas
3508,2010,Hale,female,3425,7019,7868,14887,0.4353075749872903,Texas
3509,2010,Hale,female,3425,17751,16362,34113,0.209326488204376,Texas
3512,2011,Hale,female,3377,7019,7868,14887,0.42920691408235895,Texas
3513,2011,Hale,female,3377,17751,16362,34113,0.20639286150837305,Texas
3516,2012,Hale,female,2919,7019,7868,14887,0.3709964412811388,Texas
3517,2012,Hale,female,2919,17751,16362,34113,0.1784011734506784,Texas
3520,2013,Hale,female,2612,7019,7868,14887,0.33197763091001525,Texas
3521,2013,Hale,female,2612,17751,16362,34113,0.1596381860408263,Texas
3524,2014,Hale,female,1428,7019,7868,14887,0.18149466192170818,Texas
3525,2014,Hale,female,1428,17751,16362,34113,0.08727539420608728,Texas
3528,2015,Hale,female,2073,7019,7868,14887,0.2634722928317234,Texas
3529,2015,Hale,female,2073,17751,16362,34113,0.1266960029336267,Texas
3532,2016,Hale,female,2114,7019,7868,14887,0.26868327402135234,Texas
3533,2016,Hale,female,2114,17751,16362,34113,0.12920180906979586,Texas
3536,2009,Hall,female,428,97518,98443,195961,0.004347693589183589,Texas
3537,2009,Hall,female,428,30830,30513,61343,0.014026808245665781,Texas
3538,2009,Hall,female,428,1546,1528,3074,0.2801047120418848,Texas
3542,2010,Hall,female,512,97518,98443,195961,0.005200979246873826,Texas
3543,2010,Hall,female,512,30830,30513,61343,0.01677973322846,Texas
3544,2010,Hall,female,512,1546,1528,3074,0.33507853403141363,Texas
3548,2011,Hall,female,407,97518,98443,195961,0.004134372174761029,Texas
3549,2011,Hall,female,407,30830,30513,61343,0.013338576999967227,Texas
3550,2011,Hall,female,407,1546,1528,3074,0.2663612565445026,Texas
3554,2012,Hall,female,262,97518,98443,195961,0.0026614385989862156,Texas
3555,2012,Hall,female,262,30830,30513,61343,0.008586504113001017,Texas
3556,2012,Hall,female,262,1546,1528,3074,0.17146596858638743,Texas
3560,2013,Hall,female,267,97518,98443,195961,0.0027122294119439677,Texas
3561,2013,Hall,female,267,30830,30513,61343,0.008750368695310196,Texas
3562,2013,Hall,female,267,1546,1528,3074,0.17473821989528796,Texas
3566,2014,Hall,female,135,97518,98443,195961,0.0013713519498593095,Texas
3567,2014,Hall,female,135,30830,30513,61343,0.0044243437223478515,Texas
3568,2014,Hall,female,135,1546,1528,3074,0.08835078534031414,Texas
3572,2015,Hall,female,532,97518,98443,195961,0.005404142498704834,Texas
3573,2015,Hall,female,532,30830,30513,61343,0.017435191557696718,Texas
3574,2015,Hall,female,532,1546,1528,3074,0.3481675392670157,Texas
3578,2016,Hall,female,229,97518,98443,195961,0.0023262192334650507,Texas
3579,2016,Hall,female,229,30830,30513,61343,0.00750499786976043,Texas
3580,2016,Hall,female,229,1546,1528,3074,0.149869109947644,Texas
3584,2009,Hamilton,female,967,8281,5988,14269,0.16148964595858384,Texas
3585,2009,Hamilton,female,967,4018,4203,8221,0.23007375684035214,Texas
3586,2009,Hamilton,female,967,154532,161563,316095,0.0059852812834621785,Texas
3587,2009,Hamilton,female,967,7377,7733,15110,0.1250484934695461,Texas
3588,2009,Hamilton,female,967,1353,1263,2616,0.765637371338084,Texas
3589,2009,Hamilton,female,967,4564,4614,9178,0.20957954052882533,Texas
3590,2009,Hamilton,female,967,2347,2228,4575,0.43402154398563736,Texas
3591,2009,Hamilton,female,967,391728,420309,812037,0.0023006883031293644,Texas
3592,2009,Hamilton,female,967,172447,185099,357546,0.005224231357273675,Texas
3593,2009,Hamilton,female,967,4070,4199,8269,0.23029292688735414,Texas
3604,2010,Hamilton,female,1172,8281,5988,14269,0.1957247828991316,Texas
3605,2010,Hamilton,female,1172,4018,4203,8221,0.27884844158934097,Texas
3606,2010,Hamilton,female,1172,154532,161563,316095,0.007254136157412279,Texas
3607,2010,Hamilton,female,1172,7377,7733,15110,0.15155825682141472,Texas
3608,2010,Hamilton,female,1172,1353,1263,2616,0.9279493269992082,Texas
3609,2010,Hamilton,female,1172,4564,4614,9178,0.2540095361941916,Texas
3610,2010,Hamilton,female,1172,2347,2228,4575,0.526032315978456,Texas
3611,2010,Hamilton,female,1172,391728,420309,812037,0.002788424706584917,Texas
3612,2010,Hamilton,female,1172,172447,185099,357546,0.0063317467949583735,Texas
3613,2010,Hamilton,female,1172,4070,4199,8269,0.27911407477970945,Texas
3624,2011,Hamilton,female,943,8281,5988,14269,0.1574816299265197,Texas
3625,2011,Hamilton,female,943,4018,4203,8221,0.22436354984534856,Texas
3626,2011,Hamilton,female,943,154532,161563,316095,0.00583673242017046,Texas
3627,2011,Hamilton,female,943,7377,7733,15110,0.12194491141859563,Texas
3628,2011,Hamilton,female,943,1353,1263,2616,0.7466349960411718,Texas
3629,2011,Hamilton,female,943,4564,4614,9178,0.20437798006068486,Texas
3630,2011,Hamilton,female,943,2347,2228,4575,0.4232495511669659,Texas
3631,2011,Hamilton,female,943,391728,420309,812037,0.0022435874558955436,Texas
3632,2011,Hamilton,female,943,172447,185099,357546,0.005094571013349613,Texas
3633,2011,Hamilton,female,943,4070,4199,8269,0.22457728030483448,Texas
3644,2012,Hamilton,female,786,8281,5988,14269,0.1312625250501002,Texas
3645,2012,Hamilton,female,786,4018,4203,8221,0.1870092790863669,Texas
3646,2012,Hamilton,female,786,154532,161563,316095,0.004864975272803798,Texas
3647,2012,Hamilton,female,786,7377,7733,15110,0.10164231216862796,Texas
3648,2012,Hamilton,female,786,1353,1263,2616,0.6223277909738717,Texas
3649,2012,Hamilton,female,786,4564,4614,9178,0.17035110533159947,Texas
3650,2012,Hamilton,female,786,2347,2228,4575,0.3527827648114901,Texas
3651,2012,Hamilton,female,786,391728,420309,812037,0.0018700527469076322,Texas
3652,2012,Hamilton,female,786,172447,185099,357546,0.004246376263513039,Texas
3653,2012,Hamilton,female,786,4070,4199,8269,0.18718742557751847,Texas
3664,2013,Hamilton,female,370,8281,5988,14269,0.061790247160988646,Texas
3665,2013,Hamilton,female,370,4018,4203,8221,0.08803235783963835,Texas
3666,2013,Hamilton,female,370,154532,161563,316095,0.0022901283090806684,Texas
3667,2013,Hamilton,female,370,7377,7733,15110,0.04784688995215311,Texas
3668,2013,Hamilton,female,370,1353,1263,2616,0.2929532858273951,Texas
3669,2013,Hamilton,female,370,4564,4614,9178,0.08019072388383182,Texas
3670,2013,Hamilton,female,370,2347,2228,4575,0.16606822262118492,Texas
3671,2013,Hamilton,female,370,391728,420309,812037,0.0008803047281880712,Texas
3672,2013,Hamilton,female,370,172447,185099,357546,0.0019989303021626264,Texas
3673,2013,Hamilton,female,370,4070,4199,8269,0.0881162181471779,Texas
3684,2014,Hamilton,female,792,8281,5988,14269,0.13226452905811623,Texas
3685,2014,Hamilton,female,792,4018,4203,8221,0.18843683083511778,Texas
3686,2014,Hamilton,female,792,154532,161563,316095,0.004902112488626728,Texas
3687,2014,Hamilton,female,792,7377,7733,15110,0.10241820768136557,Texas
3688,2014,Hamilton,female,792,1353,1263,2616,0.6270783847980997,Texas
3689,2014,Hamilton,female,792,4564,4614,9178,0.1716514954486346,Texas
3690,2014,Hamilton,female,792,2347,2228,4575,0.35547576301615796,Texas
3691,2014,Hamilton,female,792,391728,420309,812037,0.0018843279587160875,Texas
3692,2014,Hamilton,female,792,172447,185099,357546,0.004278791349494055,Texas
3693,2014,Hamilton,female,792,4070,4199,8269,0.18861633722314836,Texas
3704,2015,Hamilton,female,528,8281,5988,14269,0.08817635270541083,Texas
3705,2015,Hamilton,female,528,4018,4203,8221,0.1256245538900785,Texas
3706,2015,Hamilton,female,528,154532,161563,316095,0.0032680749924178186,Texas
3707,2015,Hamilton,female,528,7377,7733,15110,0.06827880512091039,Texas
3708,2015,Hamilton,female,528,1353,1263,2616,0.4180522565320665,Texas
3709,2015,Hamilton,female,528,4564,4614,9178,0.11443433029908973,Texas
3710,2015,Hamilton,female,528,2347,2228,4575,0.236983842010772,Texas
3711,2015,Hamilton,female,528,391728,420309,812037,0.0012562186391440583,Texas
3712,2015,Hamilton,female,528,172447,185099,357546,0.00285252756632937,Texas
3713,2015,Hamilton,female,528,4070,4199,8269,0.12574422481543224,Texas
3724,2016,Hamilton,female,666,8281,5988,14269,0.11122244488977956,Texas
3725,2016,Hamilton,female,666,4018,4203,8221,0.15845824411134904,Texas
3726,2016,Hamilton,female,666,154532,161563,316095,0.004122230956345203,Texas
3727,2016,Hamilton,female,666,7377,7733,15110,0.0861244019138756,Texas
3728,2016,Hamilton,female,666,1353,1263,2616,0.5273159144893111,Texas
3729,2016,Hamilton,female,666,4564,4614,9178,0.14434330299089726,Texas
3730,2016,Hamilton,female,666,2347,2228,4575,0.2989228007181329,Texas
3731,2016,Hamilton,female,666,391728,420309,812037,0.0015845485107385282,Texas
3732,2016,Hamilton,female,666,172447,185099,357546,0.003598074543892728,Texas
3733,2016,Hamilton,female,666,4070,4199,8269,0.1586091926649202,Texas
3744,2009,Hansford,female,499,2783,2764,5547,0.18053545586107092,Texas
3746,2010,Hansford,female,280,2783,2764,5547,0.10130246020260492,Texas
3748,2011,Hansford,female,250,2783,2764,5547,0.09044862518089725,Texas
3750,2012,Hansford,female,244,2783,2764,5547,0.08827785817655572,Texas
3752,2013,Hansford,female,184,2783,2764,5547,0.06657018813314038,Texas
3754,2014,Hansford,female,272,2783,2764,5547,0.09840810419681621,Texas
3756,2015,Hansford,female,277,2783,2764,5547,0.10021707670043416,Texas
3758,2016,Hansford,female,25,2783,2764,5547,0.009044862518089725,Texas
3760,2009,Hardeman,female,917,14088,11474,25562,0.07991981872058568,Texas
3761,2009,Hardeman,female,917,1938,2014,3952,0.45531281032770604,Texas
3764,2010,Hardeman,female,895,14088,11474,25562,0.07800244029980827,Texas
3765,2010,Hardeman,female,895,1938,2014,3952,0.4443892750744787,Texas
3768,2011,Hardeman,female,908,14088,11474,25562,0.07913543663935856,Texas
3769,2011,Hardeman,female,908,1938,2014,3952,0.45084409136047665,Texas
3772,2012,Hardeman,female,986,14088,11474,25562,0.08593341467666027,Texas
3773,2012,Hardeman,female,986,1938,2014,3952,0.48957298907646474,Texas
3776,2013,Hardeman,female,732,14088,11474,25562,0.06379640927313927,Texas
3777,2013,Hardeman,female,732,1938,2014,3952,0.3634558093346574,Texas
3780,2014,Hardeman,female,887,14088,11474,25562,0.07730521178316194,Texas
3781,2014,Hardeman,female,887,1938,2014,3952,0.4404170804369414,Texas
3784,2015,Hardeman,female,511,14088,11474,25562,0.04453547150078438,Texas
3785,2015,Hardeman,female,511,1938,2014,3952,0.25372393247269115,Texas
3788,2016,Hardeman,female,360,14088,11474,25562,0.03137528324908489,Texas
3789,2016,Hardeman,female,360,1938,2014,3952,0.17874875868917578,Texas
3792,2009,Hardin,female,2105,1976,2033,4009,1.0354156419085097,Texas
3793,2009,Hardin,female,2105,8565,8562,17127,0.2458537724830647,Texas
3794,2009,Hardin,female,2105,53723,54372,108095,0.03871477966600456,Texas
3795,2009,Hardin,female,2105,15639,15903,31542,0.13236496258567565,Texas
3796,2009,Hardin,female,2105,12606,13165,25771,0.1598936574249905,Texas
3797,2009,Hardin,female,2105,27342,29037,56379,0.0724937149154527,Texas
3804,2010,Hardin,female,1947,1976,2033,4009,0.9576979832759469,Texas
3805,2010,Hardin,female,1947,8565,8562,17127,0.2274001401541696,Texas
3806,2010,Hardin,female,1947,53723,54372,108095,0.035808872213639376,Texas
3807,2010,Hardin,female,1947,15639,15903,31542,0.12242973023957744,Texas
3808,2010,Hardin,female,1947,12606,13165,25771,0.1478921382453475,Texas
3809,2010,Hardin,female,1947,27342,29037,56379,0.06705238144436408,Texas
3816,2011,Hardin,female,3478,1976,2033,4009,1.7107722577471716,Texas
3817,2011,Hardin,female,3478,8565,8562,17127,0.40621350151833685,Texas
3818,2011,Hardin,female,3478,53723,54372,108095,0.06396674759067167,Texas
3819,2011,Hardin,female,3478,15639,15903,31542,0.21870087404892158,Texas
3820,2011,Hardin,female,3478,12606,13165,25771,0.2641853399164451,Texas
3821,2011,Hardin,female,3478,27342,29037,56379,0.11977821400282399,Texas
3828,2012,Hardin,female,3685,1976,2033,4009,1.8125922282341367,Texas
3829,2012,Hardin,female,3685,8565,8562,17127,0.43039009577201587,Texas
3830,2012,Hardin,female,3685,53723,54372,108095,0.06777385418965644,Texas
3831,2012,Hardin,female,3685,15639,15903,31542,0.23171728604665787,Texas
3832,2012,Hardin,female,3685,12606,13165,25771,0.27990884922142045,Texas
3833,2012,Hardin,female,3685,27342,29037,56379,0.1269070496263388,Texas
3840,2013,Hardin,female,2744,1976,2033,4009,1.3497294638465323,Texas
3841,2013,Hardin,female,2744,8565,8562,17127,0.3204858677879,Texas
3842,2013,Hardin,female,2744,53723,54372,108095,0.050467152210696684,Texas
3843,2013,Hardin,female,2744,15639,15903,31542,0.17254606049173113,Texas
3844,2013,Hardin,female,2744,12606,13165,25771,0.20843144701860994,Texas
3845,2013,Hardin,female,2744,27342,29037,56379,0.09450012053586802,Texas
3852,2014,Hardin,female,2135,1976,2033,4009,1.0501721593703885,Texas
3853,2014,Hardin,female,2135,8565,8562,17127,0.24935762672272835,Texas
3854,2014,Hardin,female,2135,53723,54372,108095,0.03926653424556757,Texas
3855,2014,Hardin,female,2135,15639,15903,31542,0.13425139910708672,Texas
3856,2014,Hardin,female,2135,12606,13165,25771,0.1621724268894797,Texas
3857,2014,Hardin,female,2135,27342,29037,56379,0.07352687949857079,Texas
3864,2015,Hardin,female,1420,1976,2033,4009,0.6984751598622725,Texas
3865,2015,Hardin,female,1420,8565,8562,17127,0.16584910067741182,Texas
3866,2015,Hardin,female,1420,53723,54372,108095,0.026116383432649156,Texas
3867,2015,Hardin,female,1420,15639,15903,31542,0.08929132868012325,Texas
3868,2015,Hardin,female,1420,12606,13165,25771,0.10786175465248765,Texas
3869,2015,Hardin,female,1420,27342,29037,56379,0.04890312360092296,Texas
3876,2016,Hardin,female,1285,1976,2033,4009,0.632070831283817,Texas
3877,2016,Hardin,female,1285,8565,8562,17127,0.15008175659892548,Texas
3878,2016,Hardin,female,1285,53723,54372,108095,0.02363348782461561,Texas
3879,2016,Hardin,female,1285,15639,15903,31542,0.0808023643337735,Texas
3880,2016,Hardin,female,1285,12606,13165,25771,0.09760729206228637,Texas
3881,2016,Hardin,female,1285,27342,29037,56379,0.044253882976891555,Texas
3888,2009,Harris,female,22055,16832,16758,33590,1.3160878386442296,Texas
3889,2009,Harris,female,22055,2288295,2314228,4602523,0.009530175937720917,Texas
3892,2010,Harris,female,20371,16832,16758,33590,1.2155985201097983,Texas
3893,2010,Harris,female,20371,2288295,2314228,4602523,0.008802503469839618,Texas
3896,2011,Harris,female,22786,16832,16758,33590,1.3597087957990213,Texas
3897,2011,Harris,female,22786,2288295,2314228,4602523,0.009846048012555375,Texas
3900,2012,Harris,female,23055,16832,16758,33590,1.3757608306480487,Texas
3901,2012,Harris,female,23055,2288295,2314228,4602523,0.009962285479218123,Texas
3904,2013,Harris,female,19021,16832,16758,33590,1.1350399809046425,Texas
3905,2013,Harris,female,19021,2288295,2314228,4602523,0.008219155588818387,Texas
3908,2014,Harris,female,18012,16832,16758,33590,1.0748299319727892,Texas
3909,2014,Harris,female,18012,2288295,2314228,4602523,0.007783157061447705,Texas
3912,2015,Harris,female,16997,16832,16758,33590,1.0142618450889127,Texas
3913,2015,Harris,female,16997,2288295,2314228,4602523,0.00734456587682804,Texas
3916,2016,Harris,female,16713,16832,16758,33590,0.9973147153598282,Texas
3917,2016,Harris,female,16713,2288295,2314228,4602523,0.0072218467670428325,Texas
3920,2009,Harrison,female,7825,19875,19837,39712,0.39446488884407926,Texas
3921,2009,Harrison,female,7825,6989,7154,14143,1.093793681856304,Texas
3922,2009,Harrison,female,7825,9146,9522,18668,0.8217811384162991,Texas
3923,2009,Harrison,female,7825,99750,102876,202626,0.07606244410746918,Texas
3924,2009,Harrison,female,7825,4263,4291,8554,1.823584246096481,Texas
3925,2009,Harrison,female,7825,7566,7741,15307,1.0108513112001034,Texas
3926,2009,Harrison,female,7825,32556,34089,66645,0.22954618791985684,Texas
3927,2009,Harrison,female,7825,33301,34908,68209,0.2241606508536725,Texas
3936,2010,Harrison,female,8757,19875,19837,39712,0.4414477995664667,Texas
3937,2010,Harrison,female,8757,6989,7154,14143,1.2240704500978474,Texas
3938,2010,Harrison,female,8757,9146,9522,18668,0.9196597353497165,Texas
3939,2010,Harrison,female,8757,99750,102876,202626,0.08512189431937478,Texas
3940,2010,Harrison,female,8757,4263,4291,8554,2.040783034257749,Texas
3941,2010,Harrison,female,8757,7566,7741,15307,1.1312491926107737,Texas
3942,2010,Harrison,female,8757,32556,34089,66645,0.2568863856375957,Texas
3943,2010,Harrison,female,8757,33301,34908,68209,0.250859401856308,Texas
3952,2011,Harrison,female,8143,19875,19837,39712,0.41049553863991534,Texas
3953,2011,Harrison,female,8143,6989,7154,14143,1.138244338831423,Texas
3954,2011,Harrison,female,8143,9146,9522,18668,0.8551774837219072,Texas
3955,2011,Harrison,female,8143,99750,102876,202626,0.0791535440724756,Texas
3956,2011,Harrison,female,8143,4263,4291,8554,1.8976928454905617,Texas
3957,2011,Harrison,female,8143,7566,7741,15307,1.051931275029066,Texas
3958,2011,Harrison,female,8143,32556,34089,66645,0.2388747103171111,Texas
3959,2011,Harrison,female,8143,33301,34908,68209,0.2332703105305374,Texas
3968,2012,Harrison,female,10644,19875,19837,39712,0.536573070524777,Texas
3969,2012,Harrison,female,10644,6989,7154,14143,1.4878389712049203,Texas
3970,2012,Harrison,female,10644,9146,9522,18668,1.1178323881537493,Texas
3971,2012,Harrison,female,10644,99750,102876,202626,0.10346436486644116,Texas
3972,2012,Harrison,female,10644,4263,4291,8554,2.4805406665113026,Texas
3973,2012,Harrison,female,10644,7566,7741,15307,1.375016147784524,Texas
3974,2012,Harrison,female,10644,32556,34089,66645,0.3122414855231893,Texas
3975,2012,Harrison,female,10644,33301,34908,68209,0.30491577861808183,Texas
3984,2013,Harrison,female,8858,19875,19837,39712,0.4465392952563392,Texas
3985,2013,Harrison,female,8858,6989,7154,14143,1.2381884260553537,Texas
3986,2013,Harrison,female,8858,9146,9522,18668,0.9302667506826297,Texas
3987,2013,Harrison,female,8858,99750,102876,202626,0.08610365877366927,Texas
3988,2013,Harrison,female,8858,4263,4291,8554,2.064320671172221,Texas
3989,2013,Harrison,female,8858,7566,7741,15307,1.144296602506136,Texas
3990,2013,Harrison,female,8858,32556,34089,66645,0.25984921822288715,Texas
3991,2013,Harrison,female,8858,33301,34908,68209,0.2537527214392116,Texas
4000,2014,Harrison,female,6882,19875,19837,39712,0.34692745878913145,Texas
4001,2014,Harrison,female,6882,6989,7154,14143,0.9619793122728544,Texas
4002,2014,Harrison,female,6882,9146,9522,18668,0.7227473219911783,Texas
4003,2014,Harrison,female,6882,99750,102876,202626,0.06689606905400676,Texas
4004,2014,Harrison,female,6882,4263,4291,8554,1.6038219529247262,Texas
4005,2014,Harrison,female,6882,7566,7741,15307,0.8890324247513242,Texas
4006,2014,Harrison,female,6882,32556,34089,66645,0.20188330546510605,Texas
4007,2014,Harrison,female,6882,33301,34908,68209,0.19714678583705741,Texas
4016,2015,Harrison,female,6233,19875,19837,39712,0.3142108181680698,Texas
4017,2015,Harrison,female,6233,6989,7154,14143,0.8712608331003634,Texas
4018,2015,Harrison,female,6233,9146,9522,18668,0.6545893719806763,Texas
4019,2015,Harrison,female,6233,99750,102876,202626,0.06058750340215405,Texas
4020,2015,Harrison,female,6233,4263,4291,8554,1.4525751573059893,Texas
4021,2015,Harrison,female,6233,7566,7741,15307,0.8051931275029066,Texas
4022,2015,Harrison,female,6233,32556,34089,66645,0.18284490598140163,Texas
4023,2015,Harrison,female,6233,33301,34908,68209,0.1785550590122608,Texas
4032,2016,Harrison,female,6616,19875,19837,39712,0.33351817311085347,Texas
4033,2016,Harrison,female,6616,6989,7154,14143,0.9247973161867487,Texas
4034,2016,Harrison,female,6616,9146,9522,18668,0.6948120142827137,Texas
4035,2016,Harrison,female,6616,99750,102876,202626,0.06431043197635988,Texas
4036,2016,Harrison,female,6616,4263,4291,8554,1.541831740852948,Texas
4037,2016,Harrison,female,6616,7566,7741,15307,0.8546699392843302,Texas
4038,2016,Harrison,female,6616,32556,34089,66645,0.1940802018246355,Texas
4039,2016,Harrison,female,6616,33301,34908,68209,0.18952675604445973,Texas
4048,2009,Hartley,female,1388,3411,2356,5767,0.5891341256366723,Texas
4050,2010,Hartley,female,1776,3411,2356,5767,0.7538200339558574,Texas
4052,2011,Hartley,female,1814,3411,2356,5767,0.7699490662139219,Texas
4054,2012,Hartley,female,2175,3411,2356,5767,0.9231748726655348,Texas
4056,2013,Hartley,female,1670,3411,2356,5767,0.7088285229202037,Texas
4058,2014,Hartley,female,728,3411,2356,5767,0.3089983022071307,Texas
4060,2015,Hartley,female,583,3411,2356,5767,0.24745331069609508,Texas
4062,2016,Hartley,female,849,3411,2356,5767,0.3603565365025467,Texas
4064,2009,Haskell,female,980,2006,2041,4047,0.48015678588926997,Texas
4065,2009,Haskell,female,980,6311,6393,12704,0.1532926638510871,Texas
4066,2009,Haskell,female,980,3071,2738,5809,0.3579254930606282,Texas
4070,2010,Haskell,female,1166,2006,2041,4047,0.5712885840274375,Texas
4071,2010,Haskell,female,1166,6311,6393,12704,0.18238698576568121,Texas
4072,2010,Haskell,female,1166,3071,2738,5809,0.42585829072315556,Texas
4076,2011,Haskell,female,1208,2006,2041,4047,0.5918667319941205,Texas
4077,2011,Haskell,female,1208,6311,6393,12704,0.18895667135929922,Texas
4078,2011,Haskell,female,1208,3071,2738,5809,0.4411979547114682,Texas
4082,2012,Haskell,female,910,2006,2041,4047,0.445859872611465,Texas
4083,2012,Haskell,female,910,6311,6393,12704,0.14234318786172376,Texas
4084,2012,Haskell,female,910,3071,2738,5809,0.3323593864134405,Texas
4088,2013,Haskell,female,920,2006,2041,4047,0.4507594316511514,Texas
4089,2013,Haskell,female,920,6311,6393,12704,0.1439073987173471,Texas
4090,2013,Haskell,female,920,3071,2738,5809,0.3360116873630387,Texas
4094,2014,Haskell,female,725,2006,2041,4047,0.35521803037726607,Texas
4095,2014,Haskell,female,725,6311,6393,12704,0.11340528703269201,Texas
4096,2014,Haskell,female,725,3071,2738,5809,0.2647918188458729,Texas
4100,2015,Haskell,female,409,2006,2041,4047,0.20039196472317491,Texas
4101,2015,Haskell,female,409,6311,6393,12704,0.06397622399499453,Texas
4102,2015,Haskell,female,409,3071,2738,5809,0.1493791088385683,Texas
4106,2016,Haskell,female,1083,2006,2041,4047,0.5306222439980401,Texas
4107,2016,Haskell,female,1083,6311,6393,12704,0.1694040356640075,Texas
4108,2016,Haskell,female,1083,3071,2738,5809,0.3955441928414901,Texas
4112,2009,Hays,female,6498,101636,102514,204150,0.06338646428780459,Texas
4114,2010,Hays,female,5858,101636,102514,204150,0.05714341455801159,Texas
4116,2011,Hays,female,6201,101636,102514,204150,0.060489299022572524,Texas
4118,2012,Hays,female,6066,101636,102514,204150,0.05917240572019432,Texas
4120,2013,Hays,female,5827,101636,102514,204150,0.05684101683672474,Texas
4122,2014,Hays,female,4969,101636,102514,204150,0.048471428292721,Texas
4124,2015,Hays,female,4465,101636,102514,204150,0.043555026630509,Texas
4126,2016,Hays,female,4475,101636,102514,204150,0.04365257428253702,Texas
4128,2009,Hemphill,female,401,1965,2096,4061,0.19131679389312978,Texas
4130,2010,Hemphill,female,420,1965,2096,4061,0.20038167938931298,Texas
4132,2011,Hemphill,female,324,1965,2096,4061,0.15458015267175573,Texas
4134,2012,Hemphill,female,292,1965,2096,4061,0.13931297709923665,Texas
4136,2013,Hemphill,female,305,1965,2096,4061,0.14551526717557253,Texas
4138,2014,Hemphill,female,244,1965,2096,4061,0.11641221374045801,Texas
4140,2015,Hemphill,female,194,1965,2096,4061,0.09255725190839695,Texas
4142,2016,Hemphill,female,169,1965,2096,4061,0.08062977099236641,Texas
4144,2009,Henderson,female,4144,3369,3515,6884,1.1789473684210525,Texas
4145,2009,Henderson,female,4144,22328,23809,46137,0.1740518291402411,Texas
4146,2009,Henderson,female,4144,54724,58901,113625,0.07035534201456682,Texas
4147,2009,Henderson,female,4144,13446,14413,27859,0.2875182127246236,Texas
4148,2009,Henderson,female,4144,39097,41363,80460,0.10018615671010324,Texas
4154,2010,Henderson,female,3912,3369,3515,6884,1.1129445234708393,Texas
4155,2010,Henderson,female,3912,22328,23809,46137,0.1643076147675249,Texas
4156,2010,Henderson,female,3912,54724,58901,113625,0.06641652943073971,Texas
4157,2010,Henderson,female,3912,13446,14413,27859,0.2714216332477624,Texas
4158,2010,Henderson,female,3912,39097,41363,80460,0.09457727921088896,Texas
4164,2011,Henderson,female,5851,3369,3515,6884,1.6645803698435278,Texas
4165,2011,Henderson,female,5851,22328,23809,46137,0.24574740644294174,Texas
4166,2011,Henderson,female,5851,54724,58901,113625,0.09933617425850155,Texas
4167,2011,Henderson,female,5851,13446,14413,27859,0.40595295913411505,Texas
4168,2011,Henderson,female,5851,39097,41363,80460,0.1414549234823393,Texas
4174,2012,Henderson,female,4688,3369,3515,6884,1.3337126600284495,Texas
4175,2012,Henderson,female,4688,22328,23809,46137,0.19690033180729977,Texas
4176,2012,Henderson,female,4688,54724,58901,113625,0.07959117841802346,Texas
4177,2012,Henderson,female,4688,13446,14413,27859,0.32526191632553947,Texas
4178,2012,Henderson,female,4688,39097,41363,80460,0.11333800739791601,Texas
4184,2013,Henderson,female,4420,3369,3515,6884,1.2574679943100995,Texas
4185,2013,Henderson,female,4420,22328,23809,46137,0.18564408416985173,Texas
4186,2013,Henderson,female,4420,54724,58901,113625,0.07504117077808527,Texas
4187,2013,Henderson,female,4420,13446,14413,27859,0.3066675917574412,Texas
4188,2013,Henderson,female,4420,39097,41363,80460,0.10685878683847884,Texas
4194,2014,Henderson,female,3311,3369,3515,6884,0.9419630156472262,Texas
4195,2014,Henderson,female,3311,22328,23809,46137,0.13906505943130748,Texas
4196,2014,Henderson,female,3311,54724,58901,113625,0.05621296752177382,Texas
4197,2014,Henderson,female,3311,13446,14413,27859,0.22972316658572123,Texas
4198,2014,Henderson,female,3311,39097,41363,80460,0.08004738534438992,Texas
4204,2015,Henderson,female,2355,3369,3515,6884,0.6699857752489331,Texas
4205,2015,Henderson,female,2355,22328,23809,46137,0.09891217606787349,Texas
4206,2015,Henderson,female,2355,54724,58901,113625,0.03998234325393457,Texas
4207,2015,Henderson,female,2355,13446,14413,27859,0.16339415805175883,Texas
4208,2015,Henderson,female,2355,39097,41363,80460,0.05693494185624834,Texas
4214,2016,Henderson,female,3836,3369,3515,6884,1.0913229018492177,Texas
4215,2016,Henderson,female,3836,22328,23809,46137,0.16111554454197993,Texas
4216,2016,Henderson,female,3836,54724,58901,113625,0.06512622875672738,Texas
4217,2016,Henderson,female,3836,13446,14413,27859,0.2661486158329286,Texas
4218,2016,Henderson,female,3836,39097,41363,80460,0.09273988830597393,Texas
4224,2009,Hidalgo,female,23242,2149,2222,4371,10.45994599459946,Texas
4225,2009,Hidalgo,female,23242,415443,433946,849389,0.053559659496803746,Texas
4228,2010,Hidalgo,female,26935,2149,2222,4371,12.121962196219622,Texas
4229,2010,Hidalgo,female,26935,415443,433946,849389,0.06206993496886709,Texas
4232,2011,Hidalgo,female,27751,2149,2222,4371,12.489198919891988,Texas
4233,2011,Hidalgo,female,27751,415443,433946,849389,0.06395035326976167,Texas
4236,2012,Hidalgo,female,21713,2149,2222,4371,9.771827182718273,Texas
4237,2012,Hidalgo,female,21713,415443,433946,849389,0.05003617961681868,Texas
4240,2013,Hidalgo,female,24167,2149,2222,4371,10.876237623762377,Texas
4241,2013,Hidalgo,female,24167,415443,433946,849389,0.05569126112465606,Texas
4244,2014,Hidalgo,female,30407,2149,2222,4371,13.684518451845184,Texas
4245,2014,Hidalgo,female,30407,415443,433946,849389,0.07007093048443816,Texas
4248,2015,Hidalgo,female,34602,2149,2222,4371,15.572457245724573,Texas
4249,2015,Hidalgo,female,34602,415443,433946,849389,0.07973803192102243,Texas
4252,2016,Hidalgo,female,31690,2149,2222,4371,14.261926192619262,Texas
4253,2016,Hidalgo,female,31690,415443,433946,849389,0.07302751955312412,Texas
4256,2009,Hill,female,3372,8292,8147,16439,0.4138946851601817,Texas
4257,2009,Hill,female,3372,17603,17796,35399,0.1894807821982468,Texas
4260,2010,Hill,female,3780,8292,8147,16439,0.463974469129741,Texas
4261,2010,Hill,female,3780,17603,17796,35399,0.21240728253540123,Texas
4264,2011,Hill,female,4141,8292,8147,16439,0.5082852583773168,Texas
4265,2011,Hill,female,4141,17603,17796,35399,0.2326927399415599,Texas
4268,2012,Hill,female,4153,8292,8147,16439,0.5097581931999509,Texas
4269,2012,Hill,female,4153,17603,17796,35399,0.2333670487750056,Texas
4272,2013,Hill,female,3395,8292,8147,16439,0.416717810236897,Texas
4273,2013,Hill,female,3395,17603,17796,35399,0.1907732074623511,Texas
4276,2014,Hill,female,3506,8292,8147,16439,0.4303424573462624,Texas
4277,2014,Hill,female,3506,17603,17796,35399,0.197010564171724,Texas
4280,2015,Hill,female,2315,8292,8147,16439,0.2841536761998282,Texas
4281,2015,Hill,female,2315,17603,17796,35399,0.13008541245223645,Texas
4284,2016,Hill,female,1972,8292,8147,16439,0.2420522891862035,Texas
4285,2016,Hill,female,1972,17603,17796,35399,0.11081141829624634,Texas
4288,2009,Hockley,female,2551,11428,11734,23162,0.21740242031702744,Texas
4290,2010,Hockley,female,2448,11428,11734,23162,0.20862450997102439,Texas
4292,2011,Hockley,female,2008,11428,11734,23162,0.17112664053178797,Texas
4294,2012,Hockley,female,2101,11428,11734,23162,0.17905232657235384,Texas
4296,2013,Hockley,female,2119,11428,11734,23162,0.18058633032214078,Texas
4298,2014,Hockley,female,1538,11428,11734,23162,0.13107209817624,Texas
4300,2015,Hockley,female,1252,11428,11734,23162,0.10669848304073633,Texas
4302,2016,Hockley,female,1073,11428,11734,23162,0.09144366797341061,Texas
4304,2009,Hood,female,4596,28004,28897,56901,0.15904765200539847,Texas
4306,2010,Hood,female,5898,28004,28897,56901,0.20410423227324637,Texas
4308,2011,Hood,female,5101,28004,28897,56901,0.17652351455168355,Texas
4310,2012,Hood,female,5937,28004,28897,56901,0.20545385334117727,Texas
4312,2013,Hood,female,6080,28004,28897,56901,0.2104024639235907,Texas
4314,2014,Hood,female,4611,28004,28897,56901,0.15956673703152577,Texas
4316,2015,Hood,female,4226,28004,28897,56901,0.14624355469425893,Texas
4318,2016,Hood,female,4329,28004,28897,56901,0.14980793854033292,Texas
4320,2009,Hopkins,female,4950,22219,23445,45664,0.21113243761996162,Texas
4321,2009,Hopkins,female,4950,17801,18439,36240,0.26845273604859266,Texas
4324,2010,Hopkins,female,3863,22219,23445,45664,0.16476860737897206,Texas
4325,2010,Hopkins,female,3863,17801,18439,36240,0.2095015998698411,Texas
4328,2011,Hopkins,female,3990,22219,23445,45664,0.17018554062699937,Texas
4329,2011,Hopkins,female,3990,17801,18439,36240,0.2163891751179565,Texas
4332,2012,Hopkins,female,4227,22219,23445,45664,0.18029430582213693,Texas
4333,2012,Hopkins,female,4227,17801,18439,36240,0.2292423667227073,Texas
4336,2013,Hopkins,female,3430,22219,23445,45664,0.14629985071443805,Texas
4337,2013,Hopkins,female,3430,17801,18439,36240,0.18601876457508543,Texas
4340,2014,Hopkins,female,3977,22219,23445,45664,0.16963105139688633,Texas
4341,2014,Hopkins,female,3977,17801,18439,36240,0.21568414773035413,Texas
4344,2015,Hopkins,female,3653,22219,23445,45664,0.15581147366176157,Texas
4345,2015,Hopkins,female,3653,17801,18439,36240,0.19811269591626443,Texas
4348,2016,Hopkins,female,3673,22219,23445,45664,0.15666453401578162,Texas
4349,2016,Hopkins,female,3673,17801,18439,36240,0.1991973534356527,Texas
4352,2009,Houston,female,1433,50029,54323,104352,0.02637925004141892,Texas
4353,2009,Houston,female,1433,73756,77926,151682,0.0183892410748659,Texas
4354,2009,Houston,female,1433,9349,9314,18663,0.1538544127120464,Texas
4355,2009,Houston,female,1433,4066,4110,8176,0.348661800486618,Texas
4356,2009,Houston,female,1433,12432,10523,22955,0.13617789603725172,Texas
4362,2010,Houston,female,2116,50029,54323,104352,0.03895219336192773,Texas
4363,2010,Houston,female,2116,73756,77926,151682,0.027153966583681955,Texas
4364,2010,Houston,female,2116,9349,9314,18663,0.2271848829718703,Texas
4365,2010,Houston,female,2116,4066,4110,8176,0.5148418491484185,Texas
4366,2010,Houston,female,2116,12432,10523,22955,0.20108334125249452,Texas
4372,2011,Houston,female,1492,50029,54323,104352,0.027465346170130515,Texas
4373,2011,Houston,female,1492,73756,77926,151682,0.019146369632728488,Texas
4374,2011,Houston,female,1492,9349,9314,18663,0.1601889628516212,Texas
4375,2011,Houston,female,1492,4066,4110,8176,0.3630170316301703,Texas
4376,2011,Houston,female,1492,12432,10523,22955,0.1417846621685831,Texas
4382,2012,Houston,female,1399,50029,54323,104352,0.02575336413673766,Texas
4383,2012,Houston,female,1399,73756,77926,151682,0.017952929702538305,Texas
4384,2012,Houston,female,1399,9349,9314,18663,0.15020399398754564,Texas
4385,2012,Houston,female,1399,4066,4110,8176,0.34038929440389293,Texas
4386,2012,Houston,female,1399,12432,10523,22955,0.132946878266654,Texas
4392,2013,Houston,female,1193,50029,54323,104352,0.021961231890727684,Texas
4393,2013,Houston,female,1193,73756,77926,151682,0.015309396093729949,Texas
4394,2013,Houston,female,1193,9349,9314,18663,0.1280867511273352,Texas
4395,2013,Houston,female,1193,4066,4110,8176,0.2902676399026764,Texas
4396,2013,Houston,female,1193,12432,10523,22955,0.11337071177420888,Texas
4402,2014,Houston,female,1306,50029,54323,104352,0.02404138210334481,Texas
4403,2014,Houston,female,1306,73756,77926,151682,0.016759489772348125,Texas
4404,2014,Houston,female,1306,9349,9314,18663,0.14021902512347004,Texas
4405,2014,Houston,female,1306,4066,4110,8176,0.31776155717761556,Texas
4406,2014,Houston,female,1306,12432,10523,22955,0.12410909436472489,Texas
4412,2015,Houston,female,1512,50029,54323,104352,0.027833514349354785,Texas
4413,2015,Houston,female,1512,73756,77926,151682,0.019403023381156483,Texas
4414,2015,Houston,female,1512,9349,9314,18663,0.16233626798368048,Texas
4415,2015,Houston,female,1512,4066,4110,8176,0.3678832116788321,Texas
4416,2015,Houston,female,1512,12432,10523,22955,0.14368526085717,Texas
4422,2016,Houston,female,1480,50029,54323,104352,0.027244445262595954,Texas
4423,2016,Houston,female,1480,73756,77926,151682,0.01899237738367169,Texas
4424,2016,Houston,female,1480,9349,9314,18663,0.15890057977238567,Texas
4425,2016,Houston,female,1480,4066,4110,8176,0.36009732360097324,Texas
4426,2016,Houston,female,1480,12432,10523,22955,0.14064430295543096,Texas
4432,2009,Howard,female,2510,6440,6949,13389,0.3612030507986761,Texas
4433,2009,Howard,female,2510,39852,42535,82387,0.05901022687198777,Texas
4434,2009,Howard,female,2510,4580,4684,9264,0.535866780529462,Texas
4435,2009,Howard,female,2510,154285,161042,315327,0.015585996199749133,Texas
4436,2009,Howard,female,2510,5042,5071,10113,0.4949714060343128,Texas
4437,2009,Howard,female,2510,3227,3178,6405,0.78980490874764,Texas
4438,2009,Howard,female,2510,20732,15935,36667,0.15751490429871354,Texas
4446,2010,Howard,female,2680,6440,6949,13389,0.3856670024463952,Texas
4447,2010,Howard,female,2680,39852,42535,82387,0.06300693546491125,Texas
4448,2010,Howard,female,2680,4580,4684,9264,0.5721605465414176,Texas
4449,2010,Howard,female,2680,154285,161042,315327,0.016641621440369594,Texas
4450,2010,Howard,female,2680,5042,5071,10113,0.528495365805561,Texas
4451,2010,Howard,female,2680,3227,3178,6405,0.8432976714915041,Texas
4452,2010,Howard,female,2680,20732,15935,36667,0.1681832444304989,Texas
4460,2011,Howard,female,2244,6440,6949,13389,0.3229241617498921,Texas
4461,2011,Howard,female,2244,39852,42535,82387,0.052756553426589865,Texas
4462,2011,Howard,female,2244,4580,4684,9264,0.47907771135781385,Texas
4463,2011,Howard,female,2244,154285,161042,315327,0.013934253176190061,Texas
4464,2011,Howard,female,2244,5042,5071,10113,0.44251626898047725,Texas
4465,2011,Howard,female,2244,3227,3178,6405,0.7061044682190056,Texas
4466,2011,Howard,female,2244,20732,15935,36667,0.140822089739567,Texas
4474,2012,Howard,female,936,6440,6949,13389,0.13469563966038278,Texas
4475,2012,Howard,female,936,39852,42535,82387,0.02200540731162572,Texas
4476,2012,Howard,female,936,4580,4684,9264,0.19982920580700256,Texas
4477,2012,Howard,female,936,154285,161042,315327,0.00581214838365147,Texas
4478,2012,Howard,female,936,5042,5071,10113,0.18457897850522578,Texas
4479,2012,Howard,female,936,3227,3178,6405,0.2945248584015104,Texas
4480,2012,Howard,female,936,20732,15935,36667,0.05873862566677126,Texas
4488,2013,Howard,female,1394,6440,6949,13389,0.2006044035112966,Texas
4489,2013,Howard,female,1394,39852,42535,82387,0.03277301046197249,Texas
4490,2013,Howard,female,1394,4580,4684,9264,0.29760888129803587,Texas
4491,2013,Howard,female,1394,154285,161042,315327,0.008656126973087767,Texas
4492,2013,Howard,female,1394,5042,5071,10113,0.27489647012423585,Texas
4493,2013,Howard,female,1394,3227,3178,6405,0.4386406544996853,Texas
4494,2013,Howard,female,1394,20732,15935,36667,0.0874803890806401,Texas
4502,2014,Howard,female,1277,6440,6949,13389,0.18376744855374874,Texas
4503,2014,Howard,female,1277,39852,42535,82387,0.030022334548019277,Texas
4504,2014,Howard,female,1277,4580,4684,9264,0.27263023057216057,Texas
4505,2014,Howard,female,1277,154285,161042,315327,0.007929608425131332,Texas
4506,2014,Howard,female,1277,5042,5071,10113,0.2518240978110826,Texas
4507,2014,Howard,female,1277,3227,3178,6405,0.4018250471994965,Texas
4508,2014,Howard,female,1277,20732,15935,36667,0.08013806087229369,Texas
4516,2015,Howard,female,1822,6440,6949,13389,0.2621959994243776,Texas
4517,2015,Howard,female,1822,39852,42535,82387,0.04283531209592101,Texas
4518,2015,Howard,female,1822,4580,4684,9264,0.3889837745516652,Texas
4519,2015,Howard,female,1822,154285,161042,315327,0.011313818755355746,Texas
4520,2015,Howard,female,1822,5042,5071,10113,0.35929796884243737,Texas
4521,2015,Howard,female,1822,3227,3178,6405,0.5733165512901196,Texas
4522,2015,Howard,female,1822,20732,15935,36667,0.11433950423595858,Texas
4530,2016,Howard,female,2397,6440,6949,13389,0.34494171823283926,Texas
4531,2016,Howard,female,2397,39852,42535,82387,0.056353591160221,Texas
4532,2016,Howard,female,2397,4580,4684,9264,0.5117421007685738,Texas
4533,2016,Howard,female,2397,154285,161042,315327,0.014884315892748476,Texas
4534,2016,Howard,female,2397,5042,5071,10113,0.4726878327746007,Texas
4535,2016,Howard,female,2397,3227,3178,6405,0.7542479546884833,Texas
4536,2016,Howard,female,2397,20732,15935,36667,0.15042359585817383,Texas
4544,2009,Hudspeth,female,2874,2019,2079,4098,1.3823953823953823,Texas
4546,2010,Hudspeth,female,2274,2019,2079,4098,1.0937950937950938,Texas
4548,2011,Hudspeth,female,1901,2019,2079,4098,0.9143819143819144,Texas
4550,2012,Hudspeth,female,1599,2019,2079,4098,0.7691197691197691,Texas
4552,2013,Hudspeth,female,1915,2019,2079,4098,0.9211159211159211,Texas
4554,2014,Hudspeth,female,1830,2019,2079,4098,0.8802308802308803,Texas
4556,2015,Hudspeth,female,2624,2019,2079,4098,1.2621452621452622,Texas
4558,2016,Hudspeth,female,3661,2019,2079,4098,1.760942760942761,Texas
4560,2009,Hunt,female,7694,45279,46873,92152,0.16414567021526252,Texas
4562,2010,Hunt,female,7131,45279,46873,92152,0.15213449107161905,Texas
4564,2011,Hunt,female,7610,45279,46873,92152,0.16235359375333347,Texas
4566,2012,Hunt,female,6751,45279,46873,92152,0.14402747850574957,Texas
4568,2013,Hunt,female,5029,45279,46873,92152,0.10728991103620421,Texas
4570,2014,Hunt,female,5288,45279,46873,92152,0.11281548012715209,Texas
4572,2015,Hunt,female,4065,45279,46873,92152,0.08672370021120901,Texas
4574,2016,Hunt,female,5150,45279,46873,92152,0.10987135451112581,Texas
4576,2009,Hutchinson,female,926,3605,3710,7315,0.2495956873315364,Texas
4577,2009,Hutchinson,female,926,10797,10774,21571,0.08594765175422313,Texas
4580,2010,Hutchinson,female,813,3605,3710,7315,0.21913746630727762,Texas
4581,2010,Hutchinson,female,813,10797,10774,21571,0.07545943939112679,Texas
4584,2011,Hutchinson,female,1609,3605,3710,7315,0.43369272237196765,Texas
4585,2011,Hutchinson,female,1609,10797,10774,21571,0.14934100612585854,Texas
4588,2012,Hutchinson,female,1212,3605,3710,7315,0.3266846361185984,Texas
4589,2012,Hutchinson,female,1212,10797,10774,21571,0.11249303879710414,Texas
4592,2013,Hutchinson,female,762,3605,3710,7315,0.20539083557951482,Texas
4593,2013,Hutchinson,female,762,10797,10774,21571,0.07072582142194171,Texas
4596,2014,Hutchinson,female,1078,3605,3710,7315,0.29056603773584905,Texas
4597,2014,Hutchinson,female,1078,10797,10774,21571,0.10005568962316688,Texas
4600,2015,Hutchinson,female,979,3605,3710,7315,0.26388140161725065,Texas
4601,2015,Hutchinson,female,979,10797,10774,21571,0.09086690180063114,Texas
4604,2016,Hutchinson,female,884,3605,3710,7315,0.23827493261455526,Texas
4605,2016,Hutchinson,female,884,10797,10774,21571,0.0820493781325413,Texas
4608,2009,Irion,female,164,836,688,1524,0.23837209302325582,Texas
4610,2010,Irion,female,340,836,688,1524,0.4941860465116279,Texas
4612,2011,Irion,female,326,836,688,1524,0.4738372093023256,Texas
4614,2012,Irion,female,284,836,688,1524,0.4127906976744186,Texas
4616,2013,Irion,female,184,836,688,1524,0.26744186046511625,Texas
4618,2014,Irion,female,205,836,688,1524,0.29796511627906974,Texas
4620,2015,Irion,female,316,836,688,1524,0.45930232558139533,Texas
4622,2016,Irion,female,258,836,688,1524,0.375,Texas
4624,2009,Jack,female,1372,4987,3855,8842,0.35590142671854735,Texas
4626,2010,Jack,female,1133,4987,3855,8842,0.2939040207522698,Texas
4628,2011,Jack,female,1508,4987,3855,8842,0.39118028534370947,Texas
4630,2012,Jack,female,1674,4987,3855,8842,0.4342412451361868,Texas
4632,2013,Jack,female,1328,4987,3855,8842,0.3444876783398184,Texas
4634,2014,Jack,female,815,4987,3855,8842,0.21141374837872892,Texas
4636,2015,Jack,female,781,4987,3855,8842,0.2025940337224384,Texas
4638,2016,Jack,female,1862,4987,3855,8842,0.48300907911802854,Texas
4640,2009,Jackson,female,1670,25536,26558,52094,0.06288124105730854,Texas
4641,2009,Jackson,female,1670,8512,8713,17225,0.19166762309193158,Texas
4642,2009,Jackson,female,1670,631,665,1296,2.511278195488722,Texas
4643,2009,Jackson,female,1670,26784,21688,48472,0.07700110660272962,Texas
4644,2009,Jackson,female,1670,32445,33310,65755,0.05013509456619634,Texas
4645,2009,Jackson,female,1670,28989,29562,58551,0.05649144171571612,Texas
4646,2009,Jackson,female,1670,21822,22116,43938,0.07551094230421414,Texas
4647,2009,Jackson,female,1670,9712,9683,19395,0.17246721057523495,Texas
4648,2009,Jackson,female,1670,6642,6676,13318,0.25014979029358897,Texas
4649,2009,Jackson,female,1670,6655,6718,13373,0.2485858886573385,Texas
4650,2009,Jackson,female,1670,8080,7846,15926,0.21284731073158297,Texas
4651,2009,Jackson,female,1670,81205,77708,158913,0.021490708807330006,Texas
4652,2009,Jackson,female,1670,5069,4978,10047,0.33547609481719565,Texas
4653,2009,Jackson,female,1670,70065,71949,142014,0.023210885488332014,Texas
4654,2009,Jackson,female,1670,334604,357399,692003,0.00467264877629764,Texas
4655,2009,Jackson,female,1670,20838,21418,42256,0.07797179942104772,Texas
4656,2009,Jackson,female,1670,15885,16639,32524,0.10036660857022657,Texas
4657,2009,Jackson,female,1670,12579,12805,25384,0.1304178055447091,Texas
4658,2009,Jackson,female,1670,104458,109809,214267,0.015208225191013487,Texas
4659,2009,Jackson,female,1670,1611,1676,3287,0.9964200477326969,Texas
4660,2009,Jackson,female,1670,5826,5789,11615,0.2884781482121265,Texas
4661,2009,Jackson,female,1670,7226,7594,14820,0.21991045562286016,Texas
4662,2009,Jackson,female,1670,14417,14601,29018,0.11437572768988426,Texas
4663,2009,Jackson,female,1670,10955,9551,20506,0.17485080096324992,Texas
4688,2010,Jackson,female,1585,25536,26558,52094,0.0596806988478048,Texas
4689,2010,Jackson,female,1585,8512,8713,17225,0.18191208538964765,Texas
4690,2010,Jackson,female,1585,631,665,1296,2.3834586466165413,Texas
4691,2010,Jackson,female,1585,26784,21688,48472,0.07308188860199188,Texas
4692,2010,Jackson,female,1585,32445,33310,65755,0.047583308315821075,Texas
4693,2010,Jackson,female,1585,28989,29562,58551,0.053616128814018,Texas
4694,2010,Jackson,female,1585,21822,22116,43938,0.071667570989329,Texas
4695,2010,Jackson,female,1585,9712,9683,19395,0.16368893937829185,Texas
4696,2010,Jackson,female,1585,6642,6676,13318,0.23741761533852607,Texas
4697,2010,Jackson,female,1585,6655,6718,13373,0.2359333134861566,Texas
4698,2010,Jackson,female,1585,8080,7846,15926,0.20201376497578383,Texas
4699,2010,Jackson,female,1585,81205,77708,158913,0.020396870335100632,Texas
4700,2010,Jackson,female,1585,5069,4978,10047,0.31840096424266773,Texas
4701,2010,Jackson,female,1585,70065,71949,142014,0.02202949311317739,Texas
4702,2010,Jackson,female,1585,334604,357399,692003,0.004434819347563927,Texas
4703,2010,Jackson,female,1585,20838,21418,42256,0.07400317489961715,Texas
4704,2010,Jackson,female,1585,15885,16639,32524,0.09525812849329887,Texas
4705,2010,Jackson,female,1585,12579,12805,25384,0.12377977352596642,Texas
4706,2010,Jackson,female,1585,104458,109809,214267,0.014434153848955914,Texas
4707,2010,Jackson,female,1585,1611,1676,3287,0.9457040572792362,Texas
4708,2010,Jackson,female,1585,5826,5789,11615,0.27379512869234757,Texas
4709,2010,Jackson,female,1585,7226,7594,14820,0.20871740848037926,Texas
4710,2010,Jackson,female,1585,14417,14601,29018,0.10855420861584823,Texas
4711,2010,Jackson,female,1585,10955,9551,20506,0.16595120929745577,Texas
4736,2011,Jackson,female,1124,25536,26558,52094,0.04232246404096694,Texas
4737,2011,Jackson,female,1124,8512,8713,17225,0.12900263973373122,Texas
4738,2011,Jackson,female,1124,631,665,1296,1.6902255639097745,Texas
4739,2011,Jackson,female,1124,26784,21688,48472,0.05182589450387311,Texas
4740,2011,Jackson,female,1124,32445,33310,65755,0.03374362053437406,Texas
4741,2011,Jackson,female,1124,28989,29562,58551,0.03802178472363169,Texas
4742,2011,Jackson,female,1124,21822,22116,43938,0.05082293362271659,Texas
4743,2011,Jackson,female,1124,9712,9683,19395,0.116079727357224,Texas
4744,2011,Jackson,female,1124,6642,6676,13318,0.16836428999400838,Texas
4745,2011,Jackson,female,1124,6655,6718,13373,0.1673116999106877,Texas
4746,2011,Jackson,female,1124,8080,7846,15926,0.14325771093550854,Texas
4747,2011,Jackson,female,1124,81205,77708,158913,0.014464405209244866,Texas
4748,2011,Jackson,female,1124,5069,4978,10047,0.22579349136199278,Texas
4749,2011,Jackson,female,1124,70065,71949,142014,0.015622176819691726,Texas
4750,2011,Jackson,female,1124,334604,357399,692003,0.003144944445843441,Texas
4751,2011,Jackson,female,1124,20838,21418,42256,0.0524792230833878,Texas
4752,2011,Jackson,female,1124,15885,16639,32524,0.06755213654666747,Texas
4753,2011,Jackson,female,1124,12579,12805,25384,0.08777821163607966,Texas
4754,2011,Jackson,female,1124,104458,109809,214267,0.01023595515850249,Texas
4755,2011,Jackson,female,1124,1611,1676,3287,0.6706443914081146,Texas
4756,2011,Jackson,female,1124,5826,5789,11615,0.19416134047331146,Texas
4757,2011,Jackson,female,1124,7226,7594,14820,0.14801158809586515,Texas
4758,2011,Jackson,female,1124,14417,14601,29018,0.07698102869666461,Texas
4759,2011,Jackson,female,1124,10955,9551,20506,0.1176840121453251,Texas
4784,2012,Jackson,female,792,25536,26558,52094,0.02982152270502297,Texas
4785,2012,Jackson,female,792,8512,8713,17225,0.09089865717892803,Texas
4786,2012,Jackson,female,792,631,665,1296,1.1909774436090226,Texas
4787,2012,Jackson,female,792,26784,21688,48472,0.036517890077462194,Texas
4788,2012,Jackson,female,792,32445,33310,65755,0.023776643650555387,Texas
4789,2012,Jackson,female,792,28989,29562,58551,0.026791150801704893,Texas
4790,2012,Jackson,female,792,21822,22116,43938,0.03581117742810635,Texas
4791,2012,Jackson,female,792,9712,9683,19395,0.08179283279975215,Texas
4792,2012,Jackson,female,792,6642,6676,13318,0.11863391252246855,Texas
4793,2012,Jackson,female,792,6655,6718,13373,0.11789222983030664,Texas
4794,2012,Jackson,female,792,8080,7846,15926,0.10094315574815192,Texas
4795,2012,Jackson,female,792,81205,77708,158913,0.010192000823596026,Texas
4796,2012,Jackson,female,792,5069,4978,10047,0.1591000401767778,Texas
4797,2012,Jackson,female,792,70065,71949,142014,0.011007797189676021,Texas
4798,2012,Jackson,female,792,334604,357399,692003,0.0022160106771423535,Texas
4799,2012,Jackson,female,792,20838,21418,42256,0.03697824259968251,Texas
4800,2012,Jackson,female,792,15885,16639,32524,0.04759901436384398,Texas
4801,2012,Jackson,female,792,12579,12805,25384,0.06185083951581413,Texas
4802,2012,Jackson,female,792,104458,109809,214267,0.007212523563642324,Texas
4803,2012,Jackson,female,792,1611,1676,3287,0.47255369928400953,Texas
4804,2012,Jackson,female,792,5826,5789,11615,0.13681119364311625,Texas
4805,2012,Jackson,female,792,7226,7594,14820,0.10429286278641033,Texas
4806,2012,Jackson,female,792,14417,14601,29018,0.05424286007807685,Texas
4807,2012,Jackson,female,792,10955,9551,20506,0.08292325410951733,Texas
4832,2013,Jackson,female,877,25536,26558,52094,0.033022064914526694,Texas
4833,2013,Jackson,female,877,8512,8713,17225,0.10065419488121198,Texas
4834,2013,Jackson,female,877,631,665,1296,1.318796992481203,Texas
4835,2013,Jackson,female,877,26784,21688,48472,0.040437108078199925,Texas
4836,2013,Jackson,female,877,32445,33310,65755,0.02632842990093065,Texas
4837,2013,Jackson,female,877,28989,29562,58551,0.029666463703403017,Texas
4838,2013,Jackson,female,877,21822,22116,43938,0.0396545487429915,Texas
4839,2013,Jackson,female,877,9712,9683,19395,0.09057110399669524,Texas
4840,2013,Jackson,female,877,6642,6676,13318,0.13136608747753145,Texas
4841,2013,Jackson,female,877,6655,6718,13373,0.13054480500148855,Texas
4842,2013,Jackson,female,877,8080,7846,15926,0.11177670150395105,Texas
4843,2013,Jackson,female,877,81205,77708,158913,0.011285839295825398,Texas
4844,2013,Jackson,female,877,5069,4978,10047,0.17617517075130573,Texas
4845,2013,Jackson,female,877,70065,71949,142014,0.012189189564830644,Texas
4846,2013,Jackson,female,877,334604,357399,692003,0.002453840105876066,Texas
4847,2013,Jackson,female,877,20838,21418,42256,0.04094686712111308,Texas
4848,2013,Jackson,female,877,15885,16639,32524,0.052707494440771684,Texas
4849,2013,Jackson,female,877,12579,12805,25384,0.06848887153455681,Texas
4850,2013,Jackson,female,877,104458,109809,214267,0.007986594905699897,Texas
4851,2013,Jackson,female,877,1611,1676,3287,0.5232696897374701,Texas
4852,2013,Jackson,female,877,5826,5789,11615,0.15149421316289516,Texas
4853,2013,Jackson,female,877,7226,7594,14820,0.11548590992889123,Texas
4854,2013,Jackson,female,877,14417,14601,29018,0.06006437915211287,Texas
4855,2013,Jackson,female,877,10955,9551,20506,0.09182284577531148,Texas
4880,2014,Jackson,female,526,25536,26558,52094,0.019805708261164245,Texas
4881,2014,Jackson,female,526,8512,8713,17225,0.060369562722368875,Texas
4882,2014,Jackson,female,526,631,665,1296,0.7909774436090226,Texas
4883,2014,Jackson,female,526,26784,21688,48472,0.024253043157506454,Texas
4884,2014,Jackson,female,526,32445,33310,65755,0.015791053737616332,Texas
4885,2014,Jackson,female,526,28989,29562,58551,0.017793112779920166,Texas
4886,2014,Jackson,female,526,21822,22116,43938,0.023783686019171642,Texas
4887,2014,Jackson,female,526,9712,9683,19395,0.05432200764225963,Texas
4888,2014,Jackson,female,526,6642,6676,13318,0.07878969442780108,Texas
4889,2014,Jackson,female,526,6655,6718,13373,0.07829711223578446,Texas
4890,2014,Jackson,female,526,8080,7846,15926,0.06704053020647463,Texas
4891,2014,Jackson,female,526,81205,77708,158913,0.006768929839913522,Texas
4892,2014,Jackson,female,526,5069,4978,10047,0.10566492567296103,Texas
4893,2014,Jackson,female,526,70065,71949,142014,0.007310733992133316,Texas
4894,2014,Jackson,female,526,334604,357399,692003,0.0014717444648697953,Texas
4895,2014,Jackson,female,526,20838,21418,42256,0.024558782332617424,Texas
4896,2014,Jackson,female,526,15885,16639,32524,0.03161247671134083,Texas
4897,2014,Jackson,female,526,12579,12805,25384,0.04107770402186646,Texas
4898,2014,Jackson,female,526,104458,109809,214267,0.004790135599085685,Texas
4899,2014,Jackson,female,526,1611,1676,3287,0.3138424821002387,Texas
4900,2014,Jackson,female,526,5826,5789,11615,0.09086197961651409,Texas
4901,2014,Jackson,female,526,7226,7594,14820,0.06926520937582302,Texas
4902,2014,Jackson,female,526,14417,14601,29018,0.036024929799328816,Texas
4903,2014,Jackson,female,526,10955,9551,20506,0.05507276724950267,Texas
4928,2015,Jackson,female,924,25536,26558,52094,0.03479177648919346,Texas
4929,2015,Jackson,female,924,8512,8713,17225,0.10604843337541604,Texas
4930,2015,Jackson,female,924,631,665,1296,1.3894736842105264,Texas
4931,2015,Jackson,female,924,26784,21688,48472,0.042604205090372556,Texas
4932,2015,Jackson,female,924,32445,33310,65755,0.02773941759231462,Texas
4933,2015,Jackson,female,924,28989,29562,58551,0.03125634260198904,Texas
4934,2015,Jackson,female,924,21822,22116,43938,0.041779706999457406,Texas
4935,2015,Jackson,female,924,9712,9683,19395,0.09542497159971083,Texas
4936,2015,Jackson,female,924,6642,6676,13318,0.1384062312762133,Texas
4937,2015,Jackson,female,924,6655,6718,13373,0.13754093480202442,Texas
4938,2015,Jackson,female,924,8080,7846,15926,0.11776701503951058,Texas
4939,2015,Jackson,female,924,81205,77708,158913,0.011890667627528698,Texas
4940,2015,Jackson,female,924,5069,4978,10047,0.18561671353957412,Texas
4941,2015,Jackson,female,924,70065,71949,142014,0.012842430054622024,Texas
4942,2015,Jackson,female,924,334604,357399,692003,0.0025853457899994124,Texas
4943,2015,Jackson,female,924,20838,21418,42256,0.04314128303296293,Texas
4944,2015,Jackson,female,924,15885,16639,32524,0.05553218342448465,Texas
4945,2015,Jackson,female,924,12579,12805,25384,0.07215931276844982,Texas
4946,2015,Jackson,female,924,104458,109809,214267,0.008414610824249378,Texas
4947,2015,Jackson,female,924,1611,1676,3287,0.5513126491646778,Texas
4948,2015,Jackson,female,924,5826,5789,11615,0.1596130592503023,Texas
4949,2015,Jackson,female,924,7226,7594,14820,0.12167500658414537,Texas
4950,2015,Jackson,female,924,14417,14601,29018,0.06328333675775631,Texas
4951,2015,Jackson,female,924,10955,9551,20506,0.09674379646110355,Texas
4976,2016,Jackson,female,944,25536,26558,52094,0.035544845244370814,Texas
4977,2016,Jackson,female,944,8512,8713,17225,0.10834385401124756,Texas
4978,2016,Jackson,female,944,631,665,1296,1.4195488721804512,Texas
4979,2016,Jackson,female,944,26784,21688,48472,0.04352637403172261,Texas
4980,2016,Jackson,female,944,32445,33310,65755,0.028339837886520565,Texas
4981,2016,Jackson,female,944,28989,29562,58551,0.03193288681415331,Texas
4982,2016,Jackson,female,944,21822,22116,43938,0.04268402966178332,Texas
4983,2016,Jackson,female,944,9712,9683,19395,0.09749044717546215,Texas
4984,2016,Jackson,female,944,6642,6676,13318,0.14140203714799282,Texas
4985,2016,Jackson,female,944,6655,6718,13373,0.14051801131289074,Texas
4986,2016,Jackson,female,944,8080,7846,15926,0.12031608462911038,Texas
4987,2016,Jackson,female,944,81205,77708,158913,0.012148041385700314,Texas
4988,2016,Jackson,female,944,5069,4978,10047,0.189634391321816,Texas
4989,2016,Jackson,female,944,70065,71949,142014,0.013120404731128995,Texas
4990,2016,Jackson,female,944,334604,357399,692003,0.002641305655583815,Texas
4991,2016,Jackson,female,944,20838,21418,42256,0.044075077038005415,Texas
4992,2016,Jackson,female,944,15885,16639,32524,0.056734178736702924,Texas
4993,2016,Jackson,female,944,12579,12805,25384,0.07372120265521281,Texas
4994,2016,Jackson,female,944,104458,109809,214267,0.00859674525767469,Texas
4995,2016,Jackson,female,944,1611,1676,3287,0.5632458233890215,Texas
4996,2016,Jackson,female,944,5826,5789,11615,0.16306788737260322,Texas
4997,2016,Jackson,female,944,7226,7594,14820,0.12430866473531736,Texas
4998,2016,Jackson,female,944,14417,14601,29018,0.06465310595164715,Texas
4999,2016,Jackson,female,944,10955,9551,20506,0.09883781802952571,Texas
5024,2009,Jasper,female,3405,6682,7102,13784,0.4794424105885666,Texas
5025,2009,Jasper,female,3405,4809,4789,9598,0.7110043850490708,Texas
5026,2009,Jasper,female,3405,16699,16750,33449,0.20328358208955224,Texas
5027,2009,Jasper,female,3405,18669,18222,36891,0.18686203490286468,Texas
5028,2009,Jasper,female,3405,8048,8481,16529,0.40148567385921474,Texas
5029,2009,Jasper,female,3405,58223,61015,119238,0.05580594935671556,Texas
5030,2009,Jasper,female,3405,14070,13830,27900,0.24620390455531455,Texas
5031,2009,Jasper,female,3405,17501,18003,35504,0.1891351441426429,Texas
5040,2010,Jasper,female,4977,6682,7102,13784,0.7007885102787947,Texas
5041,2010,Jasper,female,4977,4809,4789,9598,1.0392566297765713,Texas
5042,2010,Jasper,female,4977,16699,16750,33449,0.29713432835820897,Texas
5043,2010,Jasper,female,4977,18669,18222,36891,0.27313137965097134,Texas
5044,2010,Jasper,female,4977,8048,8481,16529,0.5868411743898125,Texas
5045,2010,Jasper,female,4977,58223,61015,119238,0.08157010571171024,Texas
5046,2010,Jasper,female,4977,14070,13830,27900,0.3598698481561822,Texas
5047,2010,Jasper,female,4977,17501,18003,35504,0.27645392434594235,Texas
5056,2011,Jasper,female,5133,6682,7102,13784,0.7227541537595044,Texas
5057,2011,Jasper,female,5133,4809,4789,9598,1.071831280016705,Texas
5058,2011,Jasper,female,5133,16699,16750,33449,0.30644776119402983,Texas
5059,2011,Jasper,female,5133,18669,18222,36891,0.28169245966414225,Texas
5060,2011,Jasper,female,5133,8048,8481,16529,0.6052352316943757,Texas
5061,2011,Jasper,female,5133,58223,61015,119238,0.08412685405228222,Texas
5062,2011,Jasper,female,5133,14070,13830,27900,0.37114967462039045,Texas
5063,2011,Jasper,female,5133,17501,18003,35504,0.2851191468088652,Texas
5072,2012,Jasper,female,6008,6682,7102,13784,0.8459588848211771,Texas
5073,2012,Jasper,female,6008,4809,4789,9598,1.2545416579661726,Texas
5074,2012,Jasper,female,6008,16699,16750,33449,0.3586865671641791,Texas
5075,2012,Jasper,female,6008,18669,18222,36891,0.32971133794314567,Texas
5076,2012,Jasper,female,6008,8048,8481,16529,0.7084070274731753,Texas
5077,2012,Jasper,female,6008,58223,61015,119238,0.09846758993690076,Texas
5078,2012,Jasper,female,6008,14070,13830,27900,0.4344179320318149,Texas
5079,2012,Jasper,female,6008,17501,18003,35504,0.3337221574182081,Texas
5088,2013,Jasper,female,7497,6682,7102,13784,1.0556181357364123,Texas
5089,2013,Jasper,female,7497,4809,4789,9598,1.5654625182710378,Texas
5090,2013,Jasper,female,7497,16699,16750,33449,0.4475820895522388,Texas
5091,2013,Jasper,female,7497,18669,18222,36891,0.41142574909450114,Texas
5092,2013,Jasper,female,7497,8048,8481,16529,0.8839759462327555,Texas
5093,2013,Jasper,female,7497,58223,61015,119238,0.12287142505941162,Texas
5094,2013,Jasper,female,7497,14070,13830,27900,0.5420824295010847,Texas
5095,2013,Jasper,female,7497,17501,18003,35504,0.4164305949008499,Texas
5104,2014,Jasper,female,6405,6682,7102,13784,0.9018586313714446,Texas
5105,2014,Jasper,female,6405,4809,4789,9598,1.3374399665901022,Texas
5106,2014,Jasper,female,6405,16699,16750,33449,0.38238805970149253,Texas
5107,2014,Jasper,female,6405,18669,18222,36891,0.3514981890023049,Texas
5108,2014,Jasper,female,6405,8048,8481,16529,0.7552175451008136,Texas
5109,2014,Jasper,female,6405,58223,61015,119238,0.10497418667540769,Texas
5110,2014,Jasper,female,6405,14070,13830,27900,0.4631236442516269,Texas
5111,2014,Jasper,female,6405,17501,18003,35504,0.35577403766038995,Texas
5120,2015,Jasper,female,5878,6682,7102,13784,0.8276541819205857,Texas
5121,2015,Jasper,female,5878,4809,4789,9598,1.2273961160993945,Texas
5122,2015,Jasper,female,5878,16699,16750,33449,0.35092537313432837,Texas
5123,2015,Jasper,female,5878,18669,18222,36891,0.3225771045988366,Texas
5124,2015,Jasper,female,5878,8048,8481,16529,0.6930786463860393,Texas
5125,2015,Jasper,female,5878,58223,61015,119238,0.09633696631975744,Texas
5126,2015,Jasper,female,5878,14070,13830,27900,0.4250180766449747,Texas
5127,2015,Jasper,female,5878,17501,18003,35504,0.3265011386991057,Texas
5136,2016,Jasper,female,5284,6682,7102,13784,0.7440157702055759,Texas
5137,2016,Jasper,female,5284,4809,4789,9598,1.1033618709542703,Texas
5138,2016,Jasper,female,5284,16699,16750,33449,0.3154626865671642,Texas
5139,2016,Jasper,female,5284,18669,18222,36891,0.2899791460871474,Texas
5140,2016,Jasper,female,5284,8048,8481,16529,0.6230397358802028,Texas
5141,2016,Jasper,female,5284,58223,61015,119238,0.08660165533065639,Texas
5142,2016,Jasper,female,5284,14070,13830,27900,0.38206796818510486,Texas
5143,2016,Jasper,female,5284,17501,18003,35504,0.2935066377825918,Texas
5152,2009,Jeff Davis,female,1111,7408,7583,14991,0.14651193459053144,Texas
5153,2009,Jeff Davis,female,1111,1114,1120,2234,0.9919642857142857,Texas
5156,2010,Jeff Davis,female,915,7408,7583,14991,0.12066464459976263,Texas
5157,2010,Jeff Davis,female,915,1114,1120,2234,0.8169642857142857,Texas
5160,2011,Jeff Davis,female,833,7408,7583,14991,0.10985098246076751,Texas
5161,2011,Jeff Davis,female,833,1114,1120,2234,0.74375,Texas
5164,2012,Jeff Davis,female,387,7408,7583,14991,0.051035210338916,Texas
5165,2012,Jeff Davis,female,387,1114,1120,2234,0.3455357142857143,Texas
5168,2013,Jeff Davis,female,403,7408,7583,14991,0.053145193195305286,Texas
5169,2013,Jeff Davis,female,403,1114,1120,2234,0.35982142857142857,Texas
5172,2014,Jeff Davis,female,464,7408,7583,14991,0.06118950283528946,Texas
5173,2014,Jeff Davis,female,464,1114,1120,2234,0.4142857142857143,Texas
5176,2015,Jeff Davis,female,401,7408,7583,14991,0.05288144533825662,Texas
5177,2015,Jeff Davis,female,401,1114,1120,2234,0.3580357142857143,Texas
5180,2016,Jeff Davis,female,630,7408,7583,14991,0.08308057497032836,Texas
5181,2016,Jeff Davis,female,630,1114,1120,2234,0.5625,Texas
5184,2009,Jefferson,female,4458,312348,347544,659892,0.012827152820937781,Texas
5185,2009,Jefferson,female,4458,34906,35518,70424,0.12551382397657526,Texas
5186,2009,Jefferson,female,4458,283919,286508,570427,0.015559774945202227,Texas
5187,2009,Jefferson,female,4458,7507,6598,14105,0.6756592906941498,Texas
5188,2009,Jefferson,female,4458,7605,8167,15772,0.5458552712134198,Texas
5189,2009,Jefferson,female,4458,14295,13674,27969,0.3260201842913559,Texas
5190,2009,Jefferson,female,4458,19567,18602,38169,0.23965165036017633,Texas
5191,2009,Jefferson,female,4458,15333,16904,32237,0.2637245622337908,Texas
5192,2009,Jefferson,female,4458,9112,8965,18077,0.49726715002788624,Texas
5193,2009,Jefferson,female,4458,9581,9307,18888,0.4789943053615558,Texas
5194,2009,Jefferson,female,4458,370844,396310,767154,0.011248769902349172,Texas
5195,2009,Jefferson,female,4458,211175,224125,435300,0.01989068600111545,Texas
5196,2009,Jefferson,female,4458,3642,3704,7346,1.2035637149028078,Texas
5197,2009,Jefferson,female,4458,110887,112415,223302,0.03965662945336476,Texas
5198,2009,Jefferson,female,4458,5979,5799,11778,0.768753233316089,Texas
5199,2009,Jefferson,female,4458,3486,3702,7188,1.2042139384116695,Texas
5200,2009,Jefferson,female,4458,59931,54517,114448,0.08177265806995983,Texas
5201,2009,Jefferson,female,4458,32489,34397,66886,0.12960432595865917,Texas
5202,2009,Jefferson,female,4458,3104,3119,6223,1.4293042641872395,Texas
5203,2009,Jefferson,female,4458,12010,11133,23143,0.4004311506332525,Texas
5204,2009,Jefferson,female,4458,21887,22197,44084,0.20083795107446953,Texas
5205,2009,Jefferson,female,4458,26099,27148,53247,0.16421099160159128,Texas
5206,2009,Jefferson,female,4458,130660,124550,255210,0.03579285427539141,Texas
5207,2009,Jefferson,female,4458,15354,15502,30856,0.28757579667139727,Texas
5208,2009,Jefferson,female,4458,27743,28436,56179,0.15677310451540302,Texas
5209,2009,Jefferson,female,4458,42343,42309,84652,0.10536765227256611,Texas
5236,2010,Jefferson,female,5914,312348,347544,659892,0.01701655042239256,Texas
5237,2010,Jefferson,female,5914,34906,35518,70424,0.16650712314882596,Texas
5238,2010,Jefferson,female,5914,283919,286508,570427,0.020641657475532968,Texas
5239,2010,Jefferson,female,5914,7507,6598,14105,0.8963322218854198,Texas
5240,2010,Jefferson,female,5914,7605,8167,15772,0.724133708828211,Texas
5241,2010,Jefferson,female,5914,14295,13674,27969,0.4324996343425479,Texas
5242,2010,Jefferson,female,5914,19567,18602,38169,0.31792280399956996,Texas
5243,2010,Jefferson,female,5914,15333,16904,32237,0.34985802176999525,Texas
5244,2010,Jefferson,female,5914,9112,8965,18077,0.6596765197992192,Texas
5245,2010,Jefferson,female,5914,9581,9307,18888,0.6354356935639841,Texas
5246,2010,Jefferson,female,5914,370844,396310,767154,0.014922661552824809,Texas
5247,2010,Jefferson,female,5914,211175,224125,435300,0.02638706079196877,Texas
5248,2010,Jefferson,female,5914,3642,3704,7346,1.5966522678185746,Texas
5249,2010,Jefferson,female,5914,110887,112415,223302,0.052608637637325976,Texas
5250,2010,Jefferson,female,5914,5979,5799,11778,1.0198310053457493,Texas
5251,2010,Jefferson,female,5914,3486,3702,7188,1.5975148568341437,Texas
5252,2010,Jefferson,female,5914,59931,54517,114448,0.10847992369352678,Texas
5253,2010,Jefferson,female,5914,32489,34397,66886,0.17193359886036572,Texas
5254,2010,Jefferson,female,5914,3104,3119,6223,1.8961205514588009,Texas
5255,2010,Jefferson,female,5914,12010,11133,23143,0.5312135093865086,Texas
5256,2010,Jefferson,female,5914,21887,22197,44084,0.2664324007748795,Texas
5257,2010,Jefferson,female,5914,26099,27148,53247,0.21784293502283777,Texas
5258,2010,Jefferson,female,5914,130660,124550,255210,0.047482938578883985,Texas
5259,2010,Jefferson,female,5914,15354,15502,30856,0.38149916139852924,Texas
5260,2010,Jefferson,female,5914,27743,28436,56179,0.20797580531720355,Texas
5261,2010,Jefferson,female,5914,42343,42309,84652,0.1397811340376752,Texas
5288,2011,Jefferson,female,8831,312348,347544,659892,0.025409732292889533,Texas
5289,2011,Jefferson,female,8831,34906,35518,70424,0.24863449518553973,Texas
5290,2011,Jefferson,female,8831,283919,286508,570427,0.030822874055872786,Texas
5291,2011,Jefferson,female,8831,7507,6598,14105,1.3384358896635344,Texas
5292,2011,Jefferson,female,8831,7605,8167,15772,1.081302803967185,Texas
5293,2011,Jefferson,female,8831,14295,13674,27969,0.6458241918970309,Texas
5294,2011,Jefferson,female,8831,19567,18602,38169,0.47473389958069023,Texas
5295,2011,Jefferson,female,8831,15333,16904,32237,0.5224207288215806,Texas
5296,2011,Jefferson,female,8831,9112,8965,18077,0.9850529838259899,Texas
5297,2011,Jefferson,female,8831,9581,9307,18888,0.9488557000107446,Texas
5298,2011,Jefferson,female,8831,370844,396310,767154,0.022283061239938434,Texas
5299,2011,Jefferson,female,8831,211175,224125,435300,0.0394021193530396,Texas
5300,2011,Jefferson,female,8831,3642,3704,7346,2.3841792656587475,Texas
5301,2011,Jefferson,female,8831,110887,112415,223302,0.0785571320553307,Texas
5302,2011,Jefferson,female,8831,5979,5799,11778,1.522848767028798,Texas
5303,2011,Jefferson,female,8831,3486,3702,7188,2.3854673149648837,Texas
5304,2011,Jefferson,female,8831,59931,54517,114448,0.16198616945173067,Texas
5305,2011,Jefferson,female,8831,32489,34397,66886,0.25673750617786434,Texas
5306,2011,Jefferson,female,8831,3104,3119,6223,2.83135620391151,Texas
5307,2011,Jefferson,female,8831,12010,11133,23143,0.7932273421359921,Texas
5308,2011,Jefferson,female,8831,21887,22197,44084,0.3978465558408794,Texas
5309,2011,Jefferson,female,8831,26099,27148,53247,0.32529099749521145,Texas
5310,2011,Jefferson,female,8831,130660,124550,255210,0.07090325170614212,Texas
5311,2011,Jefferson,female,8831,15354,15502,30856,0.5696684298800155,Texas
5312,2011,Jefferson,female,8831,27743,28436,56179,0.3105570403713602,Texas
5313,2011,Jefferson,female,8831,42343,42309,84652,0.20872627573329552,Texas
5340,2012,Jefferson,female,9558,312348,347544,659892,0.02750155376009944,Texas
5341,2012,Jefferson,female,9558,34906,35518,70424,0.2691029900332226,Texas
5342,2012,Jefferson,female,9558,283919,286508,570427,0.03336032501710249,Texas
5343,2012,Jefferson,female,9558,7507,6598,14105,1.4486207941800546,Texas
5344,2012,Jefferson,female,9558,7605,8167,15772,1.1703195787927023,Texas
5345,2012,Jefferson,female,9558,14295,13674,27969,0.6989907854322072,Texas
5346,2012,Jefferson,female,9558,19567,18602,38169,0.5138157187399205,Texas
5347,2012,Jefferson,female,9558,15333,16904,32237,0.5654283009938476,Texas
5348,2012,Jefferson,female,9558,9112,8965,18077,1.0661461238148355,Texas
5349,2012,Jefferson,female,9558,9581,9307,18888,1.026968948103578,Texas
5350,2012,Jefferson,female,9558,370844,396310,767154,0.02411748378794378,Texas
5351,2012,Jefferson,female,9558,211175,224125,435300,0.042645844952593416,Texas
5352,2012,Jefferson,female,9558,3642,3704,7346,2.5804535637149026,Texas
5353,2012,Jefferson,female,9558,110887,112415,223302,0.08502424053729485,Texas
5354,2012,Jefferson,female,9558,5979,5799,11778,1.6482152095188827,Texas
5355,2012,Jefferson,female,9558,3486,3702,7188,2.581847649918963,Texas
5356,2012,Jefferson,female,9558,59931,54517,114448,0.17532145936130014,Texas
5357,2012,Jefferson,female,9558,32489,34397,66886,0.27787307032590053,Texas
5358,2012,Jefferson,female,9558,3104,3119,6223,3.0644437319653735,Texas
5359,2012,Jefferson,female,9558,12010,11133,23143,0.8585286984640259,Texas
5360,2012,Jefferson,female,9558,21887,22197,44084,0.4305987295580484,Texas
5361,2012,Jefferson,female,9558,26099,27148,53247,0.35207013407985854,Texas
5362,2012,Jefferson,female,9558,130660,124550,255210,0.0767402649538338,Texas
5363,2012,Jefferson,female,9558,15354,15502,30856,0.616565604438137,Texas
5364,2012,Jefferson,female,9558,27743,28436,56179,0.3361232240821494,Texas
5365,2012,Jefferson,female,9558,42343,42309,84652,0.22590938098276964,Texas
5392,2013,Jefferson,female,8610,312348,347544,659892,0.024773841585525862,Texas
5393,2013,Jefferson,female,8610,34906,35518,70424,0.24241229798975167,Texas
5394,2013,Jefferson,female,8610,283919,286508,570427,0.03005151688609044,Texas
5395,2013,Jefferson,female,8610,7507,6598,14105,1.3049408911791451,Texas
5396,2013,Jefferson,female,8610,7605,8167,15772,1.0542426839720829,Texas
5397,2013,Jefferson,female,8610,14295,13674,27969,0.6296621325142606,Texas
5398,2013,Jefferson,female,8610,19567,18602,38169,0.462853456617568,Texas
5399,2013,Jefferson,female,8610,15333,16904,32237,0.5093469001419783,Texas
5400,2013,Jefferson,female,8610,9112,8965,18077,0.9604015616285555,Texas
5401,2013,Jefferson,female,8610,9581,9307,18888,0.9251101321585903,Texas
5402,2013,Jefferson,female,8610,370844,396310,767154,0.021725416971562665,Texas
5403,2013,Jefferson,female,8610,211175,224125,435300,0.03841606246514222,Texas
5404,2013,Jefferson,female,8610,3642,3704,7346,2.32451403887689,Texas
5405,2013,Jefferson,female,8610,110887,112415,223302,0.07659120224169372,Texas
5406,2013,Jefferson,female,8610,5979,5799,11778,1.4847387480600103,Texas
5407,2013,Jefferson,female,8610,3486,3702,7188,2.325769854132901,Texas
5408,2013,Jefferson,female,8610,59931,54517,114448,0.15793238806243923,Texas
5409,2013,Jefferson,female,8610,32489,34397,66886,0.2503125272552839,Texas
5410,2013,Jefferson,female,8610,3104,3119,6223,2.760500160307791,Texas
5411,2013,Jefferson,female,8610,12010,11133,23143,0.7733764483966585,Texas
5412,2013,Jefferson,female,8610,21887,22197,44084,0.38789025543992434,Texas
5413,2013,Jefferson,female,8610,26099,27148,53247,0.3171504346544865,Texas
5414,2013,Jefferson,female,8610,130660,124550,255210,0.06912886391007628,Texas
5415,2013,Jefferson,female,8610,15354,15502,30856,0.5554122048767901,Texas
5416,2013,Jefferson,female,8610,27743,28436,56179,0.30278520185680124,Texas
5417,2013,Jefferson,female,8610,42343,42309,84652,0.20350280082252004,Texas
5444,2014,Jefferson,female,5614,312348,347544,659892,0.016153350367147757,Texas
5445,2014,Jefferson,female,5614,34906,35518,70424,0.158060701616082,Texas
5446,2014,Jefferson,female,5614,283919,286508,570427,0.019594566294832954,Texas
5447,2014,Jefferson,female,5614,7507,6598,14105,0.8508638981509549,Texas
5448,2014,Jefferson,female,5614,7605,8167,15772,0.6874005142647239,Texas
5449,2014,Jefferson,female,5614,14295,13674,27969,0.41056018721661547,Texas
5450,2014,Jefferson,female,5614,19567,18602,38169,0.301795505859585,Texas
5451,2014,Jefferson,female,5614,15333,16904,32237,0.3321107430194037,Texas
5452,2014,Jefferson,female,5614,9112,8965,18077,0.6262130507529281,Texas
5453,2014,Jefferson,female,5614,9581,9307,18888,0.6032018910497475,Texas
5454,2014,Jefferson,female,5614,370844,396310,767154,0.01416567838308395,Texas
5455,2014,Jefferson,female,5614,211175,224125,435300,0.02504852203011712,Texas
5456,2014,Jefferson,female,5614,3642,3704,7346,1.5156587473002159,Texas
5457,2014,Jefferson,female,5614,110887,112415,223302,0.049939954632388914,Texas
5458,2014,Jefferson,female,5614,5979,5799,11778,0.9680979479220555,Texas
5459,2014,Jefferson,female,5614,3486,3702,7188,1.5164775796866559,Texas
5460,2014,Jefferson,female,5614,59931,54517,114448,0.1029770530293303,Texas
5461,2014,Jefferson,female,5614,32489,34397,66886,0.1632119080152339,Texas
5462,2014,Jefferson,female,5614,3104,3119,6223,1.7999358768836164,Texas
5463,2014,Jefferson,female,5614,12010,11133,23143,0.5042665948082278,Texas
5464,2014,Jefferson,female,5614,21887,22197,44084,0.2529170608640807,Texas
5465,2014,Jefferson,female,5614,26099,27148,53247,0.20679239722999854,Texas
5466,2014,Jefferson,female,5614,130660,124550,255210,0.04507426736250502,Texas
5467,2014,Jefferson,female,5614,15354,15502,30856,0.3621468197651916,Texas
5468,2014,Jefferson,female,5614,27743,28436,56179,0.19742579828386553,Texas
5469,2014,Jefferson,female,5614,42343,42309,84652,0.13269044411354558,Texas
5496,2015,Jefferson,female,4699,312348,347544,659892,0.013520590198651107,Texas
5497,2015,Jefferson,female,4699,34906,35518,70424,0.1322991159412129,Texas
5498,2015,Jefferson,female,4699,283919,286508,570427,0.01640093819369791,Texas
5499,2015,Jefferson,female,4699,7507,6598,14105,0.7121855107608366,Texas
5500,2015,Jefferson,female,4699,7605,8167,15772,0.5753642708460879,Texas
5501,2015,Jefferson,female,4699,14295,13674,27969,0.3436448734825216,Texas
5502,2015,Jefferson,female,4699,19567,18602,38169,0.2526072465326309,Texas
5503,2015,Jefferson,female,4699,15333,16904,32237,0.2779815428300994,Texas
5504,2015,Jefferson,female,4699,9112,8965,18077,0.5241494701617401,Texas
5505,2015,Jefferson,female,4699,9581,9307,18888,0.5048887933813259,Texas
5506,2015,Jefferson,female,4699,370844,396310,767154,0.011856879715374328,Texas
5507,2015,Jefferson,female,4699,211175,224125,435300,0.020965978806469603,Texas
5508,2015,Jefferson,female,4699,3642,3704,7346,1.2686285097192225,Texas
5509,2015,Jefferson,female,4699,110887,112415,223302,0.041800471467330874,Texas
5510,2015,Jefferson,female,4699,5979,5799,11778,0.8103121227797896,Texas
5511,2015,Jefferson,female,4699,3486,3702,7188,1.269313884386818,Texas
5512,2015,Jefferson,female,4699,59931,54517,114448,0.08619329750353101,Texas
5513,2015,Jefferson,female,4699,32489,34397,66886,0.13661075093758177,Texas
5514,2015,Jefferson,female,4699,3104,3119,6223,1.5065726194293043,Texas
5515,2015,Jefferson,female,4699,12010,11133,23143,0.4220785053444714,Texas
5516,2015,Jefferson,female,4699,21887,22197,44084,0.21169527413614453,Texas
5517,2015,Jefferson,female,4699,26099,27148,53247,0.1730882569618388,Texas
5518,2015,Jefferson,female,4699,130660,124550,255210,0.03772782015254918,Texas
5519,2015,Jefferson,female,4699,15354,15502,30856,0.3031221777835118,Texas
5520,2015,Jefferson,female,4699,27743,28436,56179,0.16524827683218454,Texas
5521,2015,Jefferson,female,4699,42343,42309,84652,0.11106383984495025,Texas
5548,2016,Jefferson,female,5242,312348,347544,659892,0.0150829822986442,Texas
5549,2016,Jefferson,female,5242,34906,35518,70424,0.14758713891547948,Texas
5550,2016,Jefferson,female,5242,283919,286508,570427,0.018296173230764934,Texas
5551,2016,Jefferson,female,5242,7507,6598,14105,0.7944831767202183,Texas
5552,2016,Jefferson,female,5242,7605,8167,15772,0.6418513530059997,Texas
5553,2016,Jefferson,female,5242,14295,13674,27969,0.3833552727804593,Texas
5554,2016,Jefferson,female,5242,19567,18602,38169,0.28179765616600366,Texas
5555,2016,Jefferson,female,5242,15333,16904,32237,0.31010411736867016,Texas
5556,2016,Jefferson,female,5242,9112,8965,18077,0.584718349135527,Texas
5557,2016,Jefferson,female,5242,9581,9307,18888,0.5632319759320942,Texas
5558,2016,Jefferson,female,5242,370844,396310,767154,0.013227019252605283,Texas
5559,2016,Jefferson,female,5242,211175,224125,435300,0.02338873396542108,Texas
5560,2016,Jefferson,female,5242,3642,3704,7346,1.4152267818574513,Texas
5561,2016,Jefferson,female,5242,110887,112415,223302,0.046630787706266955,Texas
5562,2016,Jefferson,female,5242,5979,5799,11778,0.9039489567166753,Texas
5563,2016,Jefferson,female,5242,3486,3702,7188,1.415991356023771,Texas
5564,2016,Jefferson,female,5242,59931,54517,114448,0.09615349340572665,Texas
5565,2016,Jefferson,female,5242,32489,34397,66886,0.1523970113672704,Texas
5566,2016,Jefferson,female,5242,3104,3119,6223,1.680666880410388,Texas
5567,2016,Jefferson,female,5242,12010,11133,23143,0.4708524207311596,Texas
5568,2016,Jefferson,female,5242,21887,22197,44084,0.23615803937469027,Texas
5569,2016,Jefferson,female,5242,26099,27148,53247,0.19308973036687785,Texas
5570,2016,Jefferson,female,5242,130660,124550,255210,0.042087515054195106,Texas
5571,2016,Jefferson,female,5242,15354,15502,30856,0.3381499161398529,Texas
5572,2016,Jefferson,female,5242,27743,28436,56179,0.18434378956252637,Texas
5573,2016,Jefferson,female,5242,42343,42309,84652,0.12389798860762485,Texas
5600,2009,Jim Hogg,female,1286,2550,2732,5282,0.4707174231332357,Texas
5602,2010,Jim Hogg,female,1488,2550,2732,5282,0.5446559297218155,Texas
5604,2011,Jim Hogg,female,1543,2550,2732,5282,0.5647877013177159,Texas
5606,2012,Jim Hogg,female,986,2550,2732,5282,0.3609077598828697,Texas
5608,2013,Jim Hogg,female,583,2550,2732,5282,0.21339677891654465,Texas
5610,2014,Jim Hogg,female,755,2550,2732,5282,0.27635431918008785,Texas
5612,2015,Jim Hogg,female,636,2550,2732,5282,0.232796486090776,Texas
5614,2016,Jim Hogg,female,955,2550,2732,5282,0.34956076134699854,Texas
5616,2009,Jim Wells,female,3824,20178,21014,41192,0.18197392214714,Texas
5618,2010,Jim Wells,female,3163,20178,21014,41192,0.15051870181783572,Texas
5620,2011,Jim Wells,female,4075,20178,21014,41192,0.19391834015418294,Texas
5622,2012,Jim Wells,female,4182,20178,21014,41192,0.19901018368706577,Texas
5624,2013,Jim Wells,female,3254,20178,21014,41192,0.154849148186923,Texas
5626,2014,Jim Wells,female,2886,20178,21014,41192,0.137337013419625,Texas
5628,2015,Jim Wells,female,2340,20178,21014,41192,0.11135433520510137,Texas
5630,2016,Jim Wells,female,3083,20178,21014,41192,0.1467117159988579,Texas
5632,2009,Johnson,female,4416,12976,13315,26291,0.3316560270371761,Texas
5633,2009,Johnson,female,4416,5318,4412,9730,1.0009066183136899,Texas
5634,2009,Johnson,female,4416,7015,5587,12602,0.7904063003400752,Texas
5635,2009,Johnson,female,4416,74349,77215,151564,0.057190960305640096,Texas
5636,2009,Johnson,female,4416,72765,74236,147001,0.05948596368338811,Texas
5637,2009,Johnson,female,4416,286987,298515,585502,0.014793226471031606,Texas
5638,2009,Johnson,female,4416,11200,11643,22843,0.37928368977067767,Texas
5639,2009,Johnson,female,4416,27715,25974,53689,0.17001617001617,Texas
5640,2009,Johnson,female,4416,3097,2100,5197,2.1028571428571428,Texas
5641,2009,Johnson,female,4416,9682,8107,17789,0.5447144443073887,Texas
5642,2009,Johnson,female,4416,81568,81907,163475,0.05391480581635269,Texas
5643,2009,Johnson,female,4416,4477,4038,8515,1.0936106983655274,Texas
5656,2010,Johnson,female,6077,12976,13315,26291,0.4564025535110777,Texas
5657,2010,Johnson,female,6077,5318,4412,9730,1.3773798730734361,Texas
5658,2010,Johnson,female,6077,7015,5587,12602,1.0877035976373726,Texas
5659,2010,Johnson,female,6077,74349,77215,151564,0.07870232467784757,Texas
5660,2010,Johnson,female,6077,72765,74236,147001,0.08186055283151032,Texas
5661,2010,Johnson,female,6077,286987,298515,585502,0.020357435974741638,Texas
5662,2010,Johnson,female,6077,11200,11643,22843,0.5219445160182083,Texas
5663,2010,Johnson,female,6077,27715,25974,53689,0.23396473396473397,Texas
5664,2010,Johnson,female,6077,3097,2100,5197,2.893809523809524,Texas
5665,2010,Johnson,female,6077,9682,8107,17789,0.7495991118786234,Texas
5666,2010,Johnson,female,6077,81568,81907,163475,0.07419390284102702,Texas
5667,2010,Johnson,female,6077,4477,4038,8515,1.504952947003467,Texas
5680,2011,Johnson,female,5491,12976,13315,26291,0.4123920390536988,Texas
5681,2011,Johnson,female,5491,5318,4412,9730,1.2445602901178603,Texas
5682,2011,Johnson,female,5491,7015,5587,12602,0.9828172543404331,Texas
5683,2011,Johnson,female,5491,74349,77215,151564,0.07111312568801399,Texas
5684,2011,Johnson,female,5491,72765,74236,147001,0.0739668085564955,Texas
5685,2011,Johnson,female,5491,286987,298515,585502,0.01839438554176507,Texas
5686,2011,Johnson,female,5491,11200,11643,22843,0.4716138452288929,Texas
5687,2011,Johnson,female,5491,27715,25974,53689,0.2114037114037114,Texas
5688,2011,Johnson,female,5491,3097,2100,5197,2.6147619047619046,Texas
5689,2011,Johnson,female,5491,9682,8107,17789,0.6773158998396448,Texas
5690,2011,Johnson,female,5491,81568,81907,163475,0.06703944717789688,Texas
5691,2011,Johnson,female,5491,4477,4038,8515,1.3598315998018822,Texas
5704,2012,Johnson,female,6519,12976,13315,26291,0.48959819752159217,Texas
5705,2012,Johnson,female,6519,5318,4412,9730,1.4775611967361741,Texas
5706,2012,Johnson,female,6519,7015,5587,12602,1.1668158224449616,Texas
5707,2012,Johnson,female,6519,74349,77215,151564,0.08442660104901897,Texas
5708,2012,Johnson,female,6519,72765,74236,147001,0.08781453742119727,Texas
5709,2012,Johnson,female,6519,286987,298515,585502,0.021838098588010654,Texas
5710,2012,Johnson,female,6519,11200,11643,22843,0.5599072404019583,Texas
5711,2012,Johnson,female,6519,27715,25974,53689,0.25098175098175096,Texas
5712,2012,Johnson,female,6519,3097,2100,5197,3.104285714285714,Texas
5713,2012,Johnson,female,6519,9682,8107,17789,0.8041198963858394,Texas
5714,2012,Johnson,female,6519,81568,81907,163475,0.07959026701014565,Texas
5715,2012,Johnson,female,6519,4477,4038,8515,1.6144130757800892,Texas
5728,2013,Johnson,female,6546,12976,13315,26291,0.49162598573037924,Texas
5729,2013,Johnson,female,6546,5318,4412,9730,1.483680870353581,Texas
5730,2013,Johnson,female,6546,7015,5587,12602,1.1716484696617147,Texas
5731,2013,Johnson,female,6546,74349,77215,151564,0.08477627404001813,Texas
5732,2013,Johnson,female,6546,72765,74236,147001,0.08817824236219624,Texas
5733,2013,Johnson,female,6546,286987,298515,585502,0.02192854630420582,Texas
5734,2013,Johnson,female,6546,11200,11643,22843,0.5622262303530018,Texas
5735,2013,Johnson,female,6546,27715,25974,53689,0.25202125202125203,Texas
5736,2013,Johnson,female,6546,3097,2100,5197,3.117142857142857,Texas
5737,2013,Johnson,female,6546,9682,8107,17789,0.8074503515480449,Texas
5738,2013,Johnson,female,6546,81568,81907,163475,0.0799199091652728,Texas
5739,2013,Johnson,female,6546,4477,4038,8515,1.6210995542347697,Texas
5752,2014,Johnson,female,2979,12976,13315,26291,0.22373263236950808,Texas
5753,2014,Johnson,female,2979,5318,4412,9730,0.6752039891205802,Texas
5754,2014,Johnson,female,2979,7015,5587,12602,0.5332020762484339,Texas
5755,2014,Johnson,female,2979,74349,77215,151564,0.03858058667357379,Texas
5756,2014,Johnson,female,2979,72765,74236,147001,0.040128778490220375,Texas
5757,2014,Johnson,female,2979,286987,298515,585502,0.00997939802019999,Texas
5758,2014,Johnson,female,2979,11200,11643,22843,0.25586189126513786,Texas
5759,2014,Johnson,female,2979,27715,25974,53689,0.1146916146916147,Texas
5760,2014,Johnson,female,2979,3097,2100,5197,1.4185714285714286,Texas
5761,2014,Johnson,female,2979,9682,8107,17789,0.3674602195633403,Texas
5762,2014,Johnson,female,2979,81568,81907,163475,0.03637051778236292,Texas
5763,2014,Johnson,female,2979,4477,4038,8515,0.7377414561664191,Texas
5776,2015,Johnson,female,4447,12976,13315,26291,0.33398422831393165,Texas
5777,2015,Johnson,female,4447,5318,4412,9730,1.007932910244787,Texas
5778,2015,Johnson,female,4447,7015,5587,12602,0.7959548952926436,Texas
5779,2015,Johnson,female,4447,74349,77215,151564,0.057592436702713204,Texas
5780,2015,Johnson,female,4447,72765,74236,147001,0.05990355083786842,Texas
5781,2015,Johnson,female,4447,286987,298515,585502,0.014897073848885316,Texas
5782,2015,Johnson,female,4447,11200,11643,22843,0.3819462337885425,Texas
5783,2015,Johnson,female,4447,27715,25974,53689,0.1712096712096712,Texas
5784,2015,Johnson,female,4447,3097,2100,5197,2.1176190476190477,Texas
5785,2015,Johnson,female,4447,9682,8107,17789,0.5485383002343653,Texas
5786,2015,Johnson,female,4447,81568,81907,163475,0.0542932838463135,Texas
5787,2015,Johnson,female,4447,4477,4038,8515,1.1012877662209015,Texas
5800,2016,Johnson,female,4107,12976,13315,26291,0.30844911753661286,Texas
5801,2016,Johnson,female,4107,5318,4412,9730,0.9308703535811423,Texas
5802,2016,Johnson,female,4107,7015,5587,12602,0.7350993377483444,Texas
5803,2016,Johnson,female,4107,74349,77215,151564,0.053189147186427504,Texas
5804,2016,Johnson,female,4107,72765,74236,147001,0.05532356269195539,Texas
5805,2016,Johnson,female,4107,286987,298515,585502,0.01375810260790915,Texas
5806,2016,Johnson,female,4107,11200,11643,22843,0.35274413810873484,Texas
5807,2016,Johnson,female,4107,27715,25974,53689,0.1581196581196581,Texas
5808,2016,Johnson,female,4107,3097,2100,5197,1.9557142857142857,Texas
5809,2016,Johnson,female,4107,9682,8107,17789,0.5065992352288146,Texas
5810,2016,Johnson,female,4107,81568,81907,163475,0.05014223448545301,Texas
5811,2016,Johnson,female,4107,4477,4038,8515,1.0170876671619613,Texas
5824,2009,Jones,female,896,13874,14674,28548,0.061060378901458365,Texas
5825,2009,Jones,female,896,10585,9983,20568,0.08975257938495443,Texas
5826,2009,Jones,female,896,33352,35102,68454,0.02552561107629195,Texas
5827,2009,Jones,female,896,4828,4867,9695,0.18409697965892746,Texas
5828,2009,Jones,female,896,364,371,735,2.4150943396226414,Texas
5829,2009,Jones,female,896,12507,7384,19891,0.12134344528710726,Texas
5836,2010,Jones,female,982,13874,14674,28548,0.06692108491208941,Texas
5837,2010,Jones,female,982,10585,9983,20568,0.09836722428127817,Texas
5838,2010,Jones,female,982,33352,35102,68454,0.02797561392513247,Texas
5839,2010,Jones,female,982,4828,4867,9695,0.20176700226011918,Texas
5840,2010,Jones,female,982,364,371,735,2.646900269541779,Texas
5841,2010,Jones,female,982,12507,7384,19891,0.1329902491874323,Texas
5848,2011,Jones,female,1292,13874,14674,28548,0.08804688564808505,Texas
5849,2011,Jones,female,1292,10585,9983,20568,0.12942001402384054,Texas
5850,2011,Jones,female,1292,33352,35102,68454,0.03680701954304598,Texas
5851,2011,Jones,female,1292,4828,4867,9695,0.26546126977604273,Texas
5852,2011,Jones,female,1292,364,371,735,3.4824797843665767,Texas
5853,2011,Jones,female,1292,12507,7384,19891,0.17497291440953414,Texas
5860,2012,Jones,female,1912,13874,14674,28548,0.13029848712007633,Texas
5861,2012,Jones,female,1912,10585,9983,20568,0.19152559350896525,Texas
5862,2012,Jones,female,1912,33352,35102,68454,0.054469830778873,Texas
5863,2012,Jones,female,1912,4828,4867,9695,0.3928498048078899,Texas
5864,2012,Jones,female,1912,364,371,735,5.153638814016173,Texas
5865,2012,Jones,female,1912,12507,7384,19891,0.2589382448537378,Texas
5872,2013,Jones,female,1174,13874,14674,28548,0.08000545181954477,Texas
5873,2013,Jones,female,1174,10585,9983,20568,0.1175999198637684,Texas
5874,2013,Jones,female,1174,33352,35102,68454,0.03344538772719503,Texas
5875,2013,Jones,female,1174,4828,4867,9695,0.24121635504417505,Texas
5876,2013,Jones,female,1174,364,371,735,3.164420485175202,Texas
5877,2013,Jones,female,1174,12507,7384,19891,0.15899241603466954,Texas
5884,2014,Jones,female,826,13874,14674,28548,0.05629003679978193,Texas
5885,2014,Jones,female,826,10585,9983,20568,0.08274065912050486,Texas
5886,2014,Jones,female,826,33352,35102,68454,0.02353142271095664,Texas
5887,2014,Jones,female,826,4828,4867,9695,0.16971440312307376,Texas
5888,2014,Jones,female,826,364,371,735,2.2264150943396226,Texas
5889,2014,Jones,female,826,12507,7384,19891,0.111863488624052,Texas
5896,2015,Jones,female,868,13874,14674,28548,0.059152242060787785,Texas
5897,2015,Jones,female,868,10585,9983,20568,0.0869478112791746,Texas
5898,2015,Jones,female,868,33352,35102,68454,0.024727935730157826,Texas
5899,2015,Jones,female,868,4828,4867,9695,0.17834394904458598,Texas
5900,2015,Jones,female,868,364,371,735,2.339622641509434,Texas
5901,2015,Jones,female,868,12507,7384,19891,0.11755146262188516,Texas
5908,2016,Jones,female,1098,13874,14674,28548,0.07482622325201035,Texas
5909,2016,Jones,female,1098,10585,9983,20568,0.10998697786236603,Texas
5910,2016,Jones,female,1098,33352,35102,68454,0.031280268930545266,Texas
5911,2016,Jones,female,1098,4828,4867,9695,0.2256009862338196,Texas
5912,2016,Jones,female,1098,364,371,735,2.9595687331536387,Texas
5913,2016,Jones,female,1098,12507,7384,19891,0.14869989165763814,Texas
5920,2009,Karnes,female,1345,9133,6254,15387,0.2150623600895427,Texas
5922,2010,Karnes,female,1417,9133,6254,15387,0.22657499200511672,Texas
5924,2011,Karnes,female,1284,9133,6254,15387,0.20530860249440358,Texas
5926,2012,Karnes,female,965,9133,6254,15387,0.15430124720179086,Texas
5928,2013,Karnes,female,1106,9133,6254,15387,0.17684681803645666,Texas
5930,2014,Karnes,female,983,9133,6254,15387,0.15717940518068435,Texas
5932,2015,Karnes,female,954,9133,6254,15387,0.15254237288135594,Texas
5934,2016,Karnes,female,1187,9133,6254,15387,0.18979852894147745,Texas
5936,2009,Kaufman,female,5316,58360,60550,118910,0.08779521056977704,Texas
5938,2010,Kaufman,female,6143,58360,60550,118910,0.10145334434351776,Texas
5940,2011,Kaufman,female,7036,58360,60550,118910,0.11620148637489677,Texas
5942,2012,Kaufman,female,6640,58360,60550,118910,0.10966143682906689,Texas
5944,2013,Kaufman,female,5730,58360,60550,118910,0.09463253509496285,Texas
5946,2014,Kaufman,female,3659,58360,60550,118910,0.06042939719240297,Texas
5948,2015,Kaufman,female,2867,58360,60550,118910,0.04734929810074319,Texas
5950,2016,Kaufman,female,4347,58360,60550,118910,0.07179190751445087,Texas
5952,2009,Kendall,female,1397,61761,62865,124626,0.022222222222222223,Texas
5953,2009,Kendall,female,1397,20415,21567,41982,0.06477488755969768,Texas
5956,2010,Kendall,female,1550,61761,62865,124626,0.024656008907977412,Texas
5957,2010,Kendall,female,1550,20415,21567,41982,0.07186905921083137,Texas
5960,2011,Kendall,female,1702,61761,62865,124626,0.027073888491211326,Texas
5961,2011,Kendall,female,1702,20415,21567,41982,0.0789168637269903,Texas
5964,2012,Kendall,female,1535,61761,62865,124626,0.024417402370158277,Texas
5965,2012,Kendall,female,1535,20415,21567,41982,0.07117355218621041,Texas
5968,2013,Kendall,female,1093,61761,62865,124626,0.017386463055754395,Texas
5969,2013,Kendall,female,1093,20415,21567,41982,0.050679278527379794,Texas
5972,2014,Kendall,female,1154,61761,62865,124626,0.018356796309552215,Texas
5973,2014,Kendall,female,1154,20415,21567,41982,0.053507673760838315,Texas
5976,2015,Kendall,female,793,61761,62865,124626,0.012614332299371669,Texas
5977,2015,Kendall,female,793,20415,21567,41982,0.03676913803496082,Texas
5980,2016,Kendall,female,955,61761,62865,124626,0.015191282907818342,Texas
5981,2016,Kendall,female,955,20415,21567,41982,0.044280613900867065,Texas
5984,2009,Kenedy,female,780,286,309,595,2.5242718446601944,Texas
5986,2010,Kenedy,female,658,286,309,595,2.129449838187702,Texas
5988,2011,Kenedy,female,298,286,309,595,0.9644012944983819,Texas
5990,2012,Kenedy,female,265,286,309,595,0.8576051779935275,Texas
5992,2013,Kenedy,female,278,286,309,595,0.8996763754045307,Texas
5994,2014,Kenedy,female,194,286,309,595,0.627831715210356,Texas
5996,2015,Kenedy,female,218,286,309,595,0.7055016181229773,Texas
5998,2016,Kenedy,female,297,286,309,595,0.9611650485436893,Texas
6000,2009,Kent,female,84,84271,90551,174822,0.000927654029221102,Texas
6001,2009,Kent,female,84,9344,10249,19593,0.008195921553322275,Texas
6002,2009,Kent,female,84,316734,326406,643140,0.0002573482105108362,Texas
6003,2009,Kent,female,84,79219,84642,163861,0.000992415113064436,Texas
6004,2009,Kent,female,84,327,422,749,0.1990521327014218,Texas
6010,2010,Kent,female,65,84271,90551,174822,0.000717827522611567,Texas
6011,2010,Kent,female,65,9344,10249,19593,0.006342082154356523,Texas
6012,2010,Kent,female,65,316734,326406,643140,0.00019913849622862326,Texas
6013,2010,Kent,female,65,79219,84642,163861,0.000767940266061766,Texas
6014,2010,Kent,female,65,327,422,749,0.15402843601895735,Texas
6020,2011,Kent,female,62,84271,90551,174822,0.0006846970215679561,Texas
6021,2011,Kent,female,62,9344,10249,19593,0.006049370670309299,Texas
6022,2011,Kent,female,62,316734,326406,643140,0.0001899474887103791,Texas
6023,2011,Kent,female,62,79219,84642,163861,0.0007324968691666076,Texas
6024,2011,Kent,female,62,327,422,749,0.14691943127962084,Texas
6030,2012,Kent,female,131,84271,90551,174822,0.0014466985455710041,Texas
6031,2012,Kent,female,131,9344,10249,19593,0.012781734803395454,Texas
6032,2012,Kent,female,131,316734,326406,643140,0.00040134066162999453,Texas
6033,2012,Kent,female,131,79219,84642,163861,0.0015476949977552515,Texas
6034,2012,Kent,female,131,327,422,749,0.3104265402843602,Texas
6040,2013,Kent,female,45,84271,90551,174822,0.0004969575156541618,Texas
6041,2013,Kent,female,45,9344,10249,19593,0.004390672260708362,Texas
6042,2013,Kent,female,45,316734,326406,643140,0.00013786511277366224,Texas
6043,2013,Kent,female,45,79219,84642,163861,0.0005316509534273765,Texas
6044,2013,Kent,female,45,327,422,749,0.1066350710900474,Texas
6050,2014,Kent,female,19,84271,90551,174822,0.00020982650660953496,Texas
6051,2014,Kent,female,19,9344,10249,19593,0.0018538393989657527,Texas
6052,2014,Kent,female,19,316734,326406,643140,5.820971428221295e-05,Texas
6053,2014,Kent,female,19,79219,84642,163861,0.00022447484700267007,Texas
6054,2014,Kent,female,19,327,422,749,0.045023696682464455,Texas
6060,2015,Kent,female,7,84271,90551,174822,7.730450243509183e-05,Texas
6061,2015,Kent,female,7,9344,10249,19593,0.0006829934627768562,Texas
6062,2015,Kent,female,7,316734,326406,643140,2.144568420923635e-05,Texas
6063,2015,Kent,female,7,79219,84642,163861,8.270125942203634e-05,Texas
6064,2015,Kent,female,7,327,422,749,0.016587677725118485,Texas
6070,2016,Kent,female,19,84271,90551,174822,0.00020982650660953496,Texas
6071,2016,Kent,female,19,9344,10249,19593,0.0018538393989657527,Texas
6072,2016,Kent,female,19,316734,326406,643140,5.820971428221295e-05,Texas
6073,2016,Kent,female,19,79219,84642,163861,0.00022447484700267007,Texas
6074,2016,Kent,female,19,327,422,749,0.045023696682464455,Texas
6080,2009,Kerr,female,2225,24886,26479,51365,0.08402885305336304,Texas
6082,2010,Kerr,female,3142,24886,26479,51365,0.11866007024434458,Texas
6084,2011,Kerr,female,3389,24886,26479,51365,0.1279882170776842,Texas
6086,2012,Kerr,female,3446,24886,26479,51365,0.13014086634691643,Texas
6088,2013,Kerr,female,2649,24886,26479,51365,0.10004154235431852,Texas
6090,2014,Kerr,female,1893,24886,26479,51365,0.07149061520450169,Texas
6092,2015,Kerr,female,2064,24886,26479,51365,0.07794856301219835,Texas
6094,2016,Kerr,female,1520,24886,26479,51365,0.05740398051285925,Texas
6096,2009,Kimble,female,1090,2154,2254,4408,0.4835847382431233,Texas
6098,2010,Kimble,female,215,2154,2254,4408,0.09538598047914817,Texas
6100,2011,Kimble,female,1120,2154,2254,4408,0.4968944099378882,Texas
6102,2012,Kimble,female,1091,2154,2254,4408,0.48402839396628217,Texas
6104,2013,Kimble,female,651,2154,2254,4408,0.2888198757763975,Texas
6106,2014,Kimble,female,792,2154,2254,4408,0.3513753327417924,Texas
6108,2015,Kimble,female,953,2154,2254,4408,0.4228039041703638,Texas
6110,2016,Kimble,female,1925,2154,2254,4408,0.8540372670807453,Texas
6112,2009,King,female,288,118,110,228,2.618181818181818,Texas
6113,2009,King,female,288,1082940,1080317,2163257,0.00026658841802915253,Texas
6116,2010,King,female,197,118,110,228,1.790909090909091,Texas
6117,2010,King,female,197,1082940,1080317,2163257,0.0001823538831657745,Texas
6120,2011,King,female,179,118,110,228,1.6272727272727272,Texas
6121,2011,King,female,179,1082940,1080317,2163257,0.00016569210703895246,Texas
6124,2012,King,female,424,118,110,228,3.8545454545454545,Texas
6125,2012,King,female,424,1082940,1080317,2163257,0.00039247739320958573,Texas
6128,2013,King,female,190,118,110,228,1.7272727272727273,Texas
6129,2013,King,female,190,1082940,1080317,2163257,0.00017587430356089925,Texas
6132,2014,King,female,248,118,110,228,2.2545454545454544,Texas
6133,2014,King,female,248,1082940,1080317,2163257,0.00022956224885843692,Texas
6136,2015,King,female,142,118,110,228,1.290909090909091,Texas
6137,2015,King,female,142,1082940,1080317,2163257,0.0001314429005560405,Texas
6140,2016,King,female,118,118,110,228,1.0727272727272728,Texas
6141,2016,King,female,118,1082940,1080317,2163257,0.00010922719905361112,Texas
6144,2009,Kinney,female,1010,2290,1385,3675,0.7292418772563177,Texas
6146,2010,Kinney,female,868,2290,1385,3675,0.6267148014440433,Texas
6148,2011,Kinney,female,775,2290,1385,3675,0.5595667870036101,Texas
6150,2012,Kinney,female,817,2290,1385,3675,0.5898916967509025,Texas
6152,2013,Kinney,female,871,2290,1385,3675,0.6288808664259928,Texas
6154,2014,Kinney,female,886,2290,1385,3675,0.6397111913357401,Texas
6156,2015,Kinney,female,1639,2290,1385,3675,1.183393501805054,Texas
6158,2016,Kinney,female,1107,2290,1385,3675,0.7992779783393502,Texas
6160,2009,Kleberg,female,2257,16052,15373,31425,0.1468158459637026,Texas
6162,2010,Kleberg,female,2847,16052,15373,31425,0.18519482209067847,Texas
6164,2011,Kleberg,female,3231,16052,15373,31425,0.21017368112925258,Texas
6166,2012,Kleberg,female,2847,16052,15373,31425,0.18519482209067847,Texas
6168,2013,Kleberg,female,2250,16052,15373,31425,0.14636050217914526,Texas
6170,2014,Kleberg,female,1508,16052,15373,31425,0.09809406101606713,Texas
6172,2015,Kleberg,female,1757,16052,15373,31425,0.11429128992389254,Texas
6174,2016,Kleberg,female,2089,16052,15373,31425,0.1358875951343264,Texas
6176,2009,Knox,female,703,25743,25256,50999,0.02783496990814064,Texas
6177,2009,Knox,female,703,18949,18460,37409,0.03808234019501625,Texas
6178,2009,Knox,female,703,15330,16137,31467,0.04356447914730123,Texas
6179,2009,Knox,female,703,19701,20122,39823,0.034936885001490905,Texas
6180,2009,Knox,female,703,1989,1962,3951,0.3583078491335372,Texas
6181,2009,Knox,female,703,4150,4310,8460,0.16310904872389792,Texas
6182,2009,Knox,female,703,29959,31256,61215,0.02249168159713335,Texas
6183,2009,Knox,female,703,221667,234518,456185,0.002997637707979771,Texas
6184,2009,Knox,female,703,1853,1880,3733,0.373936170212766,Texas
6194,2010,Knox,female,785,25743,25256,50999,0.031081723154893888,Texas
6195,2010,Knox,female,785,18949,18460,37409,0.042524377031419286,Texas
6196,2010,Knox,female,785,15330,16137,31467,0.048645968891367665,Texas
6197,2010,Knox,female,785,19701,20122,39823,0.03901202663751118,Texas
6198,2010,Knox,female,785,1989,1962,3951,0.4001019367991845,Texas
6199,2010,Knox,female,785,4150,4310,8460,0.18213457076566125,Texas
6200,2010,Knox,female,785,29959,31256,61215,0.025115177885845916,Texas
6201,2010,Knox,female,785,221667,234518,456185,0.0033472910394937703,Texas
6202,2010,Knox,female,785,1853,1880,3733,0.4175531914893617,Texas
6212,2011,Knox,female,707,25743,25256,50999,0.027993348115299334,Texas
6213,2011,Knox,female,707,18949,18460,37409,0.03829902491874323,Texas
6214,2011,Knox,female,707,15330,16137,31467,0.04381235669579228,Texas
6215,2011,Knox,female,707,19701,20122,39823,0.03513567239836994,Texas
6216,2011,Knox,female,707,1989,1962,3951,0.36034658511722734,Texas
6217,2011,Knox,female,707,4150,4310,8460,0.16403712296983758,Texas
6218,2011,Knox,female,707,29959,31256,61215,0.022619657025851038,Texas
6219,2011,Knox,female,707,221667,234518,456185,0.003014693968053625,Texas
6220,2011,Knox,female,707,1853,1880,3733,0.376063829787234,Texas
6230,2012,Knox,female,377,25743,25256,50999,0.014927146024707,Texas
6231,2012,Knox,female,377,18949,18460,37409,0.020422535211267606,Texas
6232,2012,Knox,female,377,15330,16137,31467,0.02336245894528103,Texas
6233,2012,Knox,female,377,19701,20122,39823,0.018735712155849318,Texas
6234,2012,Knox,female,377,1989,1962,3951,0.19215086646279306,Texas
6235,2012,Knox,female,377,4150,4310,8460,0.08747099767981438,Texas
6236,2012,Knox,female,377,29959,31256,61215,0.012061684156641925,Texas
6237,2012,Knox,female,377,221667,234518,456185,0.0016075525119607023,Texas
6238,2012,Knox,female,377,1853,1880,3733,0.20053191489361702,Texas
6248,2013,Knox,female,531,25743,25256,50999,0.021024707000316757,Texas
6249,2013,Knox,female,531,18949,18460,37409,0.02876489707475623,Texas
6250,2013,Knox,female,531,15330,16137,31467,0.03290574456218628,Texas
6251,2013,Knox,female,531,19701,20122,39823,0.026389026935692277,Texas
6252,2013,Knox,female,531,1989,1962,3951,0.2706422018348624,Texas
6253,2013,Knox,female,531,4150,4310,8460,0.12320185614849188,Texas
6254,2013,Knox,female,531,29959,31256,61215,0.016988738162272844,Texas
6255,2013,Knox,female,531,221667,234518,456185,0.0022642185248040662,Texas
6256,2013,Knox,female,531,1853,1880,3733,0.2824468085106383,Texas
6266,2014,Knox,female,413,25743,25256,50999,0.016352549889135256,Texas
6267,2014,Knox,female,413,18949,18460,37409,0.0223726977248104,Texas
6268,2014,Knox,female,413,15330,16137,31467,0.02559335688170044,Texas
6269,2014,Knox,female,413,19701,20122,39823,0.02052479872776066,Texas
6270,2014,Knox,female,413,1989,1962,3951,0.21049949031600407,Texas
6271,2014,Knox,female,413,4150,4310,8460,0.09582366589327146,Texas
6272,2014,Knox,female,413,29959,31256,61215,0.013213463015101101,Texas
6273,2014,Knox,female,413,221667,234518,456185,0.0017610588526253848,Texas
6274,2014,Knox,female,413,1853,1880,3733,0.21968085106382979,Texas
6284,2015,Knox,female,189,25743,25256,50999,0.007483370288248337,Texas
6285,2015,Knox,female,189,18949,18460,37409,0.010238353196099675,Texas
6286,2015,Knox,female,189,15330,16137,31467,0.011712214166201896,Texas
6287,2015,Knox,female,189,19701,20122,39823,0.00939270450253454,Texas
6288,2015,Knox,female,189,1989,1962,3951,0.0963302752293578,Texas
6289,2015,Knox,female,189,4150,4310,8460,0.043851508120649654,Texas
6290,2015,Knox,female,189,29959,31256,61215,0.0060468390069106735,Texas
6291,2015,Knox,female,189,221667,234518,456185,0.0008059082884895828,Texas
6292,2015,Knox,female,189,1853,1880,3733,0.10053191489361703,Texas
6302,2016,Knox,female,406,25743,25256,50999,0.01607538802660754,Texas
6303,2016,Knox,female,406,18949,18460,37409,0.021993499458288192,Texas
6304,2016,Knox,female,406,15330,16137,31467,0.02515957117184111,Texas
6305,2016,Knox,female,406,19701,20122,39823,0.020176920783222342,Texas
6306,2016,Knox,female,406,1989,1962,3951,0.2069317023445464,Texas
6307,2016,Knox,female,406,4150,4310,8460,0.09419953596287703,Texas
6308,2016,Knox,female,406,29959,31256,61215,0.012989506014845149,Texas
6309,2016,Knox,female,406,221667,234518,456185,0.001731210397496141,Texas
6310,2016,Knox,female,406,1853,1880,3733,0.21595744680851064,Texas
6320,2009,La Salle,female,2373,4408,3001,7409,0.7907364211929356,Texas
6322,2010,La Salle,female,3290,4408,3001,7409,1.0963012329223591,Texas
6324,2011,La Salle,female,2092,4408,3001,7409,0.6971009663445518,Texas
6326,2012,La Salle,female,1274,4408,3001,7409,0.42452515828057313,Texas
6328,2013,La Salle,female,1122,4408,3001,7409,0.37387537487504163,Texas
6330,2014,La Salle,female,958,4408,3001,7409,0.31922692435854716,Texas
6332,2015,La Salle,female,1376,4408,3001,7409,0.45851382872375873,Texas
6334,2016,La Salle,female,2235,4408,3001,7409,0.7447517494168611,Texas
6336,2009,Lamar,female,2092,6800,7133,13933,0.2932847329314454,Texas
6337,2009,Lamar,female,2092,8959,9554,18513,0.2189658781662131,Texas
6338,2009,Lamar,female,2092,29243,31980,61223,0.06541588492808005,Texas
6339,2009,Lamar,female,2092,23917,25615,49532,0.08167089595939879,Texas
6344,2010,Lamar,female,1642,6800,7133,13933,0.23019767278844805,Texas
6345,2010,Lamar,female,1642,8959,9554,18513,0.17186518735608122,Texas
6346,2010,Lamar,female,1642,29243,31980,61223,0.05134459036898061,Texas
6347,2010,Lamar,female,1642,23917,25615,49532,0.06410306461057974,Texas
6352,2011,Lamar,female,2634,6800,7133,13933,0.3692695920370111,Texas
6353,2011,Lamar,female,2634,8959,9554,18513,0.27569604354197197,Texas
6354,2011,Lamar,female,2634,29243,31980,61223,0.0823639774859287,Texas
6355,2011,Lamar,female,2634,23917,25615,49532,0.10283037282842085,Texas
6360,2012,Lamar,female,2613,6800,7133,13933,0.36632552923033784,Texas
6361,2012,Lamar,female,2613,8959,9554,18513,0.2734980113041658,Texas
6362,2012,Lamar,female,2613,29243,31980,61223,0.08170731707317073,Texas
6363,2012,Lamar,female,2613,23917,25615,49532,0.10201054069880928,Texas
6368,2013,Lamar,female,3332,6800,7133,13933,0.46712463199214915,Texas
6369,2013,Lamar,female,3332,8959,9554,18513,0.3487544483985765,Texas
6370,2013,Lamar,female,3332,29243,31980,61223,0.10419011882426517,Texas
6371,2013,Lamar,female,3332,23917,25615,49532,0.13008003123170017,Texas
6376,2014,Lamar,female,2520,6800,7133,13933,0.35328753680078506,Texas
6377,2014,Lamar,female,2520,8959,9554,18513,0.26376386853673855,Texas
6378,2014,Lamar,female,2520,29243,31980,61223,0.07879924953095685,Texas
6379,2014,Lamar,female,2520,23917,25615,49532,0.09837985555338669,Texas
6384,2015,Lamar,female,2076,6800,7133,13933,0.29104163745969436,Texas
6385,2015,Lamar,female,2076,8959,9554,18513,0.21729118693740843,Texas
6386,2015,Lamar,female,2076,29243,31980,61223,0.06491557223264541,Texas
6387,2015,Lamar,female,2076,23917,25615,49532,0.08104626195588523,Texas
6392,2016,Lamar,female,1994,6800,7133,13933,0.27954577316697043,Texas
6393,2016,Lamar,female,1994,8959,9554,18513,0.2087083943897844,Texas
6394,2016,Lamar,female,1994,29243,31980,61223,0.06235146966854284,Texas
6395,2016,Lamar,female,1994,23917,25615,49532,0.07784501268787819,Texas
6400,2009,Lamb,female,1822,6710,6552,13262,0.2780830280830281,Texas
6402,2010,Lamb,female,2700,6710,6552,13262,0.41208791208791207,Texas
6404,2011,Lamb,female,2263,6710,6552,13262,0.3453907203907204,Texas
6406,2012,Lamb,female,2192,6710,6552,13262,0.33455433455433453,Texas
6408,2013,Lamb,female,1607,6710,6552,13262,0.24526862026862026,Texas
6410,2014,Lamb,female,1132,6710,6552,13262,0.17277167277167277,Texas
6412,2015,Lamb,female,1254,6710,6552,13262,0.19139194139194138,Texas
6414,2016,Lamb,female,1242,6710,6552,13262,0.18956043956043955,Texas
6416,2009,Lampasas,female,1875,10187,10453,20640,0.17937434229407825,Texas
6418,2010,Lampasas,female,2045,10187,10453,20640,0.19563761599540802,Texas
6420,2011,Lampasas,female,2260,10187,10453,20640,0.21620587391179566,Texas
6422,2012,Lampasas,female,2046,10187,10453,20640,0.1957332823112982,Texas
6424,2013,Lampasas,female,1785,10187,10453,20640,0.1707643738639625,Texas
6426,2014,Lampasas,female,1299,10187,10453,20640,0.12427054434133741,Texas
6428,2015,Lampasas,female,1339,10187,10453,20640,0.1280971969769444,Texas
6430,2016,Lampasas,female,1176,10187,10453,20640,0.11250358748684589,Texas
6432,2009,Lavaca,female,1932,9684,10257,19941,0.1883591693477625,Texas
6434,2010,Lavaca,female,1362,9684,10257,19941,0.13278736472652822,Texas
6436,2011,Lavaca,female,1281,9684,10257,19941,0.12489031880666862,Texas
6438,2012,Lavaca,female,1170,9684,10257,19941,0.11406844106463879,Texas
6440,2013,Lavaca,female,997,9684,10257,19941,0.09720191089012382,Texas
6442,2014,Lavaca,female,862,9684,10257,19941,0.0840401676903578,Texas
6444,2015,Lavaca,female,580,9684,10257,19941,0.05654674856195769,Texas
6446,2016,Lavaca,female,500,9684,10257,19941,0.04874719703617042,Texas
6448,2009,Lee,female,1628,78372,80915,159287,0.020119878885249954,Texas
6449,2009,Lee,female,1628,5309,4089,9398,0.39814135485448765,Texas
6450,2009,Lee,female,1628,351918,366761,718679,0.004438858002895619,Texas
6451,2009,Lee,female,1628,14674,14674,29348,0.11094452773613193,Texas
6452,2009,Lee,female,1628,18326,16201,34527,0.10048762422072711,Texas
6453,2009,Lee,female,1628,17371,17170,34541,0.09481654047757716,Texas
6454,2009,Lee,female,1628,3501,3250,6751,0.5009230769230769,Texas
6455,2009,Lee,female,1628,40526,44389,84915,0.036675753001869836,Texas
6456,2009,Lee,female,1628,29225,30900,60125,0.05268608414239482,Texas
6457,2009,Lee,female,1628,9164,8442,17606,0.19284529732290925,Texas
6458,2009,Lee,female,1628,8558,8394,16952,0.19394805813676436,Texas
6459,2009,Lee,female,1628,12608,11526,24134,0.14124587888252646,Texas
6472,2010,Lee,female,2005,78372,80915,159287,0.024779089167645058,Texas
6473,2010,Lee,female,2005,5309,4089,9398,0.49033993641477136,Texas
6474,2010,Lee,female,2005,351918,366761,718679,0.005466775365974026,Texas
6475,2010,Lee,female,2005,14674,14674,29348,0.13663622734087502,Texas
6476,2010,Lee,female,2005,18326,16201,34527,0.1237577927288439,Texas
6477,2010,Lee,female,2005,17371,17170,34541,0.11677344205008736,Texas
6478,2010,Lee,female,2005,3501,3250,6751,0.6169230769230769,Texas
6479,2010,Lee,female,2005,40526,44389,84915,0.04516884813805222,Texas
6480,2010,Lee,female,2005,29225,30900,60125,0.06488673139158577,Texas
6481,2010,Lee,female,2005,9164,8442,17606,0.2375029613835584,Texas
6482,2010,Lee,female,2005,8558,8394,16952,0.2388610912556588,Texas
6483,2010,Lee,female,2005,12608,11526,24134,0.17395453756723928,Texas
6496,2011,Lee,female,1805,78372,80915,159287,0.02230735957486251,Texas
6497,2011,Lee,female,1805,5309,4089,9398,0.4414282220591832,Texas
6498,2011,Lee,female,1805,351918,366761,718679,0.004921461115004049,Texas
6499,2011,Lee,female,1805,14674,14674,29348,0.12300667847894235,Texas
6500,2011,Lee,female,1805,18326,16201,34527,0.11141287574841059,Texas
6501,2011,Lee,female,1805,17371,17170,34541,0.10512521840419337,Texas
6502,2011,Lee,female,1805,3501,3250,6751,0.5553846153846154,Texas
6503,2011,Lee,female,1805,40526,44389,84915,0.04066322737615175,Texas
6504,2011,Lee,female,1805,29225,30900,60125,0.05841423948220065,Texas
6505,2011,Lee,female,1805,9164,8442,17606,0.21381189291637054,Texas
6506,2011,Lee,female,1805,8558,8394,16952,0.21503454848701453,Texas
6507,2011,Lee,female,1805,12608,11526,24134,0.15660246399444733,Texas
6520,2012,Lee,female,1882,78372,80915,159287,0.02325897546808379,Texas
6521,2012,Lee,female,1882,5309,4089,9398,0.4602592320860846,Texas
6522,2012,Lee,female,1882,351918,366761,718679,0.00513140710162749,Texas
6523,2012,Lee,female,1882,14674,14674,29348,0.12825405479078641,Texas
6524,2012,Lee,female,1882,18326,16201,34527,0.11616566878587742,Texas
6525,2012,Lee,female,1882,17371,17170,34541,0.10960978450786255,Texas
6526,2012,Lee,female,1882,3501,3250,6751,0.579076923076923,Texas
6527,2012,Lee,female,1882,40526,44389,84915,0.04239789136948343,Texas
6528,2012,Lee,female,1882,29225,30900,60125,0.060906148867313915,Texas
6529,2012,Lee,female,1882,9164,8442,17606,0.22293295427623785,Texas
6530,2012,Lee,female,1882,8558,8394,16952,0.22420776745294257,Texas
6531,2012,Lee,female,1882,12608,11526,24134,0.16328301231997225,Texas
6544,2013,Lee,female,2311,78372,80915,159287,0.02856083544460236,Texas
6545,2013,Lee,female,2311,5309,4089,9398,0.5651748593788213,Texas
6546,2013,Lee,female,2311,351918,366761,718679,0.006301106169958093,Texas
6547,2013,Lee,female,2311,14674,14674,29348,0.157489437099632,Texas
6548,2013,Lee,female,2311,18326,16201,34527,0.14264551570890685,Texas
6549,2013,Lee,female,2311,17371,17170,34541,0.1345952242283052,Texas
6550,2013,Lee,female,2311,3501,3250,6751,0.711076923076923,Texas
6551,2013,Lee,female,2311,40526,44389,84915,0.05206244790375994,Texas
6552,2013,Lee,female,2311,29225,30900,60125,0.07478964401294498,Texas
6553,2013,Lee,female,2311,9164,8442,17606,0.27375029613835583,Texas
6554,2013,Lee,female,2311,8558,8394,16952,0.2753157016916845,Texas
6555,2013,Lee,female,2311,12608,11526,24134,0.20050321013361097,Texas
6568,2014,Lee,female,1986,78372,80915,159287,0.024544274856330716,Texas
6569,2014,Lee,female,1986,5309,4089,9398,0.4856933235509905,Texas
6570,2014,Lee,female,1986,351918,366761,718679,0.005414970512131878,Texas
6571,2014,Lee,female,1986,14674,14674,29348,0.13534142019899142,Texas
6572,2014,Lee,female,1986,18326,16201,34527,0.12258502561570274,Texas
6573,2014,Lee,female,1986,17371,17170,34541,0.11566686080372743,Texas
6574,2014,Lee,female,1986,3501,3250,6751,0.6110769230769231,Texas
6575,2014,Lee,female,1986,40526,44389,84915,0.044740814165671675,Texas
6576,2014,Lee,female,1986,29225,30900,60125,0.06427184466019417,Texas
6577,2014,Lee,female,1986,9164,8442,17606,0.23525230987917556,Texas
6578,2014,Lee,female,1986,8558,8394,16952,0.2365975696926376,Texas
6579,2014,Lee,female,1986,12608,11526,24134,0.17230609057782406,Texas
6592,2015,Lee,female,1223,78372,80915,159287,0.01511462645986529,Texas
6593,2015,Lee,female,1223,5309,4089,9398,0.2990951332844216,Texas
6594,2015,Lee,female,1223,351918,366761,718679,0.0033345966446814137,Texas
6595,2015,Lee,female,1223,14674,14674,29348,0.08334469129071828,Texas
6596,2015,Lee,female,1223,18326,16201,34527,0.07548916733534967,Texas
6597,2015,Lee,female,1223,17371,17170,34541,0.07122888759464181,Texas
6598,2015,Lee,female,1223,3501,3250,6751,0.3763076923076923,Texas
6599,2015,Lee,female,1223,40526,44389,84915,0.02755187095902138,Texas
6600,2015,Lee,female,1223,29225,30900,60125,0.03957928802588997,Texas
6601,2015,Lee,female,1223,9164,8442,17606,0.14487088367685383,Texas
6602,2015,Lee,female,1223,8558,8394,16952,0.1456993090302597,Texas
6603,2015,Lee,female,1223,12608,11526,24134,0.10610792989762277,Texas
6616,2016,Lee,female,1332,78372,80915,159287,0.01646171908793178,Texas
6617,2016,Lee,female,1332,5309,4089,9398,0.32575201760821715,Texas
6618,2016,Lee,female,1332,351918,366761,718679,0.0036317929114600515,Texas
6619,2016,Lee,female,1332,14674,14674,29348,0.09077279542047158,Texas
6620,2016,Lee,female,1332,18326,16201,34527,0.08221714708968582,Texas
6621,2016,Lee,female,1332,17371,17170,34541,0.07757716948165405,Texas
6622,2016,Lee,female,1332,3501,3250,6751,0.40984615384615386,Texas
6623,2016,Lee,female,1332,40526,44389,84915,0.030007434274257137,Texas
6624,2016,Lee,female,1332,29225,30900,60125,0.04310679611650486,Texas
6625,2016,Lee,female,1332,9164,8442,17606,0.15778251599147122,Texas
6626,2016,Lee,female,1332,8558,8394,16952,0.15868477483917084,Texas
6627,2016,Lee,female,1332,12608,11526,24134,0.11556480999479438,Texas
6640,2009,Leon,female,1917,136894,151208,288102,0.012677900640177769,Texas
6641,2009,Leon,female,1917,8602,8496,17098,0.225635593220339,Texas
6644,2010,Leon,female,2718,136894,151208,288102,0.01797523940532247,Texas
6645,2010,Leon,female,2718,8602,8496,17098,0.3199152542372881,Texas
6648,2011,Leon,female,2831,136894,151208,288102,0.018722554362203058,Texas
6649,2011,Leon,female,2831,8602,8496,17098,0.3332156308851224,Texas
6652,2012,Leon,female,3007,136894,151208,288102,0.01988651394106132,Texas
6653,2012,Leon,female,3007,8602,8496,17098,0.3539312617702448,Texas
6656,2013,Leon,female,2938,136894,151208,288102,0.019430188878895298,Texas
6657,2013,Leon,female,2938,8602,8496,17098,0.3458097928436911,Texas
6660,2014,Leon,female,2463,136894,151208,288102,0.016288820697317602,Texas
6661,2014,Leon,female,2463,8602,8496,17098,0.2899011299435028,Texas
6664,2015,Leon,female,1901,136894,151208,288102,0.012572086133008836,Texas
6665,2015,Leon,female,1901,8602,8496,17098,0.2237523540489642,Texas
6668,2016,Leon,female,1878,136894,151208,288102,0.012419977778953494,Texas
6669,2016,Leon,female,1878,8602,8496,17098,0.221045197740113,Texas
6672,2009,Liberty,female,3704,5110,3255,8365,1.137941628264209,Texas
6673,2009,Liberty,female,3704,31550,30558,62108,0.12121212121212122,Texas
6674,2009,Liberty,female,3704,1146,1134,2280,3.2663139329805997,Texas
6675,2009,Liberty,female,3704,40439,41423,81862,0.08941892185500809,Texas
6680,2010,Liberty,female,5013,5110,3255,8365,1.5400921658986175,Texas
6681,2010,Liberty,female,5013,31550,30558,62108,0.16404869428627528,Texas
6682,2010,Liberty,female,5013,1146,1134,2280,4.420634920634921,Texas
6683,2010,Liberty,female,5013,40439,41423,81862,0.12101972334210463,Texas
6688,2011,Liberty,female,5256,5110,3255,8365,1.6147465437788018,Texas
6689,2011,Liberty,female,5256,31550,30558,62108,0.17200078539171412,Texas
6690,2011,Liberty,female,5256,1146,1134,2280,4.634920634920635,Texas
6691,2011,Liberty,female,5256,40439,41423,81862,0.12688602950051903,Texas
6696,2012,Liberty,female,4863,5110,3255,8365,1.4940092165898617,Texas
6697,2012,Liberty,female,4863,31550,30558,62108,0.15913999607304144,Texas
6698,2012,Liberty,female,4863,1146,1134,2280,4.288359788359788,Texas
6699,2012,Liberty,female,4863,40439,41423,81862,0.11739854670110808,Texas
6704,2013,Liberty,female,3834,5110,3255,8365,1.1778801843317972,Texas
6705,2013,Liberty,female,3834,31550,30558,62108,0.12546632633025723,Texas
6706,2013,Liberty,female,3834,1146,1134,2280,3.380952380952381,Texas
6707,2013,Liberty,female,3834,40439,41423,81862,0.09255727494387177,Texas
6712,2014,Liberty,female,3098,5110,3255,8365,0.9517665130568357,Texas
6713,2014,Liberty,female,3098,31550,30558,62108,0.10138098043065645,Texas
6714,2014,Liberty,female,3098,1146,1134,2280,2.7319223985890653,Texas
6715,2014,Liberty,female,3098,40439,41423,81862,0.07478936822538203,Texas
6720,2015,Liberty,female,2857,5110,3255,8365,0.8777265745007681,Texas
6721,2015,Liberty,female,2857,31550,30558,62108,0.0934943386347274,Texas
6722,2015,Liberty,female,2857,1146,1134,2280,2.519400352733686,Texas
6723,2015,Liberty,female,2857,40439,41423,81862,0.06897134442218092,Texas
6728,2016,Liberty,female,2630,5110,3255,8365,0.8079877112135176,Texas
6729,2016,Liberty,female,2630,31550,30558,62108,0.08606584200536685,Texas
6730,2016,Liberty,female,2630,1146,1134,2280,2.3192239858906527,Texas
6731,2016,Liberty,female,2630,40439,41423,81862,0.0634912971054728,Texas
6736,2009,Limestone,female,2580,46427,46625,93052,0.055335120643431636,Texas
6737,2009,Limestone,female,2580,12056,11459,23515,0.2251505366960468,Texas
6740,2010,Limestone,female,2720,46427,46625,93052,0.05833780160857909,Texas
6741,2010,Limestone,female,2720,12056,11459,23515,0.23736800767955318,Texas
6744,2011,Limestone,female,2493,46427,46625,93052,0.05346916890080429,Texas
6745,2011,Limestone,female,2493,12056,11459,23515,0.21755825115629637,Texas
6748,2012,Limestone,female,1740,46427,46625,93052,0.037319034852546916,Texas
6749,2012,Limestone,female,1740,12056,11459,23515,0.1518457107950083,Texas
6752,2013,Limestone,female,1565,46427,46625,93052,0.0335656836461126,Texas
6753,2013,Limestone,female,1565,12056,11459,23515,0.13657387206562527,Texas
6756,2014,Limestone,female,1458,46427,46625,93052,0.031270777479892764,Texas
6757,2014,Limestone,female,1458,12056,11459,23515,0.12723623352823107,Texas
6760,2015,Limestone,female,1350,46427,46625,93052,0.028954423592493297,Texas
6761,2015,Limestone,female,1350,12056,11459,23515,0.1178113273409547,Texas
6764,2016,Limestone,female,1360,46427,46625,93052,0.029168900804289546,Texas
6765,2016,Limestone,female,1360,12056,11459,23515,0.11868400383977659,Texas
6768,2009,Lipscomb,female,53,1840,1629,3469,0.032535297728667895,Texas
6770,2010,Lipscomb,female,55,1840,1629,3469,0.03376304481276857,Texas
6772,2011,Lipscomb,female,65,1840,1629,3469,0.03990178023327195,Texas
6774,2012,Lipscomb,female,56,1840,1629,3469,0.03437691835481891,Texas
6776,2013,Lipscomb,female,69,1840,1629,3469,0.0423572744014733,Texas
6778,2014,Lipscomb,female,28,1840,1629,3469,0.017188459177409455,Texas
6780,2015,Lipscomb,female,34,1840,1629,3469,0.020871700429711478,Texas
6782,2016,Lipscomb,female,19,1840,1629,3469,0.011663597298956415,Texas
6784,2009,Live Oak,female,4014,6634,5489,12123,0.7312807433047914,Texas
6786,2010,Live Oak,female,3846,6634,5489,12123,0.7006740754235744,Texas
6788,2011,Live Oak,female,3338,6634,5489,12123,0.6081253415922755,Texas
6790,2012,Live Oak,female,2498,6634,5489,12123,0.45509200218619056,Texas
6792,2013,Live Oak,female,2403,6634,5489,12123,0.43778466022955,Texas
6794,2014,Live Oak,female,2958,6634,5489,12123,0.5388959737657133,Texas
6796,2015,Live Oak,female,1844,6634,5489,12123,0.33594461650573876,Texas
6798,2016,Live Oak,female,2581,6634,5489,12123,0.470213153579887,Texas
6800,2009,Llano,female,1301,10138,10502,20640,0.12388116549228718,Texas
6802,2010,Llano,female,1296,10138,10502,20640,0.1234050657017711,Texas
6804,2011,Llano,female,852,10138,10502,20640,0.08112740430394211,Texas
6806,2012,Llano,female,956,10138,10502,20640,0.09103027994667683,Texas
6808,2013,Llano,female,1180,10138,10502,20640,0.11235955056179775,Texas
6810,2014,Llano,female,1169,10138,10502,20640,0.11131213102266235,Texas
6812,2015,Llano,female,1763,10138,10502,20640,0.1678727861359741,Texas
6814,2016,Llano,female,1241,10138,10502,20640,0.11816796800609408,Texas
6816,2009,Loving,female,1,58,44,102,0.022727272727272728,Texas
6820,2012,Loving,female,2,58,44,102,0.045454545454545456,Texas
6823,2014,Loving,female,5,58,44,102,0.11363636363636363,Texas
6825,2015,Loving,female,2,58,44,102,0.045454545454545456,Texas
6827,2016,Loving,female,1,58,44,102,0.022727272727272728,Texas
6829,2009,Lubbock,female,5664,148631,152823,301454,0.0370624840501757,Texas
6831,2010,Lubbock,female,6899,148631,152823,301454,0.045143728365494726,Texas
6833,2011,Lubbock,female,7146,148631,152823,301454,0.04675997722855853,Texas
6835,2012,Lubbock,female,6830,148631,152823,301454,0.044692225646663135,Texas
6837,2013,Lubbock,female,3981,148631,152823,301454,0.026049743821283444,Texas
6839,2014,Lubbock,female,3810,148631,152823,301454,0.02493080230070081,Texas
6841,2015,Lubbock,female,3483,148631,152823,301454,0.02279107202449893,Texas
6843,2016,Lubbock,female,3902,148631,152823,301454,0.025532805925809598,Texas
6845,2009,Lynn,female,1460,2977,2831,5808,0.5157188272695161,Texas
6847,2010,Lynn,female,824,2977,2831,5808,0.2910632285411515,Texas
6849,2011,Lynn,female,1210,2977,2831,5808,0.4274108089014482,Texas
6851,2012,Lynn,female,1109,2977,2831,5808,0.39173436948074886,Texas
6853,2013,Lynn,female,886,2977,2831,5808,0.31296361709643233,Texas
6855,2014,Lynn,female,331,2977,2831,5808,0.1169198163193218,Texas
6857,2015,Lynn,female,417,2977,2831,5808,0.1472977746379371,Texas
6859,2016,Lynn,female,197,2977,2831,5808,0.06958671847403744,Texas
6861,2009,Madison,female,1940,174665,182895,357560,0.010607178982476284,Texas
6862,2009,Madison,female,1940,8038,8038,16076,0.2413535705399353,Texas
6863,2009,Madison,female,1940,9829,8645,18474,0.22440717177559283,Texas
6864,2009,Madison,female,1940,14508,14392,28900,0.1347971095052807,Texas
6865,2009,Madison,female,1940,19529,19176,38705,0.10116812682519817,Texas
6866,2009,Madison,female,1940,129718,135952,265670,0.014269742261974815,Texas
6867,2009,Madison,female,1940,64707,64798,129505,0.02993919565418686,Texas
6868,2009,Madison,female,1940,8028,7862,15890,0.246756550496057,Texas
6869,2009,Madison,female,1940,43737,45963,89700,0.04220786284620238,Texas
6870,2009,Madison,female,1940,5708,5764,11472,0.33657182512144346,Texas
6871,2009,Madison,female,1940,49524,53974,103498,0.03594323192648312,Texas
6872,2009,Madison,female,1940,6049,6156,12205,0.31513970110461337,Texas
6873,2009,Madison,female,1940,4261,3957,8218,0.49027040687389434,Texas
6874,2009,Madison,female,1940,17490,17674,35164,0.10976575761004866,Texas
6875,2009,Madison,female,1940,35252,36107,71359,0.053729193785138615,Texas
6876,2009,Madison,female,1940,10502,10903,21405,0.17793267907915253,Texas
6877,2009,Madison,female,1940,24041,19947,43988,0.09725773299242994,Texas
6878,2009,Madison,female,1940,46137,51545,97682,0.037637016199437386,Texas
6879,2009,Madison,female,1940,8127,6001,14128,0.32327945342442926,Texas
6880,2009,Madison,female,1940,6350,6789,13139,0.2857563705994992,Texas
6901,2010,Madison,female,1947,174665,182895,357560,0.010645452308701715,Texas
6902,2010,Madison,female,1947,8038,8038,16076,0.24222443393879076,Texas
6903,2010,Madison,female,1947,9829,8645,18474,0.22521688837478313,Texas
6904,2010,Madison,female,1947,14508,14392,28900,0.1352834908282379,Texas
6905,2010,Madison,female,1947,19529,19176,38705,0.10153316645807259,Texas
6906,2010,Madison,female,1947,129718,135952,265670,0.014321231022713899,Texas
6907,2010,Madison,female,1947,64707,64798,129505,0.0300472236797432,Texas
6908,2010,Madison,female,1947,8028,7862,15890,0.2476469091834139,Texas
6909,2010,Madison,female,1947,43737,45963,89700,0.042360159258534036,Texas
6910,2010,Madison,female,1947,5708,5764,11472,0.3377862595419847,Texas
6911,2010,Madison,female,1947,49524,53974,103498,0.03607292400044466,Texas
6912,2010,Madison,female,1947,6049,6156,12205,0.3162768031189084,Texas
6913,2010,Madison,female,1947,4261,3957,8218,0.4920394238059136,Texas
6914,2010,Madison,female,1947,17490,17674,35164,0.11016181962204367,Texas
6915,2010,Madison,female,1947,35252,36107,71359,0.05392306201013654,Texas
6916,2010,Madison,female,1947,10502,10903,21405,0.1785747042098505,Texas
6917,2010,Madison,female,1947,24041,19947,43988,0.09760866295683561,Texas
6918,2010,Madison,female,1947,46137,51545,97682,0.037772819866136384,Texas
6919,2010,Madison,female,1947,8127,6001,14128,0.3244459256790535,Texas
6920,2010,Madison,female,1947,6350,6789,13139,0.28678745028722935,Texas
6941,2011,Madison,female,2307,174665,182895,357560,0.012613794800295251,Texas
6942,2011,Madison,female,2307,8038,8038,16076,0.28701169445135605,Texas
6943,2011,Madison,female,2307,9829,8645,18474,0.26685945633314057,Texas
6944,2011,Madison,female,2307,14508,14392,28900,0.16029738743746527,Texas
6945,2011,Madison,female,2307,19529,19176,38705,0.12030663329161452,Texas
6946,2011,Madison,female,2307,129718,135952,265670,0.016969224432152524,Texas
6947,2011,Madison,female,2307,64707,64798,129505,0.035602950708355195,Texas
6948,2011,Madison,female,2307,8028,7862,15890,0.29343678453319766,Texas
6949,2011,Madison,female,2307,43737,45963,89700,0.05019254617844788,Texas
6950,2011,Madison,female,2307,5708,5764,11472,0.40024288688410825,Texas
6951,2011,Madison,female,2307,49524,53974,103498,0.042742802089895136,Texas
6952,2011,Madison,female,2307,6049,6156,12205,0.37475633528265107,Texas
6953,2011,Madison,female,2307,4261,3957,8218,0.5830174374526156,Texas
6954,2011,Madison,female,2307,17490,17674,35164,0.13053072309607333,Texas
6955,2011,Madison,female,2307,35252,36107,71359,0.06389342786717257,Texas
6956,2011,Madison,female,2307,10502,10903,21405,0.2115931395028891,Texas
6957,2011,Madison,female,2307,24041,19947,43988,0.1156564896976989,Texas
6958,2011,Madison,female,2307,46137,51545,97682,0.044757008439227856,Texas
6959,2011,Madison,female,2307,8127,6001,14128,0.3844359273454424,Texas
6960,2011,Madison,female,2307,6350,6789,13139,0.3398144056562086,Texas
6981,2012,Madison,female,1789,174665,182895,357560,0.00978156865961344,Texas
6982,2012,Madison,female,1789,8038,8038,16076,0.22256780293605374,Texas
6983,2012,Madison,female,1789,9829,8645,18474,0.20694042799305956,Texas
6984,2012,Madison,female,1789,14508,14392,28900,0.12430516953863258,Texas
6985,2012,Madison,female,1789,19529,19176,38705,0.09329370045890696,Texas
6986,2012,Madison,female,1789,129718,135952,265670,0.01315905613746028,Texas
6987,2012,Madison,female,1789,64707,64798,129505,0.027608876817185716,Texas
6988,2012,Madison,female,1789,8028,7862,15890,0.22755024166878657,Texas
6989,2012,Madison,female,1789,43737,45963,89700,0.03892261166590519,Texas
6990,2012,Madison,female,1789,5708,5764,11472,0.3103747397640527,Texas
6991,2012,Madison,female,1789,49524,53974,103498,0.03314558861674139,Texas
6992,2012,Madison,female,1789,6049,6156,12205,0.29061078622482134,Texas
6993,2012,Madison,female,1789,4261,3957,8218,0.45211018448319434,Texas
6994,2012,Madison,female,1789,17490,17674,35164,0.10122213420844178,Texas
6995,2012,Madison,female,1789,35252,36107,71359,0.04954717921732628,Texas
6996,2012,Madison,female,1789,10502,10903,21405,0.1640832798312391,Texas
6997,2012,Madison,female,1789,24041,19947,43988,0.08968767233167894,Texas
6998,2012,Madison,female,1789,46137,51545,97682,0.034707537103501794,Texas
6999,2012,Madison,female,1789,8127,6001,14128,0.2981169805032495,Texas
7000,2012,Madison,female,1789,6350,6789,13139,0.26351450876417737,Texas
7021,2013,Madison,female,1080,174665,182895,357560,0.005905027474780612,Texas
7022,2013,Madison,female,1080,8038,8038,16076,0.13436178153769596,Texas
7023,2013,Madison,female,1080,9829,8645,18474,0.1249277038750723,Texas
7024,2013,Madison,female,1080,14508,14392,28900,0.07504168982768204,Texas
7025,2013,Madison,female,1080,19529,19176,38705,0.056320400500625784,Texas
7026,2013,Madison,female,1080,129718,135952,265670,0.007943980228315876,Texas
7027,2013,Madison,female,1080,64707,64798,129505,0.016667181085835984,Texas
7028,2013,Madison,female,1080,8028,7862,15890,0.13736962604935132,Texas
7029,2013,Madison,female,1080,43737,45963,89700,0.02349716075974153,Texas
7030,2013,Madison,female,1080,5708,5764,11472,0.1873698820263706,Texas
7031,2013,Madison,female,1080,49524,53974,103498,0.02000963426835143,Texas
7032,2013,Madison,female,1080,6049,6156,12205,0.17543859649122806,Texas
7033,2013,Madison,female,1080,4261,3957,8218,0.27293404094010615,Texas
7034,2013,Madison,female,1080,17490,17674,35164,0.06110671042208894,Texas
7035,2013,Madison,female,1080,35252,36107,71359,0.029911097571108096,Texas
7036,2013,Madison,female,1080,10502,10903,21405,0.09905530587911585,Texas
7037,2013,Madison,female,1080,24041,19947,43988,0.054143480222589864,Texas
7038,2013,Madison,female,1080,46137,51545,97682,0.02095256571927442,Texas
7039,2013,Madison,female,1080,8127,6001,14128,0.1799700049991668,Texas
7040,2013,Madison,female,1080,6350,6789,13139,0.1590808661069377,Texas
7061,2014,Madison,female,812,174665,182895,357560,0.004439705842149868,Texas
7062,2014,Madison,female,812,8038,8038,16076,0.10102015426723066,Texas
7063,2014,Madison,female,812,9829,8645,18474,0.09392712550607288,Texas
7064,2014,Madison,female,812,14508,14392,28900,0.05642023346303502,Texas
7065,2014,Madison,female,812,19529,19176,38705,0.04234459741343346,Texas
7066,2014,Madison,female,812,129718,135952,265670,0.005972696245733789,Texas
7067,2014,Madison,female,812,64707,64798,129505,0.012531250964535943,Texas
7068,2014,Madison,female,812,8028,7862,15890,0.10328160773340117,Texas
7069,2014,Madison,female,812,43737,45963,89700,0.017666383830472338,Texas
7070,2014,Madison,female,812,5708,5764,11472,0.14087439278278974,Texas
7071,2014,Madison,female,812,49524,53974,103498,0.015044280579538296,Texas
7072,2014,Madison,female,812,6049,6156,12205,0.13190383365821962,Texas
7073,2014,Madison,female,812,4261,3957,8218,0.20520596411422795,Texas
7074,2014,Madison,female,812,17490,17674,35164,0.04594319339142243,Texas
7075,2014,Madison,female,812,35252,36107,71359,0.022488714099759048,Texas
7076,2014,Madison,female,812,10502,10903,21405,0.07447491516096487,Texas
7077,2014,Madison,female,812,24041,19947,43988,0.040707875871058306,Texas
7078,2014,Madison,female,812,46137,51545,97682,0.015753225337084103,Texas
7079,2014,Madison,female,812,8127,6001,14128,0.1353107815364106,Texas
7080,2014,Madison,female,812,6350,6789,13139,0.1196052437766976,Texas
7101,2015,Madison,female,986,174665,182895,357560,0.00539107137975341,Texas
7102,2015,Madison,female,986,8038,8038,16076,0.12266733018163722,Texas
7103,2015,Madison,female,986,9829,8645,18474,0.11405436668594564,Texas
7104,2015,Madison,female,986,14508,14392,28900,0.06851028349082824,Texas
7105,2015,Madison,female,986,19529,19176,38705,0.051418439716312055,Texas
7106,2015,Madison,female,986,129718,135952,265670,0.007252559726962458,Texas
7107,2015,Madison,female,986,64707,64798,129505,0.015216519028365074,Texas
7108,2015,Madison,female,986,8028,7862,15890,0.12541338081913,Texas
7109,2015,Madison,female,986,43737,45963,89700,0.021452037508430694,Texas
7110,2015,Madison,female,986,5708,5764,11472,0.1710617626648161,Texas
7111,2015,Madison,female,986,49524,53974,103498,0.01826805498943936,Texas
7112,2015,Madison,female,986,6049,6156,12205,0.16016894087069525,Texas
7113,2015,Madison,female,986,4261,3957,8218,0.24917867071013394,Texas
7114,2015,Madison,female,986,17490,17674,35164,0.05578816340387009,Texas
7115,2015,Madison,female,986,35252,36107,71359,0.02730772426399313,Texas
7116,2015,Madison,female,986,10502,10903,21405,0.0904338255526002,Texas
7117,2015,Madison,female,986,24041,19947,43988,0.049430992129142225,Texas
7118,2015,Madison,female,986,46137,51545,97682,0.01912891648074498,Texas
7119,2015,Madison,female,986,8127,6001,14128,0.1643059490084986,Texas
7120,2015,Madison,female,986,6350,6789,13139,0.14523493887170422,Texas
7141,2016,Madison,female,1257,174665,182895,357560,0.0068727958664807675,Texas
7142,2016,Madison,female,1257,8038,8038,16076,0.15638218462304057,Texas
7143,2016,Madison,female,1257,9829,8645,18474,0.14540196645459805,Texas
7144,2016,Madison,female,1257,14508,14392,28900,0.08734018899388549,Texas
7145,2016,Madison,female,1257,19529,19176,38705,0.06555068836045057,Texas
7146,2016,Madison,female,1257,129718,135952,265670,0.009245910321289868,Texas
7147,2016,Madison,female,1257,64707,64798,129505,0.019398746874903547,Texas
7148,2016,Madison,female,1257,8028,7862,15890,0.15988298142966167,Texas
7149,2016,Madison,female,1257,43737,45963,89700,0.02734808432869917,Texas
7150,2016,Madison,female,1257,5708,5764,11472,0.21807772380291465,Texas
7151,2016,Madison,female,1257,49524,53974,103498,0.023288990995664578,Texas
7152,2016,Madison,female,1257,6049,6156,12205,0.20419103313840156,Texas
7153,2016,Madison,female,1257,4261,3957,8218,0.31766489764973466,Texas
7154,2016,Madison,female,1257,17490,17674,35164,0.07112142129682018,Texas
7155,2016,Madison,female,1257,35252,36107,71359,0.034813194117484146,Texas
7156,2016,Madison,female,1257,10502,10903,21405,0.11528936989819316,Texas
7157,2016,Madison,female,1257,24041,19947,43988,0.06301699503684764,Texas
7158,2016,Madison,female,1257,46137,51545,97682,0.024386458434377728,Texas
7159,2016,Madison,female,1257,8127,6001,14128,0.20946508915180803,Texas
7160,2016,Madison,female,1257,6350,6789,13139,0.18515245249668583,Texas
7181,2009,Marion,female,1752,14898,15067,29965,0.11628061326076856,Texas
7182,2009,Marion,female,1752,7990,8448,16438,0.20738636363636365,Texas
7183,2009,Marion,female,1752,167211,181160,348371,0.009671009052771032,Texas
7184,2009,Marion,female,1752,4203,4281,8484,0.409250175192712,Texas
7185,2009,Marion,female,1752,18726,19358,38084,0.09050521748114475,Texas
7186,2009,Marion,female,1752,455007,489516,944523,0.003579045424460079,Texas
7187,2009,Marion,female,1752,16374,16833,33207,0.10408126893601853,Texas
7188,2009,Marion,female,1752,5971,6061,12032,0.2890612110212836,Texas
7189,2009,Marion,female,1752,9751,9481,19232,0.1847906338993777,Texas
7190,2009,Marion,female,1752,12230,12972,25202,0.13506012950971322,Texas
7191,2009,Marion,female,1752,13745,14927,28672,0.1173712065384873,Texas
7192,2009,Marion,female,1752,34700,30644,65344,0.05717269285993996,Texas
7193,2009,Marion,female,1752,167333,168220,335553,0.01041493282606111,Texas
7194,2009,Marion,female,1752,14655,16907,31562,0.10362571715857337,Texas
7195,2009,Marion,female,1752,13832,14585,28417,0.12012341446691807,Texas
7196,2009,Marion,female,1752,4915,5168,10083,0.33900928792569657,Texas
7197,2009,Marion,female,1752,27819,28678,56497,0.06109212636864495,Texas
7215,2010,Marion,female,2179,14898,15067,29965,0.1446206942324285,Texas
7216,2010,Marion,female,2179,7990,8448,16438,0.2579308712121212,Texas
7217,2010,Marion,female,2179,167211,181160,348371,0.012028041510267167,Texas
7218,2010,Marion,female,2179,4203,4281,8484,0.5089932258818033,Texas
7219,2010,Marion,female,2179,18726,19358,38084,0.11256328133071598,Texas
7220,2010,Marion,female,2179,455007,489516,944523,0.004451335604964904,Texas
7221,2010,Marion,female,2179,16374,16833,33207,0.12944810788332442,Texas
7222,2010,Marion,female,2179,5971,6061,12032,0.35951163174393663,Texas
7223,2010,Marion,female,2179,9751,9481,19232,0.22982807720704568,Texas
7224,2010,Marion,female,2179,12230,12972,25202,0.167977181621955,Texas
7225,2010,Marion,female,2179,13745,14927,28672,0.1459770884973538,Texas
7226,2010,Marion,female,2179,34700,30644,65344,0.07110690510377235,Texas
7227,2010,Marion,female,2179,167333,168220,335553,0.012953275472595411,Texas
7228,2010,Marion,female,2179,14655,16907,31562,0.1288815283610339,Texas
7229,2010,Marion,female,2179,13832,14585,28417,0.14940006856359273,Texas
7230,2010,Marion,female,2179,4915,5168,10083,0.4216331269349845,Texas
7231,2010,Marion,female,2179,27819,28678,56497,0.07598158867424507,Texas
7249,2011,Marion,female,2010,14898,15067,29965,0.13340412822725162,Texas
7250,2011,Marion,female,2010,7990,8448,16438,0.23792613636363635,Texas
7251,2011,Marion,female,2010,167211,181160,348371,0.011095164495473615,Texas
7252,2011,Marion,female,2010,4203,4281,8484,0.4695164681149264,Texas
7253,2011,Marion,female,2010,18726,19358,38084,0.10383304060336812,Texas
7254,2011,Marion,female,2010,455007,489516,944523,0.0041060966342264605,Texas
7255,2011,Marion,female,2010,16374,16833,33207,0.11940830511495278,Texas
7256,2011,Marion,female,2010,5971,6061,12032,0.3316284441511302,Texas
7257,2011,Marion,female,2010,9751,9481,19232,0.21200295327497098,Texas
7258,2011,Marion,female,2010,12230,12972,25202,0.1549491211840888,Texas
7259,2011,Marion,female,2010,13745,14927,28672,0.1346553225698399,Texas
7260,2011,Marion,female,2010,34700,30644,65344,0.06559195927424619,Texas
7261,2011,Marion,female,2010,167333,168220,335553,0.011948638687433124,Texas
7262,2011,Marion,female,2010,14655,16907,31562,0.11888566865795233,Texas
7263,2011,Marion,female,2010,13832,14585,28417,0.13781282139184092,Texas
7264,2011,Marion,female,2010,4915,5168,10083,0.38893188854489164,Texas
7265,2011,Marion,female,2010,27819,28678,56497,0.07008856963526047,Texas
7283,2012,Marion,female,1718,14898,15067,29965,0.11402402601712351,Texas
7284,2012,Marion,female,1718,7990,8448,16438,0.20336174242424243,Texas
7285,2012,Marion,female,1718,167211,181160,348371,0.00948332965334511,Texas
7286,2012,Marion,female,1718,4203,4281,8484,0.4013081055828078,Texas
7287,2012,Marion,female,1718,18726,19358,38084,0.088748837689844,Texas
7288,2012,Marion,female,1718,455007,489516,944523,0.0035095890634831138,Texas
7289,2012,Marion,female,1718,16374,16833,33207,0.10206142695894968,Texas
7290,2012,Marion,female,1718,5971,6061,12032,0.2834515756475829,Texas
7291,2012,Marion,female,1718,9751,9481,19232,0.18120451429174136,Texas
7292,2012,Marion,female,1718,12230,12972,25202,0.1324390995991366,Texas
7293,2012,Marion,female,1718,13745,14927,28672,0.11509345481342534,Texas
7294,2012,Marion,female,1718,34700,30644,65344,0.056063177130922855,Texas
7295,2012,Marion,female,1718,167333,168220,335553,0.010212816549756271,Texas
7296,2012,Marion,female,1718,14655,16907,31562,0.1016147157981901,Texas
7297,2012,Marion,female,1718,13832,14585,28417,0.11779225231402125,Texas
7298,2012,Marion,female,1718,4915,5168,10083,0.33243034055727555,Texas
7299,2012,Marion,female,1718,27819,28678,56497,0.059906548573819655,Texas
7317,2013,Marion,female,1535,14898,15067,29965,0.10187827702926927,Texas
7318,2013,Marion,female,1535,7990,8448,16438,0.1816998106060606,Texas
7319,2013,Marion,female,1535,167211,181160,348371,0.008473172885846765,Texas
7320,2013,Marion,female,1535,4203,4281,8484,0.35856108385891144,Texas
7321,2013,Marion,female,1535,18726,19358,38084,0.07929538175431346,Texas
7322,2013,Marion,female,1535,455007,489516,944523,0.0031357504146953315,Texas
7323,2013,Marion,female,1535,16374,16833,33207,0.09118992455296145,Texas
7324,2013,Marion,female,1535,5971,6061,12032,0.2532585381950173,Texas
7325,2013,Marion,female,1535,9751,9481,19232,0.1619027528741694,Texas
7326,2013,Marion,female,1535,12230,12972,25202,0.11833179155103299,Texas
7327,2013,Marion,female,1535,13745,14927,28672,0.10283379111676827,Texas
7328,2013,Marion,female,1535,34700,30644,65344,0.05009137188356611,Texas
7329,2013,Marion,female,1535,167333,168220,335553,0.009124955415527285,Texas
7330,2013,Marion,female,1535,14655,16907,31562,0.0907907967114213,Texas
7331,2013,Marion,female,1535,13832,14585,28417,0.10524511484401783,Texas
7332,2013,Marion,female,1535,4915,5168,10083,0.2970201238390093,Texas
7333,2013,Marion,female,1535,27819,28678,56497,0.053525350442848174,Texas
7351,2014,Marion,female,1243,14898,15067,29965,0.08249817481914117,Texas
7352,2014,Marion,female,1243,7990,8448,16438,0.14713541666666666,Texas
7353,2014,Marion,female,1243,167211,181160,348371,0.00686133804371826,Texas
7354,2014,Marion,female,1243,4203,4281,8484,0.2903527213267928,Texas
7355,2014,Marion,female,1243,18726,19358,38084,0.06421117884078933,Texas
7356,2014,Marion,female,1243,455007,489516,944523,0.0025392428439519853,Texas
7357,2014,Marion,female,1243,16374,16833,33207,0.07384304639695835,Texas
7358,2014,Marion,female,1243,5971,6061,12032,0.20508166969147004,Texas
7359,2014,Marion,female,1243,9751,9481,19232,0.13110431389093977,Texas
7360,2014,Marion,female,1243,12230,12972,25202,0.09582176996608079,Texas
7361,2014,Marion,female,1243,13745,14927,28672,0.08327192336035372,Texas
7362,2014,Marion,female,1243,34700,30644,65344,0.04056258974024279,Texas
7363,2014,Marion,female,1243,167333,168220,335553,0.007389133277850434,Texas
7364,2014,Marion,female,1243,14655,16907,31562,0.07351984385165908,Texas
7365,2014,Marion,female,1243,13832,14585,28417,0.08522454576619815,Texas
7366,2014,Marion,female,1243,4915,5168,10083,0.2405185758513932,Texas
7367,2014,Marion,female,1243,27819,28678,56497,0.04334332938140735,Texas
7385,2015,Marion,female,1055,14898,15067,29965,0.070020574766045,Texas
7386,2015,Marion,female,1055,7990,8448,16438,0.12488162878787878,Texas
7387,2015,Marion,female,1055,167211,181160,348371,0.005823581364539633,Texas
7388,2015,Marion,female,1055,4203,4281,8484,0.24643774818967532,Texas
7389,2015,Marion,female,1055,18726,19358,38084,0.054499431759479286,Texas
7390,2015,Marion,female,1055,455007,489516,944523,0.0021551900244322964,Texas
7391,2015,Marion,female,1055,16374,16833,33207,0.06267450840610705,Texas
7392,2015,Marion,female,1055,5971,6061,12032,0.17406368586041907,Texas
7393,2015,Marion,female,1055,9751,9481,19232,0.11127518194283303,Texas
7394,2015,Marion,female,1055,12230,12972,25202,0.08132901634289239,Texas
7395,2015,Marion,female,1055,13745,14927,28672,0.07067729617471695,Texas
7396,2015,Marion,female,1055,34700,30644,65344,0.03442762041508941,Texas
7397,2015,Marion,female,1055,167333,168220,335553,0.006271549161811913,Texas
7398,2015,Marion,female,1055,14655,16907,31562,0.06240018927071627,Texas
7399,2015,Marion,female,1055,13832,14585,28417,0.07233459033253342,Texas
7400,2015,Marion,female,1055,4915,5168,10083,0.204140866873065,Texas
7401,2015,Marion,female,1055,27819,28678,56497,0.03678778157472627,Texas
7419,2016,Marion,female,1054,14898,15067,29965,0.06995420455299661,Texas
7420,2016,Marion,female,1054,7990,8448,16438,0.12476325757575757,Texas
7421,2016,Marion,female,1054,167211,181160,348371,0.005818061382203577,Texas
7422,2016,Marion,female,1054,4203,4281,8484,0.24620415790703107,Texas
7423,2016,Marion,female,1054,18726,19358,38084,0.05444777353032338,Texas
7424,2016,Marion,female,1054,455007,489516,944523,0.0021531471902859153,Texas
7425,2016,Marion,female,1054,16374,16833,33207,0.06261510128913444,Texas
7426,2016,Marion,female,1054,5971,6061,12032,0.17389869658472198,Texas
7427,2016,Marion,female,1054,9751,9481,19232,0.11116970783672608,Texas
7428,2016,Marion,female,1054,12230,12972,25202,0.08125192722787543,Texas
7429,2016,Marion,female,1054,13745,14927,28672,0.07061030347692102,Texas
7430,2016,Marion,female,1054,34700,30644,65344,0.03439498759953009,Texas
7431,2016,Marion,female,1054,167333,168220,335553,0.0062656045654500055,Texas
7432,2016,Marion,female,1054,14655,16907,31562,0.06234104217188147,Texas
7433,2016,Marion,female,1054,13832,14585,28417,0.07226602673980116,Texas
7434,2016,Marion,female,1054,4915,5168,10083,0.20394736842105263,Texas
7435,2016,Marion,female,1054,27819,28678,56497,0.03675291163958435,Texas
7453,2009,Martin,female,874,78002,79579,157581,0.010982796969049623,Texas
7454,2009,Martin,female,874,5155,5055,10210,0.17289812067260138,Texas
7455,2009,Martin,female,874,6583,5336,11919,0.16379310344827586,Texas
7456,2009,Martin,female,874,10068,9896,19964,0.08831851253031528,Texas
7457,2009,Martin,female,874,10805,12249,23054,0.07135276349089721,Texas
7458,2009,Martin,female,874,2934,2680,5614,0.32611940298507464,Texas
7465,2010,Martin,female,1066,78002,79579,157581,0.013395493786049083,Texas
7466,2010,Martin,female,1066,5155,5055,10210,0.21088031651829872,Texas
7467,2010,Martin,female,1066,6583,5336,11919,0.1997751124437781,Texas
7468,2010,Martin,female,1066,10068,9896,19964,0.10772029102667745,Texas
7469,2010,Martin,female,1066,10805,12249,23054,0.08702751244999592,Texas
7470,2010,Martin,female,1066,2934,2680,5614,0.3977611940298508,Texas
7477,2011,Martin,female,1161,78002,79579,157581,0.014589276065293607,Texas
7478,2011,Martin,female,1161,5155,5055,10210,0.22967359050445105,Texas
7479,2011,Martin,female,1161,6583,5336,11919,0.21757871064467765,Texas
7480,2011,Martin,female,1161,10068,9896,19964,0.11732012934518997,Texas
7481,2011,Martin,female,1161,10805,12249,23054,0.09478324761204997,Texas
7482,2011,Martin,female,1161,2934,2680,5614,0.4332089552238806,Texas
7489,2012,Martin,female,1016,78002,79579,157581,0.012767187323288808,Texas
7490,2012,Martin,female,1016,5155,5055,10210,0.2009891196834817,Texas
7491,2012,Martin,female,1016,6583,5336,11919,0.1904047976011994,Texas
7492,2012,Martin,female,1016,10068,9896,19964,0.1026677445432498,Texas
7493,2012,Martin,female,1016,10805,12249,23054,0.08294554657523064,Texas
7494,2012,Martin,female,1016,2934,2680,5614,0.37910447761194027,Texas
7501,2013,Martin,female,718,78002,79579,157581,0.009022480805237564,Texas
7502,2013,Martin,female,718,5155,5055,10210,0.1420375865479723,Texas
7503,2013,Martin,female,718,6583,5336,11919,0.1345577211394303,Texas
7504,2013,Martin,female,718,10068,9896,19964,0.07255456750202102,Texas
7505,2013,Martin,female,718,10805,12249,23054,0.05861702996162952,Texas
7506,2013,Martin,female,718,2934,2680,5614,0.26791044776119405,Texas
7513,2014,Martin,female,303,78002,79579,157581,0.0038075371643272724,Texas
7514,2014,Martin,female,303,5155,5055,10210,0.0599406528189911,Texas
7515,2014,Martin,female,303,6583,5336,11919,0.056784107946026986,Texas
7516,2014,Martin,female,303,10068,9896,19964,0.030618431689571544,Texas
7517,2014,Martin,female,303,10805,12249,23054,0.024736713201077638,Texas
7518,2014,Martin,female,303,2934,2680,5614,0.11305970149253732,Texas
7525,2015,Martin,female,445,78002,79579,157581,0.005591927518566456,Texas
7526,2015,Martin,female,445,5155,5055,10210,0.08803165182987141,Texas
7527,2015,Martin,female,445,6583,5336,11919,0.08339580209895052,Texas
7528,2015,Martin,female,445,10068,9896,19964,0.044967663702506065,Texas
7529,2015,Martin,female,445,10805,12249,23054,0.03632949628541105,Texas
7530,2015,Martin,female,445,2934,2680,5614,0.166044776119403,Texas
7537,2016,Martin,female,328,78002,79579,157581,0.00412169039570741,Texas
7538,2016,Martin,female,328,5155,5055,10210,0.0648862512363996,Texas
7539,2016,Martin,female,328,6583,5336,11919,0.06146926536731634,Texas
7540,2016,Martin,female,328,10068,9896,19964,0.033144704931285365,Texas
7541,2016,Martin,female,328,10805,12249,23054,0.02677769613846028,Texas
7542,2016,Martin,female,328,2934,2680,5614,0.12238805970149254,Texas
7549,2009,Mason,female,432,6838,6940,13778,0.0622478386167147,Texas
7550,2009,Mason,female,432,8485,8668,17153,0.049838486386709735,Texas
7551,2009,Mason,female,432,14310,14574,28884,0.029641827912721283,Texas
7552,2009,Mason,female,432,2146,2015,4161,0.2143920595533499,Texas
7553,2009,Mason,female,432,32413,30214,62627,0.01429800754617065,Texas
7554,2009,Mason,female,432,13026,13913,26939,0.031050097031553224,Texas
7561,2010,Mason,female,561,6838,6940,13778,0.080835734870317,Texas
7562,2010,Mason,female,561,8485,8668,17153,0.06472081218274112,Texas
7563,2010,Mason,female,561,14310,14574,28884,0.038493207081103334,Texas
7564,2010,Mason,female,561,2146,2015,4161,0.27841191066997517,Texas
7565,2010,Mason,female,561,32413,30214,62627,0.01856755146620772,Texas
7566,2010,Mason,female,561,13026,13913,26939,0.04032200100625315,Texas
7573,2011,Mason,female,457,6838,6940,13778,0.06585014409221902,Texas
7574,2011,Mason,female,457,8485,8668,17153,0.05272265805260729,Texas
7575,2011,Mason,female,457,14310,14574,28884,0.03135721147248525,Texas
7576,2011,Mason,female,457,2146,2015,4161,0.22679900744416873,Texas
7577,2011,Mason,female,457,32413,30214,62627,0.015125438538425896,Texas
7578,2011,Mason,female,457,13026,13913,26939,0.032846977646805144,Texas
7585,2012,Mason,female,702,6838,6940,13778,0.10115273775216138,Texas
7586,2012,Mason,female,702,8485,8668,17153,0.08098754037840332,Texas
7587,2012,Mason,female,702,14310,14574,28884,0.04816797035817209,Texas
7588,2012,Mason,female,702,2146,2015,4161,0.34838709677419355,Texas
7589,2012,Mason,female,702,32413,30214,62627,0.023234262262527304,Texas
7590,2012,Mason,female,702,13026,13913,26939,0.05045640767627399,Texas
7597,2013,Mason,female,808,6838,6940,13778,0.11642651296829971,Texas
7598,2013,Mason,female,808,8485,8668,17153,0.09321642824180895,Texas
7599,2013,Mason,female,808,14310,14574,28884,0.05544119665157129,Texas
7600,2013,Mason,female,808,2146,2015,4161,0.40099255583126553,Texas
7601,2013,Mason,female,808,32413,30214,62627,0.026742569669689548,Texas
7602,2013,Mason,female,808,13026,13913,26939,0.05807518148494214,Texas
7609,2014,Mason,female,598,6838,6940,13778,0.0861671469740634,Texas
7610,2014,Mason,female,598,8485,8668,17153,0.0689893862482695,Texas
7611,2014,Mason,female,598,14310,14574,28884,0.041031974749554,Texas
7612,2014,Mason,female,598,2146,2015,4161,0.2967741935483871,Texas
7613,2014,Mason,female,598,32413,30214,62627,0.019792149334745483,Texas
7614,2014,Mason,female,598,13026,13913,26939,0.042981384316825993,Texas
7621,2015,Mason,female,549,6838,6940,13778,0.07910662824207493,Texas
7622,2015,Mason,female,549,8485,8668,17153,0.0633364097831103,Texas
7623,2015,Mason,female,549,14310,14574,28884,0.03766982297241663,Texas
7624,2015,Mason,female,549,2146,2015,4161,0.27245657568238213,Texas
7625,2015,Mason,female,549,32413,30214,62627,0.0181703845899252,Texas
7626,2015,Mason,female,549,13026,13913,26939,0.03945949831093222,Texas
7633,2016,Mason,female,617,6838,6940,13778,0.08890489913544669,Texas
7634,2016,Mason,female,617,8485,8668,17153,0.07118135671435163,Texas
7635,2016,Mason,female,617,14310,14574,28884,0.04233566625497461,Texas
7636,2016,Mason,female,617,2146,2015,4161,0.3062034739454094,Texas
7637,2016,Mason,female,617,32413,30214,62627,0.02042099688885947,Texas
7638,2016,Mason,female,617,13026,13913,26939,0.04434701358441745,Texas
7645,2009,Matagorda,female,2870,18319,18424,36743,0.15577507598784193,Texas
7647,2010,Matagorda,female,2320,18319,18424,36743,0.12592270950933565,Texas
7649,2011,Matagorda,female,3026,18319,18424,36743,0.16424229266174556,Texas
7651,2012,Matagorda,female,1917,18319,18424,36743,0.10404906643508467,Texas
7653,2013,Matagorda,female,1608,18319,18424,36743,0.08727746417716023,Texas
7655,2014,Matagorda,female,1346,18319,18424,36743,0.07305688232739904,Texas
7657,2015,Matagorda,female,983,18319,18424,36743,0.05335432045158489,Texas
7659,2016,Matagorda,female,1359,18319,18424,36743,0.07376248371689101,Texas
7661,2009,Maverick,female,3701,28736,29234,57970,0.12659916535540808,Texas
7663,2010,Maverick,female,3381,28736,29234,57970,0.11565300677293562,Texas
7665,2011,Maverick,female,3024,28736,29234,57970,0.10344119860436478,Texas
7667,2012,Maverick,female,3244,28736,29234,57970,0.1109666826298146,Texas
7669,2013,Maverick,female,3254,28736,29234,57970,0.11130875008551687,Texas
7671,2014,Maverick,female,3639,28736,29234,57970,0.12447834713005404,Texas
7673,2015,Maverick,female,4108,28736,29234,57970,0.14052131080249025,Texas
7675,2016,Maverick,female,4911,28736,29234,57970,0.1679893274953821,Texas
7677,2009,McCulloch,female,1124,4260,3838,8098,0.2928608650338718,Texas
7679,2010,McCulloch,female,1646,4260,3838,8098,0.42886920270974466,Texas
7681,2011,McCulloch,female,1451,4260,3838,8098,0.37806149035956227,Texas
7683,2012,McCulloch,female,1641,4260,3838,8098,0.42756644085461176,Texas
7685,2013,McCulloch,female,1398,4260,3838,8098,0.36425221469515373,Texas
7687,2014,McCulloch,female,1117,4260,3838,8098,0.2910369984366858,Texas
7689,2015,McCulloch,female,1238,4260,3838,8098,0.3225638353309015,Texas
7691,2016,McCulloch,female,1085,4260,3838,8098,0.28269932256383534,Texas
7693,2009,McLennan,female,6606,121359,127070,248429,0.05198709372786653,Texas
7695,2010,McLennan,female,7330,121359,127070,248429,0.05768474069410561,Texas
7697,2011,McLennan,female,6392,121359,127070,248429,0.05030298260801133,Texas
7699,2012,McLennan,female,5754,121359,127070,248429,0.045282127960966395,Texas
7701,2013,McLennan,female,5489,121359,127070,248429,0.04319666325647281,Texas
7703,2014,McLennan,female,5201,121359,127070,248429,0.04093019595498544,Texas
7705,2015,McLennan,female,3444,121359,127070,248429,0.027103171480286455,Texas
7707,2016,McLennan,female,4079,121359,127070,248429,0.0321004170929409,Texas
7709,2009,McMullen,female,273,387,275,662,0.9927272727272727,Texas
7711,2010,McMullen,female,174,387,275,662,0.6327272727272727,Texas
7713,2011,McMullen,female,122,387,275,662,0.44363636363636366,Texas
7715,2012,McMullen,female,182,387,275,662,0.6618181818181819,Texas
7717,2013,McMullen,female,170,387,275,662,0.6181818181818182,Texas
7719,2014,McMullen,female,181,387,275,662,0.6581818181818182,Texas
7721,2015,McMullen,female,183,387,275,662,0.6654545454545454,Texas
7723,2016,McMullen,female,193,387,275,662,0.7018181818181818,Texas
7725,2009,Medina,female,5373,87695,89562,177257,0.05999196087626449,Texas
7726,2009,Medina,female,5373,25551,23783,49334,0.22591767228692763,Texas
7729,2010,Medina,female,6194,87695,89562,177257,0.06915879502467565,Texas
7730,2010,Medina,female,6194,25551,23783,49334,0.2604381280746752,Texas
7733,2011,Medina,female,7085,87695,89562,177257,0.07910721064737276,Texas
7734,2011,Medina,female,7085,25551,23783,49334,0.29790186267501995,Texas
7737,2012,Medina,female,5202,87695,89562,177257,0.05808266898908019,Texas
7738,2012,Medina,female,5202,25551,23783,49334,0.2187276626161544,Texas
7741,2013,Medina,female,3879,87695,89562,177257,0.04331077912507537,Texas
7742,2013,Medina,female,3879,25551,23783,49334,0.16309969305806668,Texas
7745,2014,Medina,female,4036,87695,89562,177257,0.04506375471740247,Texas
7746,2014,Medina,female,4036,25551,23783,49334,0.1697010469663205,Texas
7749,2015,Medina,female,3987,87695,89562,177257,0.04451664768540229,Texas
7750,2015,Medina,female,3987,25551,23783,49334,0.16764075179750243,Texas
7753,2016,Medina,female,3455,87695,89562,177257,0.03857662848082892,Texas
7754,2016,Medina,female,3455,25551,23783,49334,0.14527183282176345,Texas
7757,2009,Menard,female,246,6043,6324,12367,0.03889943074003795,Texas
7758,2009,Menard,female,246,1117,1006,2123,0.24453280318091453,Texas
7761,2010,Menard,female,149,6043,6324,12367,0.023561037318153066,Texas
7762,2010,Menard,female,149,1117,1006,2123,0.1481113320079523,Texas
7765,2011,Menard,female,93,6043,6324,12367,0.014705882352941176,Texas
7766,2011,Menard,female,93,1117,1006,2123,0.09244532803180915,Texas
7769,2012,Menard,female,341,6043,6324,12367,0.05392156862745098,Texas
7770,2012,Menard,female,341,1117,1006,2123,0.3389662027833002,Texas
7773,2013,Menard,female,239,6043,6324,12367,0.03779253636938647,Texas
7774,2013,Menard,female,239,1117,1006,2123,0.23757455268389663,Texas
7777,2014,Menard,female,56,6043,6324,12367,0.008855154965211892,Texas
7778,2014,Menard,female,56,1117,1006,2123,0.055666003976143144,Texas
7781,2015,Menard,female,414,6043,6324,12367,0.06546489563567362,Texas
7782,2015,Menard,female,414,1117,1006,2123,0.4115308151093439,Texas
7785,2016,Menard,female,186,6043,6324,12367,0.029411764705882353,Texas
7786,2016,Menard,female,186,1117,1006,2123,0.1848906560636183,Texas
7789,2009,Midland,female,3093,40980,42409,83389,0.07293263222429201,Texas
7790,2009,Midland,female,3093,82543,81651,164194,0.03788073630451556,Texas
7793,2010,Midland,female,4007,40980,42409,83389,0.09448466127472942,Texas
7794,2010,Midland,female,4007,82543,81651,164194,0.04907472045657738,Texas
7797,2011,Midland,female,3829,40980,42409,83389,0.09028743898700747,Texas
7798,2011,Midland,female,3829,82543,81651,164194,0.046894710413834494,Texas
7801,2012,Midland,female,2931,40980,42409,83389,0.06911268834445519,Texas
7802,2012,Midland,female,2931,82543,81651,164194,0.035896682220670904,Texas
7805,2013,Midland,female,2593,40980,42409,83389,0.06114268197788205,Texas
7806,2013,Midland,female,2593,82543,81651,164194,0.03175711258894563,Texas
7809,2014,Midland,female,2462,40980,42409,83389,0.05805371501332264,Texas
7810,2014,Midland,female,2462,82543,81651,164194,0.030152723175466314,Texas
7813,2015,Midland,female,2599,40980,42409,83389,0.061284161380838975,Texas
7814,2015,Midland,female,2599,82543,81651,164194,0.031830596073532474,Texas
7817,2016,Midland,female,3373,40980,42409,83389,0.07953500436228159,Texas
7818,2016,Midland,female,3373,82543,81651,164194,0.04130996558523472,Texas
7821,2009,Milam,female,2610,12343,12321,24664,0.21183345507669832,Texas
7823,2010,Milam,female,3122,12343,12321,24664,0.25338852365879394,Texas
7825,2011,Milam,female,2502,12343,12321,24664,0.20306793279766253,Texas
7827,2012,Milam,female,1985,12343,12321,24664,0.1611070529989449,Texas
7829,2013,Milam,female,2565,12343,12321,24664,0.20818115412710006,Texas
7831,2014,Milam,female,2017,12343,12321,24664,0.16370424478532586,Texas
7833,2015,Milam,female,1980,12343,12321,24664,0.16070124178232287,Texas
7835,2016,Milam,female,2261,12343,12321,24664,0.1835078321564808,Texas
7837,2009,Mills,female,804,7516,7441,14957,0.10804999328047306,Texas
7838,2009,Mills,female,804,2329,2573,4902,0.312475709288768,Texas
7841,2010,Mills,female,911,7516,7441,14957,0.12242978094342158,Texas
7842,2010,Mills,female,911,2329,2573,4902,0.35406140691799454,Texas
7845,2011,Mills,female,539,7516,7441,14957,0.07243650047036689,Texas
7846,2011,Mills,female,539,2329,2573,4902,0.20948309366498252,Texas
7849,2012,Mills,female,559,7516,7441,14957,0.0751243112484881,Texas
7850,2012,Mills,female,559,2329,2573,4902,0.21725612125923047,Texas
7853,2013,Mills,female,920,7516,7441,14957,0.12363929579357613,Texas
7854,2013,Mills,female,920,2329,2573,4902,0.35755926933540616,Texas
7857,2014,Mills,female,652,7516,7441,14957,0.08762263136675177,Texas
7858,2014,Mills,female,652,2329,2573,4902,0.25340069957248346,Texas
7861,2015,Mills,female,646,7516,7441,14957,0.08681628813331542,Texas
7862,2015,Mills,female,646,2329,2573,4902,0.2510687912942091,Texas
7865,2016,Mills,female,715,7516,7441,14957,0.09608923531783363,Texas
7866,2016,Mills,female,715,2329,2573,4902,0.27788573649436454,Texas
7869,2009,Mitchell,female,1943,11683,10749,22432,0.18076100102335102,Texas
7870,2009,Mitchell,female,1943,5282,5349,10631,0.3632454664423257,Texas
7871,2009,Mitchell,female,1943,3163,3059,6222,0.6351748937561295,Texas
7872,2009,Mitchell,female,1943,7400,7640,15040,0.2543193717277487,Texas
7873,2009,Mitchell,female,1943,5383,3175,8558,0.6119685039370079,Texas
7879,2010,Mitchell,female,2305,11683,10749,22432,0.21443855242348125,Texas
7880,2010,Mitchell,female,2305,5282,5349,10631,0.4309216676014208,Texas
7881,2010,Mitchell,female,2305,3163,3059,6222,0.7535142203334423,Texas
7882,2010,Mitchell,female,2305,7400,7640,15040,0.30170157068062825,Texas
7883,2010,Mitchell,female,2305,5383,3175,8558,0.7259842519685039,Texas
7889,2011,Mitchell,female,1835,11683,10749,22432,0.170713554749279,Texas
7890,2011,Mitchell,female,1835,5282,5349,10631,0.34305477659375583,Texas
7891,2011,Mitchell,female,1835,3163,3059,6222,0.5998692383131743,Texas
7892,2011,Mitchell,female,1835,7400,7640,15040,0.24018324607329844,Texas
7893,2011,Mitchell,female,1835,5383,3175,8558,0.5779527559055118,Texas
7899,2012,Mitchell,female,1400,11683,10749,22432,0.13024467392315564,Texas
7900,2012,Mitchell,female,1400,5282,5349,10631,0.2617311647036829,Texas
7901,2012,Mitchell,female,1400,3163,3059,6222,0.4576659038901602,Texas
7902,2012,Mitchell,female,1400,7400,7640,15040,0.18324607329842932,Texas
7903,2012,Mitchell,female,1400,5383,3175,8558,0.4409448818897638,Texas
7909,2013,Mitchell,female,1280,11683,10749,22432,0.1190808447297423,Texas
7910,2013,Mitchell,female,1280,5282,5349,10631,0.2392970648719387,Texas
7911,2013,Mitchell,female,1280,3163,3059,6222,0.41843739784243217,Texas
7912,2013,Mitchell,female,1280,7400,7640,15040,0.16753926701570682,Texas
7913,2013,Mitchell,female,1280,5383,3175,8558,0.4031496062992126,Texas
7919,2014,Mitchell,female,1035,11683,10749,22432,0.09628802679319007,Texas
7920,2014,Mitchell,female,1035,5282,5349,10631,0.19349411104879416,Texas
7921,2014,Mitchell,female,1035,3163,3059,6222,0.3383458646616541,Texas
7922,2014,Mitchell,female,1035,7400,7640,15040,0.1354712041884817,Texas
7923,2014,Mitchell,female,1035,5383,3175,8558,0.32598425196850395,Texas
7929,2015,Mitchell,female,755,11683,10749,22432,0.07023909200855893,Texas
7930,2015,Mitchell,female,755,5282,5349,10631,0.14114787810805757,Texas
7931,2015,Mitchell,female,755,3163,3059,6222,0.2468126838836221,Texas
7932,2015,Mitchell,female,755,7400,7640,15040,0.09882198952879581,Texas
7933,2015,Mitchell,female,755,5383,3175,8558,0.2377952755905512,Texas
7939,2016,Mitchell,female,1205,11683,10749,22432,0.11210345148385896,Texas
7940,2016,Mitchell,female,1205,5282,5349,10631,0.22527575247709852,Texas
7941,2016,Mitchell,female,1205,3163,3059,6222,0.39391958156260215,Texas
7942,2016,Mitchell,female,1205,7400,7640,15040,0.15772251308900523,Texas
7943,2016,Mitchell,female,1205,5383,3175,8558,0.3795275590551181,Texas
7949,2009,Montague,female,2816,9403,10006,19409,0.28143114131521085,Texas
7951,2010,Montague,female,2948,9403,10006,19409,0.29462322606436137,Texas
7953,2011,Montague,female,2878,9403,10006,19409,0.28762742354587245,Texas
7955,2012,Montague,female,3137,9403,10006,19409,0.31351189286428144,Texas
7957,2013,Montague,female,2761,9403,10006,19409,0.27593443933639816,Texas
7959,2014,Montague,female,2294,9403,10006,19409,0.2292624425344793,Texas
7961,2015,Montague,female,1891,9403,10006,19409,0.1889866080351789,Texas
7963,2016,Montague,female,2155,9403,10006,19409,0.2153707775334799,Texas
7965,2009,Montgomery,female,16465,107354,119587,226941,0.13768218953565187,Texas
7966,2009,Montgomery,female,16465,4440,4553,8993,3.6162969470678674,Texas
7967,2009,Montgomery,female,16465,4633,4403,9036,3.7394957983193278,Texas
7968,2009,Montgomery,female,16465,15145,13864,29009,1.187608193883439,Texas
7969,2009,Montgomery,female,16465,19442,18834,38276,0.8742168418817033,Texas
7970,2009,Montgomery,female,16465,4869,5286,10155,3.1148316307226636,Texas
7971,2009,Montgomery,female,16465,16410,16560,32970,0.9942632850241546,Texas
7972,2009,Montgomery,female,16465,13541,14218,27759,1.1580391053594035,Texas
7973,2009,Montgomery,female,16465,502389,537744,1040133,0.0306186586926121,Texas
7974,2009,Montgomery,female,16465,4769,5429,10198,3.0327868852459017,Texas
7975,2009,Montgomery,female,16465,5764,5781,11545,2.848123162082685,Texas
7976,2009,Montgomery,female,16465,24265,25161,49426,0.654385755733079,Texas
7977,2009,Montgomery,female,16465,13546,13792,27338,1.1938080046403712,Texas
7978,2009,Montgomery,female,16465,256154,275880,532034,0.059681745686530376,Texas
7979,2009,Montgomery,female,16465,399358,421943,821301,0.03902185840267524,Texas
7980,2009,Montgomery,female,16465,98123,98264,196387,0.1675588211349019,Texas
7981,2009,Montgomery,female,16465,274604,279841,554445,0.05883698242930807,Texas
7982,2009,Montgomery,female,16465,50738,47259,97997,0.3483992467043315,Texas
8001,2010,Montgomery,female,18650,107354,119587,226941,0.15595340630670557,Texas
8002,2010,Montgomery,female,18650,4440,4553,8993,4.096200307489568,Texas
8003,2010,Montgomery,female,18650,4633,4403,9036,4.235748353395413,Texas
8004,2010,Montgomery,female,18650,15145,13864,29009,1.3452106174264282,Texas
8005,2010,Montgomery,female,18650,19442,18834,38276,0.990230434320909,Texas
8006,2010,Montgomery,female,18650,4869,5286,10155,3.528187665531593,Texas
8007,2010,Montgomery,female,18650,16410,16560,32970,1.126207729468599,Texas
8008,2010,Montgomery,female,18650,13541,14218,27759,1.3117175411450275,Texas
8009,2010,Montgomery,female,18650,502389,537744,1040133,0.034681930435300067,Texas
8010,2010,Montgomery,female,18650,4769,5429,10198,3.4352551114385705,Texas
8011,2010,Montgomery,female,18650,5764,5781,11545,3.2260854523438853,Texas
8012,2010,Montgomery,female,18650,24265,25161,49426,0.7412265013314256,Texas
8013,2010,Montgomery,female,18650,13546,13792,27338,1.3522331786542923,Texas
8014,2010,Montgomery,female,18650,256154,275880,532034,0.06760185587936784,Texas
8015,2010,Montgomery,female,18650,399358,421943,821301,0.044200282976610585,Texas
8016,2010,Montgomery,female,18650,98123,98264,196387,0.18979483839452901,Texas
8017,2010,Montgomery,female,18650,274604,279841,554445,0.06664498768943793,Texas
8018,2010,Montgomery,female,18650,50738,47259,97997,0.3946338263611164,Texas
8037,2011,Montgomery,female,22619,107354,119587,226941,0.18914263256039537,Texas
8038,2011,Montgomery,female,22619,4440,4553,8993,4.9679332308368105,Texas
8039,2011,Montgomery,female,22619,4633,4403,9036,5.137179196002726,Texas
8040,2011,Montgomery,female,22619,15145,13864,29009,1.6314916330063474,Texas
8041,2011,Montgomery,female,22619,19442,18834,38276,1.2009663374747797,Texas
8042,2011,Montgomery,female,22619,4869,5286,10155,4.27903897086644,Texas
8043,2011,Montgomery,female,22619,16410,16560,32970,1.3658816425120772,Texas
8044,2011,Montgomery,female,22619,13541,14218,27759,1.5908707272471514,Texas
8045,2011,Montgomery,female,22619,502389,537744,1040133,0.04206276592579369,Texas
8046,2011,Montgomery,female,22619,4769,5429,10198,4.166328974028366,Texas
8047,2011,Montgomery,female,22619,5764,5781,11545,3.9126448711295625,Texas
8048,2011,Montgomery,female,22619,24265,25161,49426,0.8989706291482851,Texas
8049,2011,Montgomery,female,22619,13546,13792,27338,1.6400087006960558,Texas
8050,2011,Montgomery,female,22619,256154,275880,532034,0.0819885457445266,Texas
8051,2011,Montgomery,female,22619,399358,421943,821301,0.05360676679077506,Texas
8052,2011,Montgomery,female,22619,98123,98264,196387,0.23018602947162745,Texas
8053,2011,Montgomery,female,22619,274604,279841,554445,0.08082804163793011,Texas
8054,2011,Montgomery,female,22619,50738,47259,97997,0.47861782940815506,Texas
8073,2012,Montgomery,female,21981,107354,119587,226941,0.18380760450550646,Texas
8074,2012,Montgomery,female,21981,4440,4553,8993,4.827805842301779,Texas
8075,2012,Montgomery,female,21981,4633,4403,9036,4.992277992277992,Texas
8076,2012,Montgomery,female,21981,15145,13864,29009,1.5854731679169072,Texas
8077,2012,Montgomery,female,21981,19442,18834,38276,1.1670914303918445,Texas
8078,2012,Montgomery,female,21981,4869,5286,10155,4.158342792281498,Texas
8079,2012,Montgomery,female,21981,16410,16560,32970,1.3273550724637682,Texas
8080,2012,Montgomery,female,21981,13541,14218,27759,1.5459980306653538,Texas
8081,2012,Montgomery,female,21981,502389,537744,1040133,0.0408763277693475,Texas
8082,2012,Montgomery,female,21981,4769,5429,10198,4.048811935899797,Texas
8083,2012,Montgomery,female,21981,5764,5781,11545,3.802283341982356,Texas
8084,2012,Montgomery,female,21981,24265,25161,49426,0.8736139263145344,Texas
8085,2012,Montgomery,female,21981,13546,13792,27338,1.59375,Texas
8086,2012,Montgomery,female,21981,256154,275880,532034,0.07967594606350588,Texas
8087,2012,Montgomery,female,21981,399358,421943,821301,0.0520947142149532,Texas
8088,2012,Montgomery,female,21981,98123,98264,196387,0.2236933159651551,Texas
8089,2012,Montgomery,female,21981,274604,279841,554445,0.07854817557112789,Texas
8090,2012,Montgomery,female,21981,50738,47259,97997,0.46511775534818767,Texas
8109,2013,Montgomery,female,20699,107354,119587,226941,0.17308737571809646,Texas
8110,2013,Montgomery,female,20699,4440,4553,8993,4.546233252800351,Texas
8111,2013,Montgomery,female,20699,4633,4403,9036,4.701112877583466,Texas
8112,2013,Montgomery,female,20699,15145,13864,29009,1.49300346220427,Texas
8113,2013,Montgomery,female,20699,19442,18834,38276,1.099023043432091,Texas
8114,2013,Montgomery,female,20699,4869,5286,10155,3.91581536133182,Texas
8115,2013,Montgomery,female,20699,16410,16560,32970,1.2499396135265701,Texas
8116,2013,Montgomery,female,20699,13541,14218,27759,1.4558306372204248,Texas
8117,2013,Montgomery,female,20699,502389,537744,1040133,0.0384922937308459,Texas
8118,2013,Montgomery,female,20699,4769,5429,10198,3.8126726837354945,Texas
8119,2013,Montgomery,female,20699,5764,5781,11545,3.5805224009686905,Texas
8120,2013,Montgomery,female,20699,24265,25161,49426,0.8226620563570606,Texas
8121,2013,Montgomery,female,20699,13546,13792,27338,1.5007975638051043,Texas
8122,2013,Montgomery,female,20699,256154,275880,532034,0.07502899811512252,Texas
8123,2013,Montgomery,female,20699,399358,421943,821301,0.049056389133129354,Texas
8124,2013,Montgomery,female,20699,98123,98264,196387,0.2106468289505821,Texas
8125,2013,Montgomery,female,20699,274604,279841,554445,0.07396700269081372,Texas
8126,2013,Montgomery,female,20699,50738,47259,97997,0.4379906472841152,Texas
8145,2014,Montgomery,female,16738,107354,119587,226941,0.13996504636791623,Texas
8146,2014,Montgomery,female,16738,4440,4553,8993,3.6762574126949263,Texas
8147,2014,Montgomery,female,16738,4633,4403,9036,3.8014989779695663,Texas
8148,2014,Montgomery,female,16738,15145,13864,29009,1.2072994806693595,Texas
8149,2014,Montgomery,female,16738,19442,18834,38276,0.8887119040033981,Texas
8150,2014,Montgomery,female,16738,4869,5286,10155,3.1664774877033675,Texas
8151,2014,Montgomery,female,16738,16410,16560,32970,1.0107487922705314,Texas
8152,2014,Montgomery,female,16738,13541,14218,27759,1.1772401181600787,Texas
8153,2014,Montgomery,female,16738,502389,537744,1040133,0.031126335207831236,Texas
8154,2014,Montgomery,female,16738,4769,5429,10198,3.083072389021919,Texas
8155,2014,Montgomery,female,16738,5764,5781,11545,2.8953468258086836,Texas
8156,2014,Montgomery,female,16738,24265,25161,49426,0.6652358809268312,Texas
8157,2014,Montgomery,female,16738,13546,13792,27338,1.2136020881670533,Texas
8158,2014,Montgomery,female,16738,256154,275880,532034,0.06067130636508627,Texas
8159,2014,Montgomery,female,16738,399358,421943,821301,0.03966886522587174,Texas
8160,2014,Montgomery,female,16738,98123,98264,196387,0.17033705120898804,Texas
8161,2014,Montgomery,female,16738,274604,279841,554445,0.059812536404601185,Texas
8162,2014,Montgomery,female,16738,50738,47259,97997,0.35417592416259336,Texas
8181,2015,Montgomery,female,14264,107354,119587,226941,0.119277178957579,Texas
8182,2015,Montgomery,female,14264,4440,4553,8993,3.13287942016253,Texas
8183,2015,Montgomery,female,14264,4633,4403,9036,3.239609357256416,Texas
8184,2015,Montgomery,female,14264,15145,13864,29009,1.0288517022504329,Texas
8185,2015,Montgomery,female,14264,19442,18834,38276,0.7573537219921419,Texas
8186,2015,Montgomery,female,14264,4869,5286,10155,2.698448732500946,Texas
8187,2015,Montgomery,female,14264,16410,16560,32970,0.8613526570048309,Texas
8188,2015,Montgomery,female,14264,13541,14218,27759,1.0032353354902237,Texas
8189,2015,Montgomery,female,14264,502389,537744,1040133,0.02652563301496623,Texas
8190,2015,Montgomery,female,14264,4769,5429,10198,2.627371523300792,Texas
8191,2015,Montgomery,female,14264,5764,5781,11545,2.4673931845701436,Texas
8192,2015,Montgomery,female,14264,24265,25161,49426,0.5669091053614721,Texas
8193,2015,Montgomery,female,14264,13546,13792,27338,1.0342227378190256,Texas
8194,2015,Montgomery,female,14264,256154,275880,532034,0.05170363926344788,Texas
8195,2015,Montgomery,female,14264,399358,421943,821301,0.03380551401492619,Texas
8196,2015,Montgomery,female,14264,98123,98264,196387,0.14515997720426607,Texas
8197,2015,Montgomery,female,14264,274604,279841,554445,0.05097180184461891,Texas
8198,2015,Montgomery,female,14264,50738,47259,97997,0.3018261071965128,Texas
8217,2016,Montgomery,female,14165,107354,119587,226941,0.11844932977664796,Texas
8218,2016,Montgomery,female,14165,4440,4553,8993,3.1111355150450253,Texas
8219,2016,Montgomery,female,14165,4633,4403,9036,3.217124687712923,Texas
8220,2016,Montgomery,female,14165,15145,13864,29009,1.0217109059434506,Texas
8221,2016,Montgomery,female,14165,19442,18834,38276,0.7520972708930658,Texas
8222,2016,Montgomery,female,14165,4869,5286,10155,2.679720015134317,Texas
8223,2016,Montgomery,female,14165,16410,16560,32970,0.8553743961352657,Texas
8224,2016,Montgomery,female,14165,13541,14218,27759,0.9962723308482205,Texas
8225,2016,Montgomery,female,14165,502389,537744,1040133,0.026341530542414233,Texas
8226,2016,Montgomery,female,14165,4769,5429,10198,2.6091361208325656,Texas
8227,2016,Montgomery,female,14165,5764,5781,11545,2.4502681197024736,Texas
8228,2016,Montgomery,female,14165,24265,25161,49426,0.5629744445769246,Texas
8229,2016,Montgomery,female,14165,13546,13792,27338,1.0270446635730859,Texas
8230,2016,Montgomery,female,14165,256154,275880,532034,0.05134478758880673,Texas
8231,2016,Montgomery,female,14165,399358,421943,821301,0.03357088516695383,Texas
8232,2016,Montgomery,female,14165,98123,98264,196387,0.14415248717739965,Texas
8233,2016,Montgomery,female,14165,274604,279841,554445,0.05061802952390822,Texas
8234,2016,Montgomery,female,14165,50738,47259,97997,0.299731268118242,Texas
8253,2009,Moore,female,1731,46002,49627,95629,0.03488020633929111,Texas
8254,2009,Moore,female,1731,3101,3221,6322,0.5374107420055884,Texas
8255,2009,Moore,female,1731,11438,10363,21801,0.16703657242111358,Texas
8259,2010,Moore,female,1682,46002,49627,95629,0.033892840590807424,Texas
8260,2010,Moore,female,1682,3101,3221,6322,0.5221980751319466,Texas
8261,2010,Moore,female,1682,11438,10363,21801,0.16230821190774872,Texas
8265,2011,Moore,female,2529,46002,49627,95629,0.05096016281459689,Texas
8266,2011,Moore,female,2529,3101,3221,6322,0.7851598882334678,Texas
8267,2011,Moore,female,2529,11438,10363,21801,0.24404130078162695,Texas
8271,2012,Moore,female,2952,46002,49627,95629,0.059483748765792814,Texas
8272,2012,Moore,female,2952,3101,3221,6322,0.9164855634895995,Texas
8273,2012,Moore,female,2952,11438,10363,21801,0.2848595966418991,Texas
8277,2013,Moore,female,2044,46002,49627,95629,0.04118725693674814,Texas
8278,2013,Moore,female,2044,3101,3221,6322,0.6345855324433406,Texas
8279,2013,Moore,female,2044,11438,10363,21801,0.19724018141464827,Texas
8283,2014,Moore,female,1571,46002,49627,95629,0.031656154915670906,Texas
8284,2014,Moore,female,1571,3101,3221,6322,0.4877367277243092,Texas
8285,2014,Moore,female,1571,11438,10363,21801,0.15159702788767732,Texas
8289,2015,Moore,female,1212,46002,49627,95629,0.024422189533923066,Texas
8290,2015,Moore,female,1212,3101,3221,6322,0.37628065818068923,Texas
8291,2015,Moore,female,1212,11438,10363,21801,0.1169545498407797,Texas
8295,2016,Moore,female,1392,46002,49627,95629,0.028049247385495798,Texas
8296,2016,Moore,female,1392,3101,3221,6322,0.43216392424712824,Texas
8297,2016,Moore,female,1392,11438,10363,21801,0.1343240374408955,Texas
8301,2009,Morris,female,2073,2753,2813,5566,0.7369356558833985,Texas
8302,2009,Morris,female,2073,242484,251899,494383,0.008229488803052017,Texas
8303,2009,Morris,female,2073,5981,6443,12424,0.3217445289461431,Texas
8307,2010,Morris,female,2344,2753,2813,5566,0.833274084607181,Texas
8308,2010,Morris,female,2344,242484,251899,494383,0.00930531681348477,Texas
8309,2010,Morris,female,2344,5981,6443,12424,0.3638056805835791,Texas
8313,2011,Morris,female,1567,2753,2813,5566,0.5570565232847494,Texas
8314,2011,Morris,female,1567,242484,251899,494383,0.0062207472042366185,Texas
8315,2011,Morris,female,1567,5981,6443,12424,0.24320968492938072,Texas
8319,2012,Morris,female,1768,2753,2813,5566,0.6285104870245289,Texas
8320,2012,Morris,female,1768,242484,251899,494383,0.007018686060683051,Texas
8321,2012,Morris,female,1768,5981,6443,12424,0.27440633245382584,Texas
8325,2013,Morris,female,1609,2753,2813,5566,0.5719872022751511,Texas
8326,2013,Morris,female,1609,242484,251899,494383,0.00638748069662841,Texas
8327,2013,Morris,female,1609,5981,6443,12424,0.24972838739717523,Texas
8331,2014,Morris,female,1104,2753,2813,5566,0.39246356203341626,Texas
8332,2014,Morris,female,1104,242484,251899,494383,0.00438270894286996,Texas
8333,2014,Morris,female,1104,5981,6443,12424,0.171348750582027,Texas
8337,2015,Morris,female,944,2753,2813,5566,0.33558478492712407,Texas
8338,2015,Morris,female,944,242484,251899,494383,0.0037475337337583713,Texas
8339,2015,Morris,female,944,5981,6443,12424,0.14651559832376224,Texas
8343,2016,Morris,female,608,2753,2813,5566,0.2161393530039104,Texas
8344,2016,Morris,female,608,242484,251899,494383,0.002413665794624036,Texas
8345,2016,Morris,female,608,5981,6443,12424,0.09436597858140618,Texas
8349,2009,Motley,female,205,580,576,1156,0.3559027777777778,Texas
8351,2010,Motley,female,272,580,576,1156,0.4722222222222222,Texas
8353,2011,Motley,female,280,580,576,1156,0.4861111111111111,Texas
8355,2012,Motley,female,208,580,576,1156,0.3611111111111111,Texas
8357,2013,Motley,female,44,580,576,1156,0.0763888888888889,Texas
8359,2014,Motley,female,28,580,576,1156,0.04861111111111111,Texas
8361,2015,Motley,female,27,580,576,1156,0.046875,Texas
8363,2016,Motley,female,51,580,576,1156,0.08854166666666667,Texas
8365,2009,Nacogdoches,female,4614,31365,34193,65558,0.13493989997952796,Texas
8367,2010,Nacogdoches,female,5143,31365,34193,65558,0.15041090281636593,Texas
8369,2011,Nacogdoches,female,4720,31365,34193,65558,0.13803994969730646,Texas
8371,2012,Nacogdoches,female,6270,31365,34193,65558,0.1833708653818033,Texas
8373,2013,Nacogdoches,female,6001,31365,34193,65558,0.175503758079139,Texas
8375,2014,Nacogdoches,female,4202,31365,34193,65558,0.12289065013306817,Texas
8377,2015,Nacogdoches,female,3892,31365,34193,65558,0.11382446699616881,Texas
8379,2016,Nacogdoches,female,4794,31365,34193,65558,0.1402041353493405,Texas
8381,2009,Navarro,female,3182,23845,24738,48583,0.1286280216670709,Texas
8383,2010,Navarro,female,3788,23845,24738,48583,0.1531247473522516,Texas
8385,2011,Navarro,female,3175,23845,24738,48583,0.12834505618885925,Texas
8387,2012,Navarro,female,3804,23845,24738,48583,0.15377152558816395,Texas
8389,2013,Navarro,female,2775,23845,24738,48583,0.11217560029105021,Texas
8391,2014,Navarro,female,2987,23845,24738,48583,0.12074541191688899,Texas
8393,2015,Navarro,female,2058,23845,24738,48583,0.0831918505942275,Texas
8395,2016,Navarro,female,2769,23845,24738,48583,0.11193305845258307,Texas
8397,2009,Newton,female,1177,3932,3916,7848,0.300561797752809,Texas
8398,2009,Newton,female,1177,50598,55899,106497,0.021055832841374623,Texas
8399,2009,Newton,female,1177,7004,7014,14018,0.16780724265754207,Texas
8400,2009,Newton,female,1177,10142,11382,21524,0.10340889123176945,Texas
8401,2009,Newton,female,1177,28964,29238,58202,0.04025583145221971,Texas
8402,2009,Newton,female,1177,7233,6824,14057,0.17247948417350528,Texas
8409,2010,Newton,female,1774,3932,3916,7848,0.4530132788559755,Texas
8410,2010,Newton,female,1774,50598,55899,106497,0.031735809227356485,Texas
8411,2010,Newton,female,1774,7004,7014,14018,0.2529227259766182,Texas
8412,2010,Newton,female,1774,10142,11382,21524,0.15586013002987173,Texas
8413,2010,Newton,female,1774,28964,29238,58202,0.06067446473767016,Texas
8414,2010,Newton,female,1774,7233,6824,14057,0.2599648300117233,Texas
8421,2011,Newton,female,1509,3932,3916,7848,0.38534218590398367,Texas
8422,2011,Newton,female,1509,50598,55899,106497,0.026995116191702893,Texas
8423,2011,Newton,female,1509,7004,7014,14018,0.21514114627887082,Texas
8424,2011,Newton,female,1509,10142,11382,21524,0.13257775434897207,Texas
8425,2011,Newton,female,1509,28964,29238,58202,0.05161091729940488,Texas
8426,2011,Newton,female,1509,7233,6824,14057,0.22113130128956623,Texas
8433,2012,Newton,female,1613,3932,3916,7848,0.411899897854954,Texas
8434,2012,Newton,female,1613,50598,55899,106497,0.028855614590600907,Texas
8435,2012,Newton,female,1613,7004,7014,14018,0.22996863416025093,Texas
8436,2012,Newton,female,1613,10142,11382,21524,0.1417149885784572,Texas
8437,2012,Newton,female,1613,28964,29238,58202,0.05516793214310144,Texas
8438,2012,Newton,female,1613,7233,6824,14057,0.23637162954279015,Texas
8445,2013,Newton,female,1777,3932,3916,7848,0.453779366700715,Texas
8446,2013,Newton,female,1777,50598,55899,106497,0.031789477450401615,Texas
8447,2013,Newton,female,1777,7004,7014,14018,0.25335044197319645,Texas
8448,2013,Newton,female,1777,10142,11382,21524,0.1561237040941838,Texas
8449,2013,Newton,female,1777,28964,29238,58202,0.06077707093508448,Texas
8450,2013,Newton,female,1777,7233,6824,14057,0.2604044548651817,Texas
8457,2014,Newton,female,1282,3932,3916,7848,0.32737487231869256,Texas
8458,2014,Newton,female,1282,50598,55899,106497,0.022934220647954345,Texas
8459,2014,Newton,female,1282,7004,7014,14018,0.18277730253778157,Texas
8460,2014,Newton,female,1282,10142,11382,21524,0.11263398348269198,Texas
8461,2014,Newton,female,1282,28964,29238,58202,0.04384704836172105,Texas
8462,2014,Newton,female,1282,7233,6824,14057,0.18786635404454866,Texas
8469,2015,Newton,female,1393,3932,3916,7848,0.35572012257405516,Texas
8470,2015,Newton,female,1393,50598,55899,106497,0.024919944900624342,Texas
8471,2015,Newton,female,1393,7004,7014,14018,0.19860279441117765,Texas
8472,2015,Newton,female,1393,10142,11382,21524,0.12238622386223862,Texas
8473,2015,Newton,female,1393,28964,29238,58202,0.04764347766605103,Texas
8474,2015,Newton,female,1393,7233,6824,14057,0.2041324736225088,Texas
8481,2016,Newton,female,1069,3932,3916,7848,0.2729826353421859,Texas
8482,2016,Newton,female,1069,50598,55899,106497,0.019123776811749763,Texas
8483,2016,Newton,female,1069,7004,7014,14018,0.15240946678072426,Texas
8484,2016,Newton,female,1069,10142,11382,21524,0.09392022491653489,Texas
8485,2016,Newton,female,1069,28964,29238,58202,0.036562008345304056,Texas
8486,2016,Newton,female,1069,7233,6824,14057,0.15665298944900352,Texas
8493,2009,Nolan,female,4406,7669,7297,14966,0.6038097848430862,Texas
8495,2010,Nolan,female,4868,7669,7297,14966,0.6671234754008497,Texas
8497,2011,Nolan,female,4122,7669,7297,14966,0.5648896806906948,Texas
8499,2012,Nolan,female,3257,7669,7297,14966,0.4463478141702069,Texas
8501,2013,Nolan,female,2548,7669,7297,14966,0.34918459640948335,Texas
8503,2014,Nolan,female,2240,7669,7297,14966,0.30697546937097436,Texas
8505,2015,Nolan,female,1812,7669,7297,14966,0.2483212279018775,Texas
8507,2016,Nolan,female,4118,7669,7297,14966,0.5643415102096752,Texas
8509,2009,Nueces,female,4845,178020,182466,360486,0.02655289204564138,Texas
8511,2010,Nueces,female,5333,178020,182466,360486,0.02922736290596604,Texas
8513,2011,Nueces,female,4771,178020,182466,360486,0.02614733703813313,Texas
8515,2012,Nueces,female,5510,178020,182466,360486,0.030197406640141176,Texas
8517,2013,Nueces,female,5061,178020,182466,360486,0.02773667422971951,Texas
8519,2014,Nueces,female,3467,178020,182466,360486,0.019000800149068867,Texas
8521,2015,Nueces,female,3022,178020,182466,360486,0.016561989630944945,Texas
8523,2016,Nueces,female,2758,178020,182466,360486,0.015115144739293896,Texas
8525,2009,Ochiltree,female,686,5230,5118,10348,0.13403673309886674,Texas
8527,2010,Ochiltree,female,565,5230,5118,10348,0.11039468542399375,Texas
8529,2011,Ochiltree,female,884,5230,5118,10348,0.17272372020320437,Texas
8531,2012,Ochiltree,female,489,5230,5118,10348,0.0955451348182884,Texas
8533,2013,Ochiltree,female,668,5230,5118,10348,0.1305197342711997,Texas
8535,2014,Ochiltree,female,427,5230,5118,10348,0.08343102774521298,Texas
8537,2015,Ochiltree,female,244,5230,5118,10348,0.047674872997264556,Texas
8539,2016,Ochiltree,female,243,5230,5118,10348,0.047479484173505275,Texas
8541,2009,Oldham,female,1448,34328,31046,65374,0.04664046898151131,Texas
8542,2009,Oldham,female,1448,1145,945,2090,1.5322751322751322,Texas
8545,2010,Oldham,female,1863,34328,31046,65374,0.060007730464472074,Texas
8546,2010,Oldham,female,1863,1145,945,2090,1.9714285714285715,Texas
8549,2011,Oldham,female,2145,34328,31046,65374,0.06909102621915866,Texas
8550,2011,Oldham,female,2145,1145,945,2090,2.2698412698412698,Texas
8553,2012,Oldham,female,1933,34328,31046,65374,0.0622624492688269,Texas
8554,2012,Oldham,female,1933,1145,945,2090,2.0455026455026455,Texas
8557,2013,Oldham,female,1492,34328,31046,65374,0.048057720801391486,Texas
8558,2013,Oldham,female,1492,1145,945,2090,1.578835978835979,Texas
8561,2014,Oldham,female,1314,34328,31046,65374,0.04232429298460349,Texas
8562,2014,Oldham,female,1314,1145,945,2090,1.3904761904761904,Texas
8565,2015,Oldham,female,1223,34328,31046,65374,0.039393158538942215,Texas
8566,2015,Oldham,female,1223,1145,945,2090,1.294179894179894,Texas
8569,2016,Oldham,female,1254,34328,31046,65374,0.04039167686658507,Texas
8570,2016,Oldham,female,1254,1145,945,2090,1.326984126984127,Texas
8573,2009,Orange,female,3914,1562429,1601753,3164182,0.002443572760594174,Texas
8574,2009,Orange,female,3914,648446,672748,1321194,0.005817928853002908,Texas
8575,2009,Orange,female,3914,9727,9820,19547,0.3985743380855397,Texas
8576,2009,Orange,female,3914,189484,188743,378227,0.02073719290251824,Texas
8577,2009,Orange,female,3914,68187,74751,142938,0.052360503538414205,Texas
8578,2009,Orange,female,3914,41630,42417,84047,0.0922743239738784,Texas
8579,2009,Orange,female,3914,14357,14580,28937,0.26844993141289436,Texas
8580,2009,Orange,female,3914,17418,18194,35612,0.2151258656700011,Texas
8589,2010,Orange,female,5139,1562429,1601753,3164182,0.0032083598407494788,Texas
8590,2010,Orange,female,5139,648446,672748,1321194,0.007638818695856398,Texas
8591,2010,Orange,female,5139,9727,9820,19547,0.5233197556008147,Texas
8592,2010,Orange,female,5139,189484,188743,378227,0.027227499827808185,Texas
8593,2010,Orange,female,5139,68187,74751,142938,0.06874824417064655,Texas
8594,2010,Orange,female,5139,41630,42417,84047,0.12115425419053681,Texas
8595,2010,Orange,female,5139,14357,14580,28937,0.35246913580246914,Texas
8596,2010,Orange,female,5139,17418,18194,35612,0.28245575464438827,Texas
8605,2011,Orange,female,4410,1562429,1601753,3164182,0.0027532334885590976,Texas
8606,2011,Orange,female,4410,648446,672748,1321194,0.006555203434272566,Texas
8607,2011,Orange,female,4410,9727,9820,19547,0.44908350305498984,Texas
8608,2011,Orange,female,4410,189484,188743,378227,0.0233651049310438,Texas
8609,2011,Orange,female,4410,68187,74751,142938,0.05899586627603644,Texas
8610,2011,Orange,female,4410,41630,42417,84047,0.1039677487799703,Texas
8611,2011,Orange,female,4410,14357,14580,28937,0.30246913580246915,Texas
8612,2011,Orange,female,4410,17418,18194,35612,0.24238760030779377,Texas
8621,2012,Orange,female,5270,1562429,1601753,3164182,0.0032901452346273115,Texas
8622,2012,Orange,female,5270,648446,672748,1321194,0.007833542425990119,Texas
8623,2012,Orange,female,5270,9727,9820,19547,0.5366598778004074,Texas
8624,2012,Orange,female,5270,189484,188743,378227,0.027921565303084088,Texas
8625,2012,Orange,female,5270,68187,74751,142938,0.07050072908723629,Texas
8626,2012,Orange,female,5270,41630,42417,84047,0.12424263856472641,Texas
8627,2012,Orange,female,5270,14357,14580,28937,0.3614540466392318,Texas
8628,2012,Orange,female,5270,17418,18194,35612,0.2896559305265472,Texas
8637,2013,Orange,female,4428,1562429,1601753,3164182,0.002764471176267502,Texas
8638,2013,Orange,female,4428,648446,672748,1321194,0.006581959366657351,Texas
8639,2013,Orange,female,4428,9727,9820,19547,0.4509164969450102,Texas
8640,2013,Orange,female,4428,189484,188743,378227,0.02346047270627255,Texas
8641,2013,Orange,female,4428,68187,74751,142938,0.05923666573022435,Texas
8642,2013,Orange,female,4428,41630,42417,84047,0.10439210693825589,Texas
8643,2013,Orange,female,4428,14357,14580,28937,0.3037037037037037,Texas
8644,2013,Orange,female,4428,17418,18194,35612,0.24337693745190722,Texas
8653,2014,Orange,female,4593,1562429,1601753,3164182,0.002867483313594543,Texas
8654,2014,Orange,female,4593,648446,672748,1321194,0.006827222080184557,Texas
8655,2014,Orange,female,4593,9727,9820,19547,0.46771894093686356,Texas
8656,2014,Orange,female,4593,189484,188743,378227,0.024334677312536093,Texas
8657,2014,Orange,female,4593,68187,74751,142938,0.06144399406028013,Texas
8658,2014,Orange,female,4593,41630,42417,84047,0.10828205672254049,Texas
8659,2014,Orange,female,4593,14357,14580,28937,0.31502057613168727,Texas
8660,2014,Orange,female,4593,17418,18194,35612,0.2524458612729471,Texas
8669,2015,Orange,female,4544,1562429,1601753,3164182,0.002836891830388331,Texas
8670,2015,Orange,female,4544,648446,672748,1321194,0.006754386486470417,Texas
8671,2015,Orange,female,4544,9727,9820,19547,0.46272912423625256,Texas
8672,2015,Orange,female,4544,189484,188743,378227,0.024075065035524496,Texas
8673,2015,Orange,female,4544,68187,74751,142938,0.06078848443499084,Texas
8674,2015,Orange,female,4544,41630,42417,84047,0.10712685951387416,Texas
8675,2015,Orange,female,4544,14357,14580,28937,0.31165980795610426,Texas
8676,2015,Orange,female,4544,17418,18194,35612,0.24975266571397164,Texas
8685,2016,Orange,female,2862,1562429,1601753,3164182,0.0017867923456363123,Texas
8686,2016,Orange,female,2862,648446,672748,1321194,0.004254193249180971,Texas
8687,2016,Orange,female,2862,9727,9820,19547,0.2914460285132383,Texas
8688,2016,Orange,female,2862,189484,188743,378227,0.015163476261371283,Texas
8689,2016,Orange,female,2862,68187,74751,142938,0.03828711321587671,Texas
8690,2016,Orange,female,2862,41630,42417,84047,0.0674729471674093,Texas
8691,2016,Orange,female,2862,14357,14580,28937,0.1962962962962963,Texas
8692,2016,Orange,female,2862,17418,18194,35612,0.15730460591403758,Texas
8701,2009,Palo Pinto,female,3643,13987,14330,28317,0.254221912072575,Texas
8703,2010,Palo Pinto,female,3019,13987,14330,28317,0.21067690160502442,Texas
8705,2011,Palo Pinto,female,2624,13987,14330,28317,0.18311235170969992,Texas
8707,2012,Palo Pinto,female,2643,13987,14330,28317,0.18443824145150034,Texas
8709,2013,Palo Pinto,female,2710,13987,14330,28317,0.18911374738311235,Texas
8711,2014,Palo Pinto,female,2534,13987,14330,28317,0.1768318213538032,Texas
8713,2015,Palo Pinto,female,2377,13987,14330,28317,0.1658757850662945,Texas
8715,2016,Palo Pinto,female,2768,13987,14330,28317,0.1931612002791347,Texas
8717,2009,Panola,female,2909,16549,17694,34243,0.16440601333785465,Texas
8718,2009,Panola,female,2909,11498,11942,23440,0.24359403784960643,Texas
8721,2010,Panola,female,2745,16549,17694,34243,0.15513733468972532,Texas
8722,2010,Panola,female,2745,11498,11942,23440,0.22986099480823982,Texas
8725,2011,Panola,female,1948,16549,17694,34243,0.1100938171131457,Texas
8726,2011,Panola,female,1948,11498,11942,23440,0.16312175514989113,Texas
8729,2012,Panola,female,2735,16549,17694,34243,0.15457217135752233,Texas
8730,2012,Panola,female,2735,11498,11942,23440,0.22902361413498576,Texas
8733,2013,Panola,female,3078,16549,17694,34243,0.17395727365208546,Texas
8734,2013,Panola,female,3078,11498,11942,23440,0.25774577122760006,Texas
8737,2014,Panola,female,2141,16549,17694,34243,0.12100146942466372,Texas
8738,2014,Panola,female,2141,11498,11942,23440,0.17928320214369453,Texas
8741,2015,Panola,female,2644,16549,17694,34243,0.14942918503447497,Texas
8742,2015,Panola,female,2644,11498,11942,23440,0.2214034500083738,Texas
8745,2016,Panola,female,3035,16549,17694,34243,0.17152707132361253,Texas
8746,2016,Panola,female,3035,11498,11942,23440,0.2541450343326076,Texas
8749,2009,Parker,female,11522,64448,65354,129802,0.17630137405514582,Texas
8751,2010,Parker,female,11797,64448,65354,129802,0.18050922667319522,Texas
8753,2011,Parker,female,11549,64448,65354,129802,0.17671450867582703,Texas
8755,2012,Parker,female,13841,64448,65354,129802,0.2117850475869878,Texas
8757,2013,Parker,female,10083,64448,65354,129802,0.1542828289010619,Texas
8759,2014,Parker,female,6476,64448,65354,129802,0.09909110383450133,Texas
8761,2015,Parker,female,7087,64448,65354,129802,0.10844018728769471,Texas
8763,2016,Parker,female,8581,64448,65354,129802,0.1313003029653885,Texas
8765,2009,Parmer,female,1425,5059,4793,9852,0.29730857500521596,Texas
8767,2010,Parmer,female,1289,5059,4793,9852,0.2689338618819111,Texas
8769,2011,Parmer,female,854,5059,4793,9852,0.17817650740663468,Texas
8771,2012,Parmer,female,795,5059,4793,9852,0.16586688921343626,Texas
8773,2013,Parmer,female,1035,5059,4793,9852,0.21593991237220947,Texas
8775,2014,Parmer,female,978,5059,4793,9852,0.20404756937200083,Texas
8777,2015,Parmer,female,649,5059,4793,9852,0.13540580012518255,Texas
8779,2016,Parmer,female,997,5059,4793,9852,0.2080116837054037,Texas
8781,2009,Pecos,female,4273,9010,6787,15797,0.6295859731840283,Texas
8783,2010,Pecos,female,3709,9010,6787,15797,0.5464859289818771,Texas
8785,2011,Pecos,female,3230,9010,6787,15797,0.47590982761161044,Texas
8787,2012,Pecos,female,3375,9010,6787,15797,0.49727420067776634,Texas
8789,2013,Pecos,female,2043,9010,6787,15797,0.30101664947694123,Texas
8791,2014,Pecos,female,2169,9010,6787,15797,0.31958155296891116,Texas
8793,2015,Pecos,female,3583,9010,6787,15797,0.5279210254899072,Texas
8795,2016,Pecos,female,4709,9010,6787,15797,0.6938264328864004,Texas
8797,2009,Polk,female,3647,9828,10335,20163,0.3528785679729076,Texas
8798,2009,Polk,female,3647,327706,340965,668671,0.010696112504215975,Texas
8799,2009,Polk,female,3647,20415,21206,41621,0.1719796284070546,Texas
8800,2009,Polk,female,3647,233599,240675,474274,0.015153214916381011,Texas
8801,2009,Polk,female,3647,15967,15624,31591,0.23342293906810035,Texas
8802,2009,Polk,female,3647,15435,16114,31549,0.2263249348392702,Texas
8803,2009,Polk,female,3647,2540,2715,5255,1.343278084714549,Texas
8804,2009,Polk,female,3647,9682,10776,20458,0.3384372680029696,Texas
8805,2009,Polk,female,3647,39563,41864,81427,0.08711542136441812,Texas
8806,2009,Polk,female,3647,8369,8413,16782,0.43349578033995007,Texas
8807,2009,Polk,female,3647,25878,21959,47837,0.16608224418233983,Texas
8808,2009,Polk,female,3647,21842,21507,43349,0.16957269726135676,Texas
8821,2010,Polk,female,3395,9828,10335,20163,0.3284954039671021,Texas
8822,2010,Polk,female,3395,327706,340965,668671,0.009957033713137713,Texas
8823,2010,Polk,female,3395,20415,21206,41621,0.1600961991889088,Texas
8824,2010,Polk,female,3395,233599,240675,474274,0.014106159759011114,Texas
8825,2010,Polk,female,3395,15967,15624,31591,0.21729390681003585,Texas
8826,2010,Polk,female,3395,15435,16114,31549,0.21068635968722849,Texas
8827,2010,Polk,female,3395,2540,2715,5255,1.2504604051565378,Texas
8828,2010,Polk,female,3395,9682,10776,20458,0.3150519673348181,Texas
8829,2010,Polk,female,3395,39563,41864,81427,0.0810959296770495,Texas
8830,2010,Polk,female,3395,8369,8413,16782,0.40354213716866755,Texas
8831,2010,Polk,female,3395,25878,21959,47837,0.15460631176283074,Texas
8832,2010,Polk,female,3395,21842,21507,43349,0.15785558190356627,Texas
8845,2011,Polk,female,3451,9828,10335,20163,0.3339138848572811,Texas
8846,2011,Polk,female,3451,327706,340965,668671,0.010121273444488437,Texas
8847,2011,Polk,female,3451,20415,21206,41621,0.16273696123738565,Texas
8848,2011,Polk,female,3451,233599,240675,474274,0.01433883868287109,Texas
8849,2011,Polk,female,3451,15967,15624,31591,0.22087813620071683,Texas
8850,2011,Polk,female,3451,15435,16114,31549,0.21416159860990444,Texas
8851,2011,Polk,female,3451,2540,2715,5255,1.2710865561694291,Texas
8852,2011,Polk,female,3451,9682,10776,20458,0.32024870081662954,Texas
8853,2011,Polk,female,3451,39563,41864,81427,0.08243359449646474,Texas
8854,2011,Polk,female,3451,8369,8413,16782,0.41019850231784144,Texas
8855,2011,Polk,female,3451,25878,21959,47837,0.1571565189671661,Texas
8856,2011,Polk,female,3451,21842,21507,43349,0.1604593853164086,Texas
8869,2012,Polk,female,2944,9828,10335,20163,0.2848572810836962,Texas
8870,2012,Polk,female,2944,327706,340965,668671,0.008634317305295265,Texas
8871,2012,Polk,female,2944,20415,21206,41621,0.13882863340563992,Texas
8872,2012,Polk,female,2944,233599,240675,474274,0.012232263425781657,Texas
8873,2012,Polk,female,2944,15967,15624,31591,0.18842805939580134,Texas
8874,2012,Polk,female,2944,15435,16114,31549,0.18269827479210624,Texas
8875,2012,Polk,female,2944,2540,2715,5255,1.0843462246777165,Texas
8876,2012,Polk,female,2944,9682,10776,20458,0.27319970304380103,Texas
8877,2012,Polk,female,2944,39563,41864,81427,0.07032295050640168,Texas
8878,2012,Polk,female,2944,8369,8413,16782,0.34993462498514205,Texas
8879,2012,Polk,female,2944,25878,21959,47837,0.13406803588505853,Texas
8880,2012,Polk,female,2944,21842,21507,43349,0.1368856651322825,Texas
8893,2013,Polk,female,2911,9828,10335,20163,0.28166424770198356,Texas
8894,2013,Polk,female,2911,327706,340965,668671,0.00853753317789216,Texas
8895,2013,Polk,female,2911,20415,21206,41621,0.13727247005564464,Texas
8896,2013,Polk,female,2911,233599,240675,474274,0.012095149059935598,Texas
8897,2013,Polk,female,2911,15967,15624,31591,0.18631592421915003,Texas
8898,2013,Polk,female,2911,15435,16114,31549,0.18065036614124363,Texas
8899,2013,Polk,female,2911,2540,2715,5255,1.0721915285451198,Texas
8900,2013,Polk,female,2911,9682,10776,20458,0.2701373422420193,Texas
8901,2013,Polk,female,2911,39563,41864,81427,0.0695346837378177,Texas
8902,2013,Polk,female,2911,8369,8413,16782,0.34601212409366455,Texas
8903,2013,Polk,female,2911,25878,21959,47837,0.1325652352110752,Texas
8904,2013,Polk,female,2911,21842,21507,43349,0.13535128097828614,Texas
8917,2014,Polk,female,2547,9828,10335,20163,0.24644412191582002,Texas
8918,2014,Polk,female,2547,327706,340965,668671,0.007469974924112445,Texas
8919,2014,Polk,female,2547,20415,21206,41621,0.12010751674054512,Texas
8920,2014,Polk,female,2547,233599,240675,474274,0.010582736054845747,Texas
8921,2014,Polk,female,2547,15967,15624,31591,0.1630184331797235,Texas
8922,2014,Polk,female,2547,15435,16114,31549,0.15806131314385008,Texas
8923,2014,Polk,female,2547,2540,2715,5255,0.938121546961326,Texas
8924,2014,Polk,female,2547,9682,10776,20458,0.23635857461024498,Texas
8925,2014,Polk,female,2547,39563,41864,81427,0.060839862411618574,Texas
8926,2014,Polk,female,2547,8369,8413,16782,0.30274575062403425,Texas
8927,2014,Polk,female,2547,25878,21959,47837,0.1159888883828954,Texas
8928,2014,Polk,female,2547,21842,21507,43349,0.118426558794811,Texas
8941,2015,Polk,female,3683,9828,10335,20163,0.3563618771165941,Texas
8942,2015,Polk,female,3683,327706,340965,668671,0.010801695188655727,Texas
8943,2015,Polk,female,3683,20415,21206,41621,0.173677261152504,Texas
8944,2015,Polk,female,3683,233599,240675,474274,0.015302794224576711,Texas
8945,2015,Polk,female,3683,15967,15624,31591,0.23572708653353813,Texas
8946,2015,Polk,female,3683,15435,16114,31549,0.2285590170038476,Texas
8947,2015,Polk,female,3683,2540,2715,5255,1.3565377532228362,Texas
8948,2015,Polk,female,3683,9682,10776,20458,0.34177802524127693,Texas
8949,2015,Polk,female,3683,39563,41864,81427,0.08797534874832792,Texas
8950,2015,Polk,female,3683,8369,8413,16782,0.43777487222156186,Texas
8951,2015,Polk,female,3683,25878,21959,47837,0.16772166309941255,Texas
8952,2015,Polk,female,3683,21842,21507,43349,0.17124657088389827,Texas
8965,2016,Polk,female,2708,9828,10335,20163,0.26202225447508465,Texas
8966,2016,Polk,female,2708,327706,340965,668671,0.00794216415174578,Texas
8967,2016,Polk,female,2708,20415,21206,41621,0.12769970762991606,Texas
8968,2016,Polk,female,2708,233599,240675,474274,0.01125168796094318,Texas
8969,2016,Polk,female,2708,15967,15624,31591,0.1733230926779314,Texas
8970,2016,Polk,female,2708,15435,16114,31549,0.1680526250465434,Texas
8971,2016,Polk,female,2708,2540,2715,5255,0.9974217311233886,Texas
8972,2016,Polk,female,2708,9682,10776,20458,0.25129918337045287,Texas
8973,2016,Polk,female,2708,39563,41864,81427,0.06468564876743742,Texas
8974,2016,Polk,female,2708,8369,8413,16782,0.3218828004279092,Texas
8975,2016,Polk,female,2708,25878,21959,47837,0.12332073409535953,Texas
8976,2016,Polk,female,2708,21842,21507,43349,0.12591249360673268,Texas
8989,2009,Potter,female,3621,8475,8462,16937,0.42791302292602224,Texas
8990,2009,Potter,female,3621,1179,1147,2326,3.15693112467306,Texas
8991,2009,Potter,female,3621,62295,58604,120899,0.06178759129069688,Texas
8995,2010,Potter,female,4089,8475,8462,16937,0.483219097140156,Texas
8996,2010,Potter,female,4089,1179,1147,2326,3.5649520488230166,Texas
8997,2010,Potter,female,4089,62295,58604,120899,0.0697733943075558,Texas
9001,2011,Potter,female,3405,8475,8462,16937,0.4023871425194989,Texas
9002,2011,Potter,female,3405,1179,1147,2326,2.968613775065388,Texas
9003,2011,Potter,female,3405,62295,58604,120899,0.05810183605214661,Texas
9007,2012,Potter,female,3555,8475,8462,16937,0.4201134483573623,Texas
9008,2012,Potter,female,3555,1179,1147,2326,3.099389712292938,Texas
9009,2012,Potter,female,3555,62295,58604,120899,0.06066138830113985,Texas
9013,2013,Potter,female,3336,8475,8462,16937,0.39423304183408175,Texas
9014,2013,Potter,female,3336,1179,1147,2326,2.908456843940715,Texas
9015,2013,Potter,female,3336,62295,58604,120899,0.05692444201760972,Texas
9019,2014,Potter,female,2900,8475,8462,16937,0.34270857953202555,Texas
9020,2014,Potter,female,2900,1179,1147,2326,2.5283347863993026,Texas
9021,2014,Potter,female,2900,62295,58604,120899,0.04948467681386936,Texas
9025,2015,Potter,female,2605,8475,8462,16937,0.30784684471756085,Texas
9026,2015,Potter,female,2605,1179,1147,2326,2.2711421098517874,Texas
9027,2015,Potter,female,2605,62295,58604,120899,0.04445089072418265,Texas
9031,2016,Potter,female,2520,8475,8462,16937,0.29780193807610494,Texas
9032,2016,Potter,female,2520,1179,1147,2326,2.197035745422842,Texas
9033,2016,Potter,female,2520,62295,58604,120899,0.04300047778308648,Texas
9037,2009,Presidio,female,2824,3497,3626,7123,0.7788196359624932,Texas
9039,2010,Presidio,female,2352,3497,3626,7123,0.6486486486486487,Texas
9041,2011,Presidio,female,1749,3497,3626,7123,0.48234969663541094,Texas
9043,2012,Presidio,female,1584,3497,3626,7123,0.4368450082735797,Texas
9045,2013,Presidio,female,1102,3497,3626,7123,0.3039161610590182,Texas
9047,2014,Presidio,female,1648,3497,3626,7123,0.4544953116381688,Texas
9049,2015,Presidio,female,1496,3497,3626,7123,0.4125758411472697,Texas
9051,2016,Presidio,female,1738,3497,3626,7123,0.4793160507446222,Texas
9053,2009,Rains,female,1167,5868,5605,11473,0.20820695807314898,Texas
9055,2010,Rains,female,1300,5868,5605,11473,0.231935771632471,Texas
9057,2011,Rains,female,1473,5868,5605,11473,0.26280107047279216,Texas
9059,2012,Rains,female,1218,5868,5605,11473,0.21730597680642283,Texas
9061,2013,Rains,female,1092,5868,5605,11473,0.19482604817127563,Texas
9063,2014,Rains,female,821,5868,5605,11473,0.1464763603925067,Texas
9065,2015,Rains,female,633,5868,5605,11473,0.11293487957181088,Texas
9067,2016,Rains,female,971,5868,5605,11473,0.17323818019625334,Texas
9069,2009,Randall,female,5002,65083,67392,132475,0.07422245963912631,Texas
9071,2010,Randall,female,5624,65083,67392,132475,0.08345204178537512,Texas
9073,2011,Randall,female,6863,65083,67392,132475,0.10183701329534663,Texas
9075,2012,Randall,female,6121,65083,67392,132475,0.09082680436847103,Texas
9077,2013,Randall,female,5719,65083,67392,132475,0.08486170465337133,Texas
9079,2014,Randall,female,4663,65083,67392,132475,0.06919218898385565,Texas
9081,2015,Randall,female,4705,65083,67392,132475,0.06981540835707502,Texas
9083,2016,Randall,female,5225,65083,67392,132475,0.07753145773979107,Texas
9085,2009,Reagan,female,266,1951,1801,3752,0.14769572459744587,Texas
9087,2010,Reagan,female,345,1951,1801,3752,0.19156024430871738,Texas
9089,2011,Reagan,female,381,1951,1801,3752,0.21154913936701833,Texas
9091,2012,Reagan,female,221,1951,1801,3752,0.12270960577456969,Texas
9093,2013,Reagan,female,240,1951,1801,3752,0.13325930038867295,Texas
9095,2014,Reagan,female,212,1951,1801,3752,0.11771238200999445,Texas
9097,2015,Reagan,female,119,1951,1801,3752,0.06607440310938367,Texas
9099,2016,Reagan,female,123,1951,1801,3752,0.06829539144919489,Texas
9101,2009,Real,female,362,1426,1963,3389,0.18441161487519103,Texas
9103,2010,Real,female,318,1426,1963,3389,0.1619969434538971,Texas
9105,2011,Real,female,276,1426,1963,3389,0.14060112073357106,Texas
9107,2012,Real,female,319,1426,1963,3389,0.16250636780438105,Texas
9109,2013,Real,female,239,1426,1963,3389,0.1217524197656648,Texas
9111,2014,Real,female,172,1426,1963,3389,0.08762098828323994,Texas
9113,2015,Real,female,127,1426,1963,3389,0.06469689251146205,Texas
9115,2016,Real,female,152,1426,1963,3389,0.07743250127356088,Texas
9117,2009,Red River,female,1633,4067,4551,8618,0.3588222368710174,Texas
9118,2009,Red River,female,1633,5986,6289,12275,0.259659723326443,Texas
9121,2010,Red River,female,1615,4067,4551,8618,0.35486706218413533,Texas
9122,2010,Red River,female,1615,5986,6289,12275,0.256797583081571,Texas
9125,2011,Red River,female,1481,4067,4551,8618,0.3254229839595693,Texas
9126,2011,Red River,female,1481,5986,6289,12275,0.2354905390364128,Texas
9129,2012,Red River,female,1540,4067,4551,8618,0.33838716765546034,Texas
9130,2012,Red River,female,1540,5986,6289,12275,0.24487199872793766,Texas
9133,2013,Red River,female,1447,4067,4551,8618,0.3179520984399033,Texas
9134,2013,Red River,female,1447,5986,6289,12275,0.23008427412943233,Texas
9137,2014,Red River,female,999,4067,4551,8618,0.21951219512195122,Texas
9138,2014,Red River,female,999,5986,6289,12275,0.15884878359039592,Texas
9141,2015,Red River,female,647,4067,4551,8618,0.14216655680070314,Texas
9142,2015,Red River,female,647,5986,6289,12275,0.10287804102401017,Texas
9145,2016,Red River,female,665,4067,4551,8618,0.14612173148758514,Texas
9146,2016,Red River,female,665,5986,6289,12275,0.10574018126888217,Texas
9149,2009,Reeves,female,1864,8689,6436,15125,0.2896208825357365,Texas
9151,2010,Reeves,female,1691,8689,6436,15125,0.2627408328154133,Texas
9153,2011,Reeves,female,1102,8689,6436,15125,0.17122436295835922,Texas
9155,2012,Reeves,female,657,8689,6436,15125,0.10208203853325047,Texas
9157,2013,Reeves,female,530,8689,6436,15125,0.08234928527035426,Texas
9159,2014,Reeves,female,1083,8689,6436,15125,0.168272218769422,Texas
9161,2015,Reeves,female,598,8689,6436,15125,0.09291485394655065,Texas
9163,2016,Reeves,female,1739,8689,6436,15125,0.2701988812927284,Texas
9165,2009,Refugio,female,2334,3586,3650,7236,0.6394520547945205,Texas
9167,2010,Refugio,female,2440,3586,3650,7236,0.6684931506849315,Texas
9169,2011,Refugio,female,2220,3586,3650,7236,0.6082191780821918,Texas
9171,2012,Refugio,female,1289,3586,3650,7236,0.35315068493150686,Texas
9173,2013,Refugio,female,1234,3586,3650,7236,0.33808219178082194,Texas
9175,2014,Refugio,female,1035,3586,3650,7236,0.28356164383561644,Texas
9177,2015,Refugio,female,1026,3586,3650,7236,0.2810958904109589,Texas
9179,2016,Refugio,female,845,3586,3650,7236,0.23150684931506849,Texas
9181,2009,Roberts,female,187,5290,4995,10285,0.03743743743743744,Texas
9182,2009,Roberts,female,187,401,484,885,0.38636363636363635,Texas
9185,2010,Roberts,female,283,5290,4995,10285,0.05665665665665666,Texas
9186,2010,Roberts,female,283,401,484,885,0.5847107438016529,Texas
9189,2011,Roberts,female,291,5290,4995,10285,0.058258258258258255,Texas
9190,2011,Roberts,female,291,401,484,885,0.6012396694214877,Texas
9193,2012,Roberts,female,255,5290,4995,10285,0.05105105105105105,Texas
9194,2012,Roberts,female,255,401,484,885,0.5268595041322314,Texas
9197,2013,Roberts,female,260,5290,4995,10285,0.05205205205205205,Texas
9198,2013,Roberts,female,260,401,484,885,0.5371900826446281,Texas
9201,2014,Roberts,female,334,5290,4995,10285,0.06686686686686687,Texas
9202,2014,Roberts,female,334,401,484,885,0.6900826446280992,Texas
9205,2015,Roberts,female,246,5290,4995,10285,0.04924924924924925,Texas
9206,2015,Roberts,female,246,401,484,885,0.5082644628099173,Texas
9209,2016,Roberts,female,121,5290,4995,10285,0.024224224224224225,Texas
9210,2016,Roberts,female,121,401,484,885,0.25,Texas
9213,2009,Robertson,female,1883,1147,996,2143,1.890562248995984,Texas
9214,2009,Robertson,female,1883,34287,35057,69344,0.053712525315914084,Texas
9215,2009,Robertson,female,1883,8296,8594,16890,0.21910635326972305,Texas
9219,2010,Robertson,female,2195,1147,996,2143,2.2038152610441766,Texas
9220,2010,Robertson,female,2195,34287,35057,69344,0.06261231708360669,Texas
9221,2010,Robertson,female,2195,8296,8594,16890,0.25541075168722366,Texas
9225,2011,Robertson,female,2437,1147,996,2143,2.4467871485943773,Texas
9226,2011,Robertson,female,2437,34287,35057,69344,0.06951536069829135,Texas
9227,2011,Robertson,female,2437,8296,8594,16890,0.2835699325110542,Texas
9231,2012,Robertson,female,1792,1147,996,2143,1.7991967871485943,Texas
9232,2012,Robertson,female,1792,34287,35057,69344,0.051116752717003736,Texas
9233,2012,Robertson,female,1792,8296,8594,16890,0.20851757039795207,Texas
9237,2013,Robertson,female,1778,1147,996,2143,1.785140562248996,Texas
9238,2013,Robertson,female,1778,34287,35057,69344,0.050717403086402144,Texas
9239,2013,Robertson,female,1778,8296,8594,16890,0.20688852687921805,Texas
9243,2014,Robertson,female,1311,1147,996,2143,1.3162650602409638,Texas
9244,2014,Robertson,female,1311,34287,35057,69344,0.037396240408477624,Texas
9245,2014,Robertson,female,1311,8296,8594,16890,0.15254828950430532,Texas
9249,2015,Robertson,female,1594,1147,996,2143,1.6004016064257027,Texas
9250,2015,Robertson,female,1594,34287,35057,69344,0.045468807941352656,Texas
9251,2015,Robertson,female,1594,8296,8594,16890,0.18547824063299978,Texas
9255,2016,Robertson,female,1995,1147,996,2143,2.003012048192771,Texas
9256,2016,Robertson,female,1995,34287,35057,69344,0.05690732236072682,Texas
9257,2016,Robertson,female,1995,8296,8594,16890,0.23213870141959506,Texas
9261,2009,Rockwall,female,4282,46167,47475,93642,0.09019483938915218,Texas
9263,2010,Rockwall,female,3667,46167,47475,93642,0.07724065297525014,Texas
9265,2011,Rockwall,female,2231,46167,47475,93642,0.04699315429173249,Texas
9267,2012,Rockwall,female,2229,46167,47475,93642,0.04695102685624013,Texas
9269,2013,Rockwall,female,1753,46167,47475,93642,0.036924697209057396,Texas
9271,2014,Rockwall,female,1039,46167,47475,93642,0.021885202738283305,Texas
9273,2015,Rockwall,female,513,46167,47475,93642,0.01080568720379147,Texas
9275,2016,Rockwall,female,531,46167,47475,93642,0.011184834123222749,Texas
9277,2009,Runnels,female,1280,5233,5077,10310,0.2521173921607248,Texas
9279,2010,Runnels,female,1827,5233,5077,10310,0.3598581839669096,Texas
9281,2011,Runnels,female,943,5233,5077,10310,0.185739610005909,Texas
9283,2012,Runnels,female,778,5233,5077,10310,0.15324010242269057,Texas
9285,2013,Runnels,female,943,5233,5077,10310,0.185739610005909,Texas
9287,2014,Runnels,female,496,5233,5077,10310,0.09769548946228088,Texas
9289,2015,Runnels,female,484,5233,5077,10310,0.09533188891077408,Texas
9291,2016,Runnels,female,713,5233,5077,10310,0.14043726610202875,Texas
9293,2009,Rusk,female,5187,28379,25216,53595,0.20570272842639595,Texas
9294,2009,Rusk,female,5187,7109,7074,14183,0.7332485156912638,Texas
9297,2010,Rusk,female,5438,28379,25216,53595,0.21565672588832488,Texas
9298,2010,Rusk,female,5438,7109,7074,14183,0.7687305626236924,Texas
9301,2011,Rusk,female,5808,28379,25216,53595,0.2303299492385787,Texas
9302,2011,Rusk,female,5808,7109,7074,14183,0.8210347752332485,Texas
9305,2012,Rusk,female,4920,28379,25216,53595,0.19511421319796954,Texas
9306,2012,Rusk,female,4920,7109,7074,14183,0.6955046649703138,Texas
9309,2013,Rusk,female,3645,28379,25216,53595,0.14455107868020303,Texas
9310,2013,Rusk,female,3645,7109,7074,14183,0.5152671755725191,Texas
9313,2014,Rusk,female,3926,28379,25216,53595,0.1556947969543147,Texas
9314,2014,Rusk,female,3926,7109,7074,14183,0.5549901046084252,Texas
9317,2015,Rusk,female,3775,28379,25216,53595,0.14970653553299493,Texas
9318,2015,Rusk,female,3775,7109,7074,14183,0.533644331354255,Texas
9321,2016,Rusk,female,4192,28379,25216,53595,0.16624365482233502,Texas
9322,2016,Rusk,female,4192,7109,7074,14183,0.5925925925925926,Texas
9325,2009,Sabine,female,486,11929,12159,24088,0.03997039230199852,Texas
9326,2009,Sabine,female,486,5072,5386,10458,0.0902339398440401,Texas
9329,2010,Sabine,female,414,11929,12159,24088,0.034048852701702444,Texas
9330,2010,Sabine,female,414,5072,5386,10458,0.07686594875603417,Texas
9333,2011,Sabine,female,208,11929,12159,24088,0.01710666995641089,Texas
9334,2011,Sabine,female,208,5072,5386,10458,0.038618640920906055,Texas
9337,2012,Sabine,female,753,11929,12159,24088,0.061929434986429804,Texas
9338,2012,Sabine,female,753,5072,5386,10458,0.13980690679539548,Texas
9341,2013,Sabine,female,1176,11929,12159,24088,0.09671848013816926,Texas
9342,2013,Sabine,female,1176,5072,5386,10458,0.21834385443743037,Texas
9345,2014,Sabine,female,1186,11929,12159,24088,0.09754091619376594,Texas
9346,2014,Sabine,female,1186,5072,5386,10458,0.22020051986632008,Texas
9349,2015,Sabine,female,873,11929,12159,24088,0.07179866765358993,Texas
9350,2015,Sabine,female,873,5072,5386,10458,0.16208689194207204,Texas
9353,2016,Sabine,female,972,11929,12159,24088,0.07994078460399703,Texas
9354,2016,Sabine,female,972,5072,5386,10458,0.1804678796880802,Texas
9357,2009,San Augustine,female,511,4085,4242,8327,0.12046204620462046,Texas
9359,2010,San Augustine,female,528,4085,4242,8327,0.12446958981612447,Texas
9361,2011,San Augustine,female,609,4085,4242,8327,0.14356435643564355,Texas
9363,2012,San Augustine,female,415,4085,4242,8327,0.09783121169259783,Texas
9365,2013,San Augustine,female,582,4085,4242,8327,0.1371994342291372,Texas
9367,2014,San Augustine,female,511,4085,4242,8327,0.12046204620462046,Texas
9369,2015,San Augustine,female,418,4085,4242,8327,0.09853842527109855,Texas
9371,2016,San Augustine,female,406,4085,4242,8327,0.09570957095709572,Texas
9373,2009,San Jacinto,female,2586,13718,14101,27819,0.18339124884759947,Texas
9375,2010,San Jacinto,female,4615,13718,14101,27819,0.32728175306715834,Texas
9377,2011,San Jacinto,female,5174,13718,14101,27819,0.3669243316076874,Texas
9379,2012,San Jacinto,female,4513,13718,14101,27819,0.3200482235302461,Texas
9381,2013,San Jacinto,female,4077,13718,14101,27819,0.28912843060775834,Texas
9383,2014,San Jacinto,female,3575,13718,14101,27819,0.25352811857315083,Texas
9385,2015,San Jacinto,female,2826,13718,14101,27819,0.2004113183462166,Texas
9387,2016,San Jacinto,female,2730,13718,14101,27819,0.19360329054676972,Texas
9389,2009,San Patricio,female,7323,33721,33325,67046,0.21974493623405852,Texas
9391,2010,San Patricio,female,5559,33721,33325,67046,0.16681170292573144,Texas
9393,2011,San Patricio,female,6832,33721,33325,67046,0.2050112528132033,Texas
9395,2012,San Patricio,female,4754,33721,33325,67046,0.142655663915979,Texas
9397,2013,San Patricio,female,5228,33721,33325,67046,0.15687921980495123,Texas
9399,2014,San Patricio,female,4476,33721,33325,67046,0.13431357839459865,Texas
9401,2015,San Patricio,female,3775,33721,33325,67046,0.11327831957989497,Texas
9403,2016,San Patricio,female,4659,33721,33325,67046,0.13980495123780945,Texas
9405,2009,San Saba,female,434,3073,2889,5962,0.15022499134648667,Texas
9407,2010,San Saba,female,504,3073,2889,5962,0.17445482866043613,Texas
9409,2011,San Saba,female,479,3073,2889,5962,0.16580131533402562,Texas
9411,2012,San Saba,female,422,3073,2889,5962,0.14607130494980963,Texas
9413,2013,San Saba,female,139,3073,2889,5962,0.04811353409484251,Texas
9415,2014,San Saba,female,89,3073,2889,5962,0.03080650744202146,Texas
9417,2015,San Saba,female,196,3073,2889,5962,0.06784354447905849,Texas
9419,2016,San Saba,female,173,3073,2889,5962,0.059882312218760815,Texas
9421,2009,Schleicher,female,97,1542,1519,3061,0.06385780118499013,Texas
9423,2010,Schleicher,female,438,1542,1519,3061,0.28834759710335744,Texas
9425,2011,Schleicher,female,425,1542,1519,3061,0.27978933508887427,Texas
9427,2012,Schleicher,female,373,1542,1519,3061,0.2455562870309414,Texas
9429,2013,Schleicher,female,341,1542,1519,3061,0.22448979591836735,Texas
9431,2014,Schleicher,female,127,1542,1519,3061,0.0836076366030283,Texas
9433,2015,Schleicher,female,83,1542,1519,3061,0.05464121132323897,Texas
9435,2016,Schleicher,female,315,1542,1519,3061,0.2073732718894009,Texas
9437,2009,Scurry,female,2647,9425,7814,17239,0.3387509598157154,Texas
9439,2010,Scurry,female,3224,9425,7814,17239,0.4125927821858203,Texas
9441,2011,Scurry,female,2781,9425,7814,17239,0.35589966726388533,Texas
9443,2012,Scurry,female,2204,9425,7814,17239,0.2820578448937804,Texas
9445,2013,Scurry,female,1655,9425,7814,17239,0.21179933452777067,Texas
9447,2014,Scurry,female,1328,9425,7814,17239,0.16995136933708727,Texas
9449,2015,Scurry,female,1049,9425,7814,17239,0.13424622472485284,Texas
9451,2016,Scurry,female,1517,9425,7814,17239,0.19413872536472998,Texas
9453,2009,Shackelford,female,855,1770,1541,3311,0.554834523036989,Texas
9455,2010,Shackelford,female,800,1770,1541,3311,0.5191434133679429,Texas
9457,2011,Shackelford,female,645,1770,1541,3311,0.41855937702790397,Texas
9459,2012,Shackelford,female,778,1770,1541,3311,0.5048669695003245,Texas
9461,2013,Shackelford,female,570,1770,1541,3311,0.3698896820246593,Texas
9463,2014,Shackelford,female,385,1770,1541,3311,0.24983776768332253,Texas
9465,2015,Shackelford,female,332,1770,1541,3311,0.2154445165476963,Texas
9467,2016,Shackelford,female,469,1770,1541,3311,0.30434782608695654,Texas
9469,2009,Shelby,female,2281,102478,108783,211261,0.02096834983407334,Texas
9470,2009,Shelby,female,2281,10791,11041,21832,0.206593605651662,Texas
9471,2009,Shelby,female,2281,21941,22458,44399,0.10156737020215513,Texas
9472,2009,Shelby,female,2281,5735,5959,11694,0.3827823460312133,Texas
9473,2009,Shelby,female,2281,22613,24173,46786,0.094361477681711,Texas
9474,2009,Shelby,female,2281,3047,3014,6061,0.7568015925680159,Texas
9475,2009,Shelby,female,2281,24657,24140,48797,0.09449047224523613,Texas
9476,2009,Shelby,female,2281,445994,491011,937005,0.004645517106541402,Texas
9477,2009,Shelby,female,2281,12572,12906,25478,0.17673950100728344,Texas
9487,2010,Shelby,female,2193,102478,108783,211261,0.02015939990623535,Texas
9488,2010,Shelby,female,2193,10791,11041,21832,0.19862331310569695,Texas
9489,2010,Shelby,female,2193,21941,22458,44399,0.0976489446967673,Texas
9490,2010,Shelby,female,2193,5735,5959,11694,0.36801476757845275,Texas
9491,2010,Shelby,female,2193,22613,24173,46786,0.09072105241385016,Texas
9492,2010,Shelby,female,2193,3047,3014,6061,0.7276045122760452,Texas
9493,2010,Shelby,female,2193,24657,24140,48797,0.09084507042253522,Texas
9494,2010,Shelby,female,2193,445994,491011,937005,0.004466295052453,Texas
9495,2010,Shelby,female,2193,12572,12906,25478,0.1699209669920967,Texas
9505,2011,Shelby,female,2248,102478,108783,211261,0.020664993611134094,Texas
9506,2011,Shelby,female,2248,10791,11041,21832,0.2036047459469251,Texas
9507,2011,Shelby,female,2248,21941,22458,44399,0.1000979606376347,Texas
9508,2011,Shelby,female,2248,5735,5959,11694,0.37724450411142807,Texas
9509,2011,Shelby,female,2248,22613,24173,46786,0.09299631820626318,Texas
9510,2011,Shelby,female,2248,3047,3014,6061,0.7458526874585268,Texas
9511,2011,Shelby,female,2248,24657,24140,48797,0.09312344656172328,Texas
9512,2011,Shelby,female,2248,445994,491011,937005,0.004578308836258251,Texas
9513,2011,Shelby,female,2248,12572,12906,25478,0.17418255075158842,Texas
9523,2012,Shelby,female,2260,102478,108783,211261,0.020775304964930182,Texas
9524,2012,Shelby,female,2260,10791,11041,21832,0.20469160402137487,Texas
9525,2012,Shelby,female,2260,21941,22458,44399,0.1006322913883694,Texas
9526,2012,Shelby,female,2260,5735,5959,11694,0.3792582648095318,Texas
9527,2012,Shelby,female,2260,22613,24173,46786,0.09349273983369875,Texas
9528,2012,Shelby,female,2260,3047,3014,6061,0.7498341074983411,Texas
9529,2012,Shelby,female,2260,24657,24140,48797,0.0936205468102734,Texas
9530,2012,Shelby,female,2260,445994,491011,937005,0.004602748207270305,Texas
9531,2012,Shelby,female,2260,12572,12906,25478,0.17511235084456842,Texas
9541,2013,Shelby,female,2527,102478,108783,211261,0.023229732586893172,Texas
9542,2013,Shelby,female,2527,10791,11041,21832,0.22887419617788243,Texas
9543,2013,Shelby,female,2527,21941,22458,44399,0.11252115059221658,Texas
9544,2013,Shelby,female,2527,5735,5959,11694,0.4240644403423393,Texas
9545,2013,Shelby,female,2527,22613,24173,46786,0.10453812104414016,Texas
9546,2013,Shelby,female,2527,3047,3014,6061,0.838420703384207,Texas
9547,2013,Shelby,female,2527,24657,24140,48797,0.10468102734051367,Texas
9548,2013,Shelby,female,2527,445994,491011,937005,0.005146524212288523,Texas
9549,2013,Shelby,female,2527,12572,12906,25478,0.1958004029133736,Texas
9559,2014,Shelby,female,2643,102478,108783,211261,0.024296075673588702,Texas
9560,2014,Shelby,female,2643,10791,11041,21832,0.23938049089756364,Texas
9561,2014,Shelby,female,2643,21941,22458,44399,0.11768634784931872,Texas
9562,2014,Shelby,female,2643,5735,5959,11694,0.44353079375734183,Texas
9563,2014,Shelby,female,2643,22613,24173,46786,0.10933686344268399,Texas
9564,2014,Shelby,female,2643,3047,3014,6061,0.8769077637690776,Texas
9565,2014,Shelby,female,2643,24657,24140,48797,0.10948632974316487,Texas
9566,2014,Shelby,female,2643,445994,491011,937005,0.005382771465405052,Texas
9567,2014,Shelby,female,2643,12572,12906,25478,0.20478847047884705,Texas
9577,2015,Shelby,female,2076,102478,108783,211261,0.019083864206723478,Texas
9578,2015,Shelby,female,2076,10791,11041,21832,0.1880264468798116,Texas
9579,2015,Shelby,female,2076,21941,22458,44399,0.09243921987710393,Texas
9580,2015,Shelby,female,2076,5735,5959,11694,0.3483806007719416,Texas
9581,2015,Shelby,female,2076,22613,24173,46786,0.08588094154635337,Texas
9582,2015,Shelby,female,2076,3047,3014,6061,0.6887856668878567,Texas
9583,2015,Shelby,female,2076,24657,24140,48797,0.0859983429991715,Texas
9584,2015,Shelby,female,2076,445994,491011,937005,0.004228011185085466,Texas
9585,2015,Shelby,female,2076,12572,12906,25478,0.1608554160855416,Texas
9595,2016,Shelby,female,2631,102478,108783,211261,0.024185764319792614,Texas
9596,2016,Shelby,female,2631,10791,11041,21832,0.23829363282311386,Texas
9597,2016,Shelby,female,2631,21941,22458,44399,0.11715201709858403,Texas
9598,2016,Shelby,female,2631,5735,5959,11694,0.4415170330592381,Texas
9599,2016,Shelby,female,2631,22613,24173,46786,0.10884044181524842,Texas
9600,2016,Shelby,female,2631,3047,3014,6061,0.8729263437292635,Texas
9601,2016,Shelby,female,2631,24657,24140,48797,0.10898922949461474,Texas
9602,2016,Shelby,female,2631,445994,491011,937005,0.005358332094392997,Texas
9603,2016,Shelby,female,2631,12572,12906,25478,0.20385867038586705,Texas
9613,2009,Sherman,female,851,3003,2963,5966,0.2872089098886264,Texas
9614,2009,Sherman,female,851,1527,1515,3042,0.5617161716171617,Texas
9615,2009,Sherman,female,851,871,734,1605,1.159400544959128,Texas
9616,2009,Sherman,female,851,1574,1484,3058,0.5734501347708895,Texas
9621,2010,Sherman,female,596,3003,2963,5966,0.2011474856564293,Texas
9622,2010,Sherman,female,596,1527,1515,3042,0.3933993399339934,Texas
9623,2010,Sherman,female,596,871,734,1605,0.8119891008174387,Texas
9624,2010,Sherman,female,596,1574,1484,3058,0.40161725067385445,Texas
9629,2011,Sherman,female,712,3003,2963,5966,0.24029699628754642,Texas
9630,2011,Sherman,female,712,1527,1515,3042,0.46996699669966996,Texas
9631,2011,Sherman,female,712,871,734,1605,0.9700272479564033,Texas
9632,2011,Sherman,female,712,1574,1484,3058,0.4797843665768194,Texas
9637,2012,Sherman,female,464,3003,2963,5966,0.15659804252446843,Texas
9638,2012,Sherman,female,464,1527,1515,3042,0.30627062706270625,Texas
9639,2012,Sherman,female,464,871,734,1605,0.6321525885558583,Texas
9640,2012,Sherman,female,464,1574,1484,3058,0.31266846361185985,Texas
9645,2013,Sherman,female,830,3003,2963,5966,0.280121498481269,Texas
9646,2013,Sherman,female,830,1527,1515,3042,0.5478547854785478,Texas
9647,2013,Sherman,female,830,871,734,1605,1.1307901907356948,Texas
9648,2013,Sherman,female,830,1574,1484,3058,0.5592991913746631,Texas
9653,2014,Sherman,female,507,3003,2963,5966,0.171110361120486,Texas
9654,2014,Sherman,female,507,1527,1515,3042,0.3346534653465347,Texas
9655,2014,Sherman,female,507,871,734,1605,0.6907356948228883,Texas
9656,2014,Sherman,female,507,1574,1484,3058,0.341644204851752,Texas
9661,2015,Sherman,female,299,3003,2963,5966,0.10091123860951738,Texas
9662,2015,Sherman,female,299,1527,1515,3042,0.19735973597359735,Texas
9663,2015,Sherman,female,299,871,734,1605,0.40735694822888285,Texas
9664,2015,Sherman,female,299,1574,1484,3058,0.20148247978436656,Texas
9669,2016,Sherman,female,457,3003,2963,5966,0.1542355720553493,Texas
9670,2016,Sherman,female,457,1527,1515,3042,0.30165016501650166,Texas
9671,2016,Sherman,female,457,871,734,1605,0.6226158038147139,Texas
9672,2016,Sherman,female,457,1574,1484,3058,0.3079514824797844,Texas
9677,2009,Smith,female,11634,1809,1854,3663,6.275080906148867,Texas
9678,2009,Smith,female,11634,7847,8216,16063,1.4160175267770205,Texas
9679,2009,Smith,female,11634,9675,9783,19458,1.1892057651027292,Texas
9680,2009,Smith,female,11634,108730,116285,225015,0.10004729758782302,Texas
9685,2010,Smith,female,11696,1809,1854,3663,6.308522114347357,Texas
9686,2010,Smith,female,11696,7847,8216,16063,1.4235637779941577,Texas
9687,2010,Smith,female,11696,9675,9783,19458,1.195543289379536,Texas
9688,2010,Smith,female,11696,108730,116285,225015,0.1005804703960098,Texas
9693,2011,Smith,female,13335,1809,1854,3663,7.192556634304207,Texas
9694,2011,Smith,female,13335,7847,8216,16063,1.6230525803310614,Texas
9695,2011,Smith,female,13335,9675,9783,19458,1.3630788101809261,Texas
9696,2011,Smith,female,13335,108730,116285,225015,0.11467515156727007,Texas
9701,2012,Smith,female,13475,1809,1854,3663,7.2680690399137005,Texas
9702,2012,Smith,female,13475,7847,8216,16063,1.6400925024342745,Texas
9703,2012,Smith,female,13475,9675,9783,19458,1.3773893488704896,Texas
9704,2012,Smith,female,13475,108730,116285,225015,0.11587909016640151,Texas
9709,2013,Smith,female,11840,1809,1854,3663,6.386192017259979,Texas
9710,2013,Smith,female,11840,7847,8216,16063,1.4410905550146056,Texas
9711,2013,Smith,female,11840,9675,9783,19458,1.210262700603087,Texas
9712,2013,Smith,female,11840,108730,116285,225015,0.10181880724083071,Texas
9717,2014,Smith,female,11103,1809,1854,3663,5.988673139158576,Texas
9718,2014,Smith,female,11103,7847,8216,16063,1.3513875365141188,Texas
9719,2014,Smith,female,11103,9675,9783,19458,1.1349279362158846,Texas
9720,2014,Smith,female,11103,108730,116285,225015,0.0954809304725459,Texas
9725,2015,Smith,female,6861,1809,1854,3663,3.7006472491909386,Texas
9726,2015,Smith,female,6861,7847,8216,16063,0.8350778967867576,Texas
9727,2015,Smith,female,6861,9675,9783,19458,0.7013186139221098,Texas
9728,2015,Smith,female,6861,108730,116285,225015,0.05900159091886314,Texas
9733,2016,Smith,female,7538,1809,1854,3663,4.065803667745415,Texas
9734,2016,Smith,female,7538,7847,8216,16063,0.9174780915287244,Texas
9735,2016,Smith,female,7538,9675,9783,19458,0.7705202902994991,Texas
9736,2016,Smith,female,7538,108730,116285,225015,0.06482349400180591,Texas
9741,2009,Somervell,female,443,4192,4551,8743,0.0973412436827071,Texas
9743,2010,Somervell,female,848,4192,4551,8743,0.1863326741375522,Texas
9745,2011,Somervell,female,556,4192,4551,8743,0.12217095143924413,Texas
9747,2012,Somervell,female,1182,4192,4551,8743,0.25972313777191824,Texas
9749,2013,Somervell,female,1580,4192,4551,8743,0.3471764447374203,Texas
9751,2014,Somervell,female,1110,4192,4551,8743,0.24390243902439024,Texas
9753,2015,Somervell,female,737,4192,4551,8743,0.16194243023511315,Texas
9755,2016,Somervell,female,378,4192,4551,8743,0.08305866842452209,Texas
9757,2009,Starr,female,4985,31073,32821,63894,0.1518844642149843,Texas
9759,2010,Starr,female,5639,31073,32821,63894,0.1718107309344627,Texas
9761,2011,Starr,female,5129,31073,32821,63894,0.15627189908899788,Texas
9763,2012,Starr,female,6055,31073,32821,63894,0.18448554279272417,Texas
9765,2013,Starr,female,6004,31073,32821,63894,0.1829316596081777,Texas
9767,2014,Starr,female,21866,31073,32821,63894,0.666219798299869,Texas
9769,2015,Starr,female,28763,31073,32821,63894,0.8763596477864781,Texas
9771,2016,Starr,female,24960,31073,32821,63894,0.7604887114956888,Texas
9773,2009,Stephens,female,550,11765,13911,25676,0.03953705700524764,Texas
9774,2009,Stephens,female,550,21328,22655,43983,0.024277201500772456,Texas
9775,2009,Stephens,female,550,4808,4564,9372,0.12050832602979843,Texas
9779,2010,Stephens,female,649,11765,13911,25676,0.04665372726619222,Texas
9780,2010,Stephens,female,649,21328,22655,43983,0.028647097770911498,Texas
9781,2010,Stephens,female,649,4808,4564,9372,0.14219982471516213,Texas
9785,2011,Stephens,female,884,11765,13911,25676,0.06354683344116167,Texas
9786,2011,Stephens,female,884,21328,22655,43983,0.039020083866696094,Texas
9787,2011,Stephens,female,884,4808,4564,9372,0.1936897458369851,Texas
9791,2012,Stephens,female,1049,11765,13911,25676,0.07540795054273597,Texas
9792,2012,Stephens,female,1049,21328,22655,43983,0.04630324431692783,Texas
9793,2012,Stephens,female,1049,4808,4564,9372,0.22984224364592462,Texas
9797,2013,Stephens,female,260,11765,13911,25676,0.01869024512975343,Texas
9798,2013,Stephens,female,260,21328,22655,43983,0.011476495254910615,Texas
9799,2013,Stephens,female,260,4808,4564,9372,0.05696757230499562,Texas
9803,2014,Stephens,female,756,11765,13911,25676,0.05434548199266767,Texas
9804,2014,Stephens,female,756,21328,22655,43983,0.03337011697197087,Texas
9805,2014,Stephens,female,756,4808,4564,9372,0.1656441717791411,Texas
9809,2015,Stephens,female,689,11765,13911,25676,0.0495291495938466,Texas
9810,2015,Stephens,female,689,21328,22655,43983,0.030412712425513133,Texas
9811,2015,Stephens,female,689,4808,4564,9372,0.15096406660823838,Texas
9815,2016,Stephens,female,775,11765,13911,25676,0.0557113075983035,Texas
9816,2016,Stephens,female,775,21328,22655,43983,0.03420878393290664,Texas
9817,2016,Stephens,female,775,4808,4564,9372,0.16980718667835232,Texas
9821,2009,Sterling,female,480,622,519,1141,0.9248554913294798,Texas
9823,2010,Sterling,female,253,622,519,1141,0.48747591522157996,Texas
9825,2011,Sterling,female,130,622,519,1141,0.2504816955684008,Texas
9827,2012,Sterling,female,636,622,519,1141,1.2254335260115607,Texas
9829,2013,Sterling,female,673,622,519,1141,1.2967244701348748,Texas
9831,2014,Sterling,female,272,622,519,1141,0.5240847784200385,Texas
9833,2015,Sterling,female,171,622,519,1141,0.32947976878612717,Texas
9835,2016,Sterling,female,170,622,519,1141,0.32755298651252407,Texas
9837,2009,Stonewall,female,452,730,655,1385,0.6900763358778625,Texas
9839,2010,Stonewall,female,642,730,655,1385,0.9801526717557252,Texas
9841,2011,Stonewall,female,619,730,655,1385,0.9450381679389313,Texas
9843,2012,Stonewall,female,531,730,655,1385,0.8106870229007633,Texas
9845,2013,Stonewall,female,369,730,655,1385,0.5633587786259542,Texas
9847,2014,Stonewall,female,410,730,655,1385,0.6259541984732825,Texas
9849,2015,Stonewall,female,360,730,655,1385,0.549618320610687,Texas
9851,2016,Stonewall,female,326,730,655,1385,0.49770992366412214,Texas
9853,2009,Sutton,female,2501,2116,1749,3865,1.4299599771297884,Texas
9855,2010,Sutton,female,2144,2116,1749,3865,1.2258433390508863,Texas
9857,2011,Sutton,female,2333,2116,1749,3865,1.3339050886220698,Texas
9859,2012,Sutton,female,1613,2116,1749,3865,0.9222412807318467,Texas
9861,2013,Sutton,female,1514,2116,1749,3865,0.8656375071469411,Texas
9863,2014,Sutton,female,1829,2116,1749,3865,1.0457404230989136,Texas
9865,2015,Sutton,female,1829,2116,1749,3865,1.0457404230989136,Texas
9867,2016,Sutton,female,2386,2116,1749,3865,1.3642081189251,Texas
9869,2009,Swisher,female,1416,4036,3448,7484,0.41067285382830626,Texas
9871,2010,Swisher,female,1728,4036,3448,7484,0.5011600928074246,Texas
9873,2011,Swisher,female,1395,4036,3448,7484,0.40458236658932717,Texas
9875,2012,Swisher,female,1474,4036,3448,7484,0.4274941995359629,Texas
9877,2013,Swisher,female,1045,4036,3448,7484,0.3030742459396752,Texas
9879,2014,Swisher,female,1137,4036,3448,7484,0.3297563805104408,Texas
9881,2015,Swisher,female,659,4036,3448,7484,0.19112529002320186,Texas
9883,2016,Swisher,female,1242,4036,3448,7484,0.36020881670533644,Texas
9885,2009,Tarrant,female,793,988765,1031212,2019977,0.0007689980333820786,Texas
9887,2010,Tarrant,female,1724,988765,1031212,2019977,0.0016718191797612907,Texas
9889,2011,Tarrant,female,1898,988765,1031212,2019977,0.0018405526700620242,Texas
9891,2012,Tarrant,female,1664,988765,1031212,2019977,0.001613635217588624,Texas
9893,2013,Tarrant,female,980,988765,1031212,2019977,0.0009503380488202232,Texas
9895,2014,Tarrant,female,3548,988765,1031212,2019977,0.003440611629810359,Texas
9897,2015,Tarrant,female,6338,988765,1031212,2019977,0.006146165870839362,Texas
9899,2016,Tarrant,female,5589,988765,1031212,2019977,0.005419836076383905,Texas
9901,2009,Taylor,female,3839,12414,9684,22098,0.39642709624122263,Texas
9902,2009,Taylor,female,3839,3946,4247,8193,0.9039321874264187,Texas
9903,2009,Taylor,female,3839,3168,3033,6201,1.265743488295417,Texas
9904,2009,Taylor,female,3839,12525,12975,25500,0.2958766859344894,Texas
9905,2009,Taylor,female,3839,66718,69630,136348,0.055134281200631914,Texas
9906,2009,Taylor,female,3839,8580,8371,16951,0.45860709592641263,Texas
9907,2009,Taylor,female,3839,10385,9971,20356,0.38501654798916857,Texas
9915,2010,Taylor,female,4860,12414,9684,22098,0.5018587360594795,Texas
9916,2010,Taylor,female,4860,3946,4247,8193,1.1443371791853072,Texas
9917,2010,Taylor,female,4860,3168,3033,6201,1.6023738872403561,Texas
9918,2010,Taylor,female,4860,12525,12975,25500,0.3745664739884393,Texas
9919,2010,Taylor,female,4860,66718,69630,136348,0.06979750107712193,Texas
9920,2010,Taylor,female,4860,8580,8371,16951,0.5805757973957711,Texas
9921,2010,Taylor,female,4860,10385,9971,20356,0.48741349914752785,Texas
9929,2011,Taylor,female,5976,12414,9684,22098,0.6171003717472119,Texas
9930,2011,Taylor,female,5976,3946,4247,8193,1.4071109018130445,Texas
9931,2011,Taylor,female,5976,3168,3033,6201,1.970326409495549,Texas
9932,2011,Taylor,female,5976,12525,12975,25500,0.4605780346820809,Texas
9933,2011,Taylor,female,5976,66718,69630,136348,0.08582507539853511,Texas
9934,2011,Taylor,female,5976,8580,8371,16951,0.713893202723689,Texas
9935,2011,Taylor,female,5976,10385,9971,20356,0.5993380804332564,Texas
9943,2012,Taylor,female,5919,12414,9684,22098,0.6112143742255266,Texas
9944,2012,Taylor,female,5919,3946,4247,8193,1.3936896632917353,Texas
9945,2012,Taylor,female,5919,3168,3033,6201,1.9515331355093966,Texas
9946,2012,Taylor,female,5919,12525,12975,25500,0.4561849710982659,Texas
9947,2012,Taylor,female,5919,66718,69630,136348,0.08500646273158122,Texas
9948,2012,Taylor,female,5919,8580,8371,16951,0.7070839804085534,Texas
9949,2012,Taylor,female,5919,10385,9971,20356,0.5936215023568349,Texas
9957,2013,Taylor,female,3795,12414,9684,22098,0.39188351920693926,Texas
9958,2013,Taylor,female,3795,3946,4247,8193,0.8935719331292677,Texas
9959,2013,Taylor,female,3795,3168,3033,6201,1.251236399604352,Texas
9960,2013,Taylor,female,3795,12525,12975,25500,0.292485549132948,Texas
9961,2013,Taylor,female,3795,66718,69630,136348,0.054502369668246446,Texas
9962,2013,Taylor,female,3795,8580,8371,16951,0.4533508541392904,Texas
9963,2013,Taylor,female,3795,10385,9971,20356,0.3806037508775449,Texas
9971,2014,Taylor,female,2850,12414,9684,22098,0.2942998760842627,Texas
9972,2014,Taylor,female,2850,3946,4247,8193,0.671061926065458,Texas
9973,2014,Taylor,female,2850,3168,3033,6201,0.9396636993076162,Texas
9974,2014,Taylor,female,2850,12525,12975,25500,0.21965317919075145,Texas
9975,2014,Taylor,female,2850,66718,69630,136348,0.04093063334769496,Texas
9976,2014,Taylor,female,2850,8580,8371,16951,0.34046111575677934,Texas
9977,2014,Taylor,female,2850,10385,9971,20356,0.2858289038210811,Texas
9985,2015,Taylor,female,2431,12414,9684,22098,0.2510326311441553,Texas
9986,2015,Taylor,female,2431,3946,4247,8193,0.5724040499175889,Texas
9987,2015,Taylor,female,2431,3168,3033,6201,0.8015166501813387,Texas
9988,2015,Taylor,female,2431,12525,12975,25500,0.18736030828516378,Texas
9989,2015,Taylor,female,2431,66718,69630,136348,0.034913112164296996,Texas
9990,2015,Taylor,female,2431,8580,8371,16951,0.290407358738502,Texas
9991,2015,Taylor,female,2431,10385,9971,20356,0.2438070404172099,Texas
9999,2016,Taylor,female,2984,12414,9684,22098,0.30813713341594384,Texas
10000,2016,Taylor,female,2984,3946,4247,8193,0.7026136096067812,Texas
10001,2016,Taylor,female,2984,3168,3033,6201,0.9838443785031322,Texas
10002,2016,Taylor,female,2984,12525,12975,25500,0.22998073217726397,Texas
10003,2016,Taylor,female,2984,66718,69630,136348,0.04285509119632342,Texas
10004,2016,Taylor,female,2984,8580,8371,16951,0.3564687611993788,Texas
10005,2016,Taylor,female,2984,10385,9971,20356,0.2992678768428442,Texas
10013,2009,Terrell,female,147,4228,4631,8859,0.03174260418916001,Texas
10014,2009,Terrell,female,147,429,433,862,0.3394919168591224,Texas
10017,2010,Terrell,female,83,4228,4631,8859,0.017922694882314835,Texas
10018,2010,Terrell,female,83,429,433,862,0.19168591224018475,Texas
10021,2011,Terrell,female,17,4228,4631,8859,0.0036709134096307495,Texas
10022,2011,Terrell,female,17,429,433,862,0.03926096997690531,Texas
10025,2012,Terrell,female,40,4228,4631,8859,0.008637443316778234,Texas
10026,2012,Terrell,female,40,429,433,862,0.09237875288683603,Texas
10029,2013,Terrell,female,9,4228,4631,8859,0.0019434247462751025,Texas
10030,2013,Terrell,female,9,429,433,862,0.020785219399538105,Texas
10033,2014,Terrell,female,52,4228,4631,8859,0.011228676311811703,Texas
10034,2014,Terrell,female,52,429,433,862,0.12009237875288684,Texas
10037,2015,Terrell,female,79,4228,4631,8859,0.01705895055063701,Texas
10038,2015,Terrell,female,79,429,433,862,0.18244803695150116,Texas
10041,2016,Terrell,female,132,4228,4631,8859,0.028503562945368172,Texas
10042,2016,Terrell,female,132,429,433,862,0.30484988452655887,Texas
10045,2009,Terry,female,1562,6515,6100,12615,0.25606557377049183,Texas
10047,2010,Terry,female,1721,6515,6100,12615,0.2821311475409836,Texas
10049,2011,Terry,female,1311,6515,6100,12615,0.21491803278688523,Texas
10051,2012,Terry,female,1052,6515,6100,12615,0.17245901639344263,Texas
10053,2013,Terry,female,1261,6515,6100,12615,0.20672131147540984,Texas
10055,2014,Terry,female,669,6515,6100,12615,0.10967213114754099,Texas
10057,2015,Terry,female,1082,6515,6100,12615,0.17737704918032787,Texas
10059,2016,Terry,female,790,6515,6100,12615,0.12950819672131147,Texas
10061,2009,Throckmorton,female,349,694,873,1567,0.3997709049255441,Texas
10063,2010,Throckmorton,female,479,694,873,1567,0.5486827033218786,Texas
10065,2011,Throckmorton,female,304,694,873,1567,0.34822451317296677,Texas
10067,2012,Throckmorton,female,181,694,873,1567,0.2073310423825888,Texas
10069,2013,Throckmorton,female,88,694,873,1567,0.10080183276059565,Texas
10071,2014,Throckmorton,female,109,694,873,1567,0.12485681557846506,Texas
10073,2015,Throckmorton,female,67,694,873,1567,0.07674684994272624,Texas
10075,2016,Throckmorton,female,88,694,873,1567,0.10080183276059565,Texas
10077,2009,Titus,female,4518,16046,16684,32730,0.2707983696955167,Texas
10079,2010,Titus,female,4318,16046,16684,32730,0.258810836729801,Texas
10081,2011,Titus,female,4570,16046,16684,32730,0.27391512826660275,Texas
10083,2012,Titus,female,4669,16046,16684,32730,0.279848957084632,Texas
10085,2013,Titus,female,3706,16046,16684,32730,0.2221289858547111,Texas
10087,2014,Titus,female,2904,16046,16684,32730,0.17405897866219133,Texas
10089,2015,Titus,female,2709,16046,16684,32730,0.16237113402061856,Texas
10091,2016,Titus,female,2689,16046,16684,32730,0.161172380724047,Texas
10093,2009,Tom Green,female,6224,58343,59123,117466,0.10527205994283105,Texas
10095,2010,Tom Green,female,5970,58343,59123,117466,0.1009759315325677,Texas
10097,2011,Tom Green,female,6221,58343,59123,117466,0.10522131826869408,Texas
10099,2012,Tom Green,female,3806,58343,59123,117466,0.06437427058843428,Texas
10101,2013,Tom Green,female,3079,58343,59123,117466,0.052077871555908865,Texas
10103,2014,Tom Green,female,2596,58343,59123,117466,0.04390846201985691,Texas
10105,2015,Tom Green,female,4548,58343,59123,117466,0.07692437799164453,Texas
10107,2016,Tom Green,female,3549,58343,59123,117466,0.06002740050403396,Texas
10109,2009,Travis,female,10788,607356,595810,1203166,0.018106443329249256,Texas
10111,2010,Travis,female,10053,607356,595810,1203166,0.016872828586294287,Texas
10113,2011,Travis,female,14870,607356,595810,1203166,0.02495762071801413,Texas
10115,2012,Travis,female,11859,607356,595810,1203166,0.01990399624041221,Texas
10117,2013,Travis,female,12158,607356,595810,1203166,0.020405834074621106,Texas
10119,2014,Travis,female,9726,607356,595810,1203166,0.016323995904734732,Texas
10121,2015,Travis,female,6353,607356,595810,1203166,0.01066279518638492,Texas
10123,2016,Travis,female,6616,607356,595810,1203166,0.0111042110740001,Texas
10125,2009,Trinity,female,778,6582,6280,12862,0.12388535031847134,Texas
10126,2009,Trinity,female,778,7011,7558,14569,0.10293728499603069,Texas
10129,2010,Trinity,female,411,6582,6280,12862,0.06544585987261146,Texas
10130,2010,Trinity,female,411,7011,7558,14569,0.05437946546705478,Texas
10133,2011,Trinity,female,760,6582,6280,12862,0.12101910828025478,Texas
10134,2011,Trinity,female,760,7011,7558,14569,0.10055570256681662,Texas
10137,2012,Trinity,female,633,6582,6280,12862,0.10079617834394905,Texas
10138,2012,Trinity,female,633,7011,7558,14569,0.08375231542736174,Texas
10141,2013,Trinity,female,507,6582,6280,12862,0.08073248407643312,Texas
10142,2013,Trinity,female,507,7011,7558,14569,0.06708123842286319,Texas
10145,2014,Trinity,female,701,6582,6280,12862,0.11162420382165605,Texas
10146,2014,Trinity,female,701,7011,7558,14569,0.0927494046043927,Texas
10149,2015,Trinity,female,903,6582,6280,12862,0.14378980891719745,Texas
10150,2015,Trinity,female,903,7011,7558,14569,0.1194760518655729,Texas
10153,2016,Trinity,female,528,6582,6280,12862,0.0840764331210191,Texas
10154,2016,Trinity,female,528,7011,7558,14569,0.06985975125694628,Texas
10157,2009,Tyler,female,1565,11738,9758,21496,0.1603812256609961,Texas
10158,2009,Tyler,female,1565,4437,4472,8909,0.3499552772808587,Texas
10161,2010,Tyler,female,1916,11738,9758,21496,0.19635171141627383,Texas
10162,2010,Tyler,female,1916,4437,4472,8909,0.4284436493738819,Texas
10165,2011,Tyler,female,2310,11738,9758,21496,0.23672883787661406,Texas
10166,2011,Tyler,female,2310,4437,4472,8909,0.5165474060822898,Texas
10169,2012,Tyler,female,2395,11738,9758,21496,0.2454396392703423,Texas
10170,2012,Tyler,female,2395,4437,4472,8909,0.5355545617173524,Texas
10173,2013,Tyler,female,2162,11738,9758,21496,0.22156179544988727,Texas
10174,2013,Tyler,female,2162,4437,4472,8909,0.48345259391771017,Texas
10177,2014,Tyler,female,2168,11738,9758,21496,0.2221766755482681,Texas
10178,2014,Tyler,female,2168,4437,4472,8909,0.4847942754919499,Texas
10181,2015,Tyler,female,1082,11738,9758,21496,0.11088337774134044,Texas
10182,2015,Tyler,female,1082,4437,4472,8909,0.24194991055456172,Texas
10185,2016,Tyler,female,1107,11738,9758,21496,0.1134453781512605,Texas
10186,2016,Tyler,female,1107,4437,4472,8909,0.2475402504472272,Texas
10189,2009,Upshur,female,3727,20224,20545,40769,0.18140666828912144,Texas
10190,2009,Upshur,female,3727,12200,12405,24605,0.3004433696090286,Texas
10193,2010,Upshur,female,4055,20224,20545,40769,0.19737162326600147,Texas
10194,2010,Upshur,female,4055,12200,12405,24605,0.3268843208383716,Texas
10197,2011,Upshur,female,4444,20224,20545,40769,0.21630567047943539,Texas
10198,2011,Upshur,female,4444,12200,12405,24605,0.3582426440951229,Texas
10201,2012,Upshur,female,4239,20224,20545,40769,0.20632757361888537,Texas
10202,2012,Upshur,female,4239,12200,12405,24605,0.34171704957678356,Texas
10205,2013,Upshur,female,3514,20224,20545,40769,0.17103918228279386,Texas
10206,2013,Upshur,female,3514,12200,12405,24605,0.28327287384119304,Texas
10209,2014,Upshur,female,3267,20224,20545,40769,0.15901679240691166,Texas
10210,2014,Upshur,female,3267,12200,12405,24605,0.2633615477629988,Texas
10213,2015,Upshur,female,2757,20224,20545,40769,0.13419323436359212,Texas
10214,2015,Upshur,female,2757,12200,12405,24605,0.2222490931076179,Texas
10217,2016,Upshur,female,2251,20224,20545,40769,0.10956437089316136,Texas
10218,2016,Upshur,female,2251,12200,12405,24605,0.18145908907698508,Texas
10221,2009,Upton,female,125,1843,1791,3634,0.06979341150195421,Texas
10223,2010,Upton,female,197,1843,1791,3634,0.10999441652707985,Texas
10225,2011,Upton,female,403,1843,1791,3634,0.2250139586823004,Texas
10227,2012,Upton,female,242,1843,1791,3634,0.13512004466778335,Texas
10229,2013,Upton,female,202,1843,1791,3634,0.11278615298715801,Texas
10231,2014,Upton,female,241,1843,1791,3634,0.13456169737576773,Texas
10233,2015,Upton,female,69,1843,1791,3634,0.038525963149078725,Texas
10235,2016,Upton,female,183,1843,1791,3634,0.10217755443886097,Texas
10237,2009,Uvalde,female,2835,13083,13926,27009,0.2035760448082723,Texas
10239,2010,Uvalde,female,2138,13083,13926,27009,0.15352577911819618,Texas
10241,2011,Uvalde,female,1503,13083,13926,27009,0.1079276174062904,Texas
10243,2012,Uvalde,female,1237,13083,13926,27009,0.08882665517736608,Texas
10245,2013,Uvalde,female,1377,13083,13926,27009,0.0988797931925894,Texas
10247,2014,Uvalde,female,1294,13083,13926,27009,0.09291971851213557,Texas
10249,2015,Uvalde,female,2624,13083,13926,27009,0.18842452965675716,Texas
10251,2016,Uvalde,female,2213,13083,13926,27009,0.15891138876920868,Texas
10253,2009,Val Verde,female,1813,24925,24102,49027,0.0752219732802257,Texas
10255,2010,Val Verde,female,1933,24925,24102,49027,0.08020081321052194,Texas
10257,2011,Val Verde,female,1955,24925,24102,49027,0.08111360053107626,Texas
10259,2012,Val Verde,female,1470,24925,24102,49027,0.06099078914612895,Texas
10261,2013,Val Verde,female,1192,24925,24102,49027,0.04945647664094266,Texas
10263,2014,Val Verde,female,1063,24925,24102,49027,0.0441042237158742,Texas
10265,2015,Val Verde,female,2199,24925,24102,49027,0.09123724172267862,Texas
10267,2016,Val Verde,female,1841,24925,24102,49027,0.07638370259729484,Texas
10269,2009,Van Zandt,female,6111,26619,27749,54368,0.2202241522217017,Texas
10271,2010,Van Zandt,female,5761,26619,27749,54368,0.2076110850841472,Texas
10273,2011,Van Zandt,female,7276,26619,27749,54368,0.26220764712241884,Texas
10275,2012,Van Zandt,female,6139,26619,27749,54368,0.22123319759270604,Texas
10277,2013,Van Zandt,female,6216,26619,27749,54368,0.22400807236296805,Texas
10279,2014,Van Zandt,female,4658,26619,27749,54368,0.1678619049335111,Texas
10281,2015,Van Zandt,female,3068,26619,27749,54368,0.11056254279433493,Texas
10283,2016,Van Zandt,female,4399,26619,27749,54368,0.15852823525172077,Texas
10285,2009,Victoria,female,4410,44999,46971,91970,0.09388771795363096,Texas
10287,2010,Victoria,female,3769,44999,46971,91970,0.08024099976581295,Texas
10289,2011,Victoria,female,3781,44999,46971,91970,0.08049647654936025,Texas
10291,2012,Victoria,female,2739,44999,46971,91970,0.05831257584467012,Texas
10293,2013,Victoria,female,3816,44999,46971,91970,0.08124161716803985,Texas
10295,2014,Victoria,female,4857,44999,46971,91970,0.1034042281407677,Texas
10297,2015,Victoria,female,2952,44999,46971,91970,0.06284728875263461,Texas
10299,2016,Victoria,female,2543,44999,46971,91970,0.054139788380064294,Texas
10301,2009,Walker,female,4518,31506,32987,64493,0.13696304604844334,Texas
10302,2009,Walker,female,4518,34082,34742,68824,0.13004432675148236,Texas
10303,2009,Walker,female,4518,41642,29897,71539,0.15111884135531994,Texas
10307,2010,Walker,female,6571,31506,32987,64493,0.19919968472428531,Texas
10308,2010,Walker,female,6571,34082,34742,68824,0.189137067526337,Texas
10309,2010,Walker,female,6571,41642,29897,71539,0.2197879385891561,Texas
10313,2011,Walker,female,6950,31506,32987,64493,0.2106890593264013,Texas
10314,2011,Walker,female,6950,34082,34742,68824,0.20004605376777387,Texas
10315,2011,Walker,female,6950,41642,29897,71539,0.23246479579890958,Texas
10319,2012,Walker,female,5673,31506,32987,64493,0.17197683936096037,Texas
10320,2012,Walker,female,5673,34082,34742,68824,0.1632893903632491,Texas
10321,2012,Walker,female,5673,41642,29897,71539,0.18975148008161355,Texas
10325,2013,Walker,female,4654,31506,32987,64493,0.1410858823172765,Texas
10326,2013,Walker,female,4654,34082,34742,68824,0.13395889701226182,Texas
10327,2013,Walker,female,4654,41642,29897,71539,0.15566779275512593,Texas
10331,2014,Walker,female,3438,31506,32987,64493,0.10422287567829751,Texas
10332,2014,Walker,female,3438,34082,34742,68824,0.09895803350411606,Texas
10333,2014,Walker,female,3438,41642,29897,71539,0.1149948155333311,Texas
10337,2015,Walker,female,3817,31506,32987,64493,0.1157122502804135,Texas
10338,2015,Walker,female,3817,34082,34742,68824,0.10986701974555294,Texas
10339,2015,Walker,female,3817,41642,29897,71539,0.12767167274308458,Texas
10343,2016,Walker,female,3413,31506,32987,64493,0.10346500136417376,Texas
10344,2016,Walker,female,3413,34082,34742,68824,0.09823844338264924,Texas
10345,2016,Walker,female,3413,41642,29897,71539,0.11415861123189618,Texas
10349,2009,Waller,female,4103,24869,25118,49987,0.16334899275420017,Texas
10351,2010,Waller,female,4377,24869,25118,49987,0.17425750457839,Texas
10353,2011,Waller,female,3438,24869,25118,49987,0.13687395493271756,Texas
10355,2012,Waller,female,3899,24869,25118,49987,0.1552273270164822,Texas
10357,2013,Waller,female,2875,24869,25118,49987,0.11445974998009395,Texas
10359,2014,Waller,female,2148,24869,25118,49987,0.08551636276773629,Texas
10361,2015,Waller,female,1894,24869,25118,49987,0.07540409268253842,Texas
10363,2016,Waller,female,1838,24869,25118,49987,0.07317461581336093,Texas
10365,2009,Ward,female,2017,35881,33153,69034,0.060839139746026,Texas
10366,2009,Ward,female,2017,5864,5722,11586,0.35249912617965745,Texas
10369,2010,Ward,female,1874,35881,33153,69034,0.0565258046029017,Texas
10370,2010,Ward,female,1874,5864,5722,11586,0.3275078643830828,Texas
10373,2011,Ward,female,2248,35881,33153,69034,0.0678068349772268,Texas
10374,2011,Ward,female,2248,5864,5722,11586,0.3928696260048934,Texas
10377,2012,Ward,female,1254,35881,33153,69034,0.03782463125509004,Texas
10378,2012,Ward,female,1254,5864,5722,11586,0.21915414190842364,Texas
10381,2013,Ward,female,722,35881,33153,69034,0.02177781799535487,Texas
10382,2013,Ward,female,722,5864,5722,11586,0.12617965746242574,Texas
10385,2014,Ward,female,577,35881,33153,69034,0.017404156486592465,Texas
10386,2014,Ward,female,577,5864,5722,11586,0.10083886752883607,Texas
10389,2015,Ward,female,430,35881,33153,69034,0.01297016861219196,Texas
10390,2015,Ward,female,430,5864,5722,11586,0.07514854945823139,Texas
10393,2016,Ward,female,805,35881,33153,69034,0.02428136216933611,Texas
10394,2016,Ward,female,805,5864,5722,11586,0.14068507514854947,Texas
10397,2009,Washington,female,2795,8420,8223,16643,0.3399002797032713,Texas
10398,2009,Washington,female,2795,114181,114348,228529,0.02444292860391087,Texas
10399,2009,Washington,female,2795,2510,2330,4840,1.1995708154506437,Texas
10400,2009,Washington,female,2795,13231,11335,24566,0.24658138509042787,Texas
10401,2009,Washington,female,2795,10361,10100,20461,0.27673267326732676,Texas
10402,2009,Washington,female,2795,4966,5059,10025,0.5524807274164855,Texas
10403,2009,Washington,female,2795,7108,7047,14155,0.3966226763161629,Texas
10404,2009,Washington,female,2795,13892,13935,27827,0.2005740940078938,Texas
10405,2009,Washington,female,2795,11075,11068,22143,0.2525298156848573,Texas
10406,2009,Washington,female,2795,2844,2681,5525,1.0425214472211861,Texas
10407,2009,Washington,female,2795,5865,6154,12019,0.4541761455963601,Texas
10408,2009,Washington,female,2795,22963,23494,46457,0.11896654464969779,Texas
10409,2009,Washington,female,2795,15614,16080,31694,0.173818407960199,Texas
10410,2009,Washington,female,2795,76098,73713,149811,0.037917328015411124,Texas
10411,2009,Washington,female,2795,125332,127985,253317,0.021838496698831894,Texas
10412,2009,Washington,female,2795,22018,25068,47086,0.11149672889739907,Texas
10413,2009,Washington,female,2795,12835,12096,24931,0.2310681216931217,Texas
10414,2009,Washington,female,2795,9911,10308,20219,0.2711486224291812,Texas
10415,2009,Washington,female,2795,32002,29826,61828,0.09371018574398177,Texas
10416,2009,Washington,female,2795,5726,6430,12156,0.43468118195956457,Texas
10417,2009,Washington,female,2795,29953,30718,60671,0.09098899667947132,Texas
10418,2009,Washington,female,2795,25253,26748,52001,0.10449379392851801,Texas
10419,2009,Washington,female,2795,287522,294299,581821,0.009497144060972004,Texas
10420,2009,Washington,female,2795,101709,105838,207547,0.026408284359114874,Texas
10421,2009,Washington,female,2795,61110,65132,126242,0.04291285389670208,Texas
10422,2009,Washington,female,2795,61851,65204,127055,0.04286546837617324,Texas
10423,2009,Washington,female,2795,17259,17537,34796,0.15937731653076354,Texas
10424,2009,Washington,female,2795,79500,81037,160537,0.034490417957229416,Texas
10425,2009,Washington,female,2795,28816,29661,58477,0.09423148241798995,Texas
10426,2009,Washington,female,2795,26851,27555,54406,0.10143349664307748,Texas
10427,2009,Washington,female,2795,66754,67781,134535,0.04123574453017807,Texas
10459,2010,Washington,female,2923,8420,8223,16643,0.3554663748023836,Texas
10460,2010,Washington,female,2923,114181,114348,228529,0.025562318536397663,Texas
10461,2010,Washington,female,2923,2510,2330,4840,1.2545064377682404,Texas
10462,2010,Washington,female,2923,13231,11335,24566,0.2578738420820468,Texas
10463,2010,Washington,female,2923,10361,10100,20461,0.2894059405940594,Texas
10464,2010,Washington,female,2923,4966,5059,10025,0.577782170389405,Texas
10465,2010,Washington,female,2923,7108,7047,14155,0.41478643394352205,Texas
10466,2010,Washington,female,2923,13892,13935,27827,0.20975959813419448,Texas
10467,2010,Washington,female,2923,11075,11068,22143,0.2640946873870618,Texas
10468,2010,Washington,female,2923,2844,2681,5525,1.0902648265572548,Texas
10469,2010,Washington,female,2923,5865,6154,12019,0.47497562560935974,Texas
10470,2010,Washington,female,2923,22963,23494,46457,0.12441474419000596,Texas
10471,2010,Washington,female,2923,15614,16080,31694,0.18177860696517412,Texas
10472,2010,Washington,female,2923,76098,73713,149811,0.039653792411107947,Texas
10473,2010,Washington,female,2923,125332,127985,253317,0.022838613900066414,Texas
10474,2010,Washington,female,2923,22018,25068,47086,0.11660284027445349,Texas
10475,2010,Washington,female,2923,12835,12096,24931,0.24165013227513227,Texas
10476,2010,Washington,female,2923,9911,10308,20219,0.2835661622041133,Texas
10477,2010,Washington,female,2923,32002,29826,61828,0.09800174344531616,Texas
10478,2010,Washington,female,2923,5726,6430,12156,0.4545878693623639,Texas
10479,2010,Washington,female,2923,29953,30718,60671,0.09515593463116089,Texas
10480,2010,Washington,female,2923,25253,26748,52001,0.10927919844474353,Texas
10481,2010,Washington,female,2923,287522,294299,581821,0.009932075882011152,Texas
10482,2010,Washington,female,2923,101709,105838,207547,0.027617679850337307,Texas
10483,2010,Washington,female,2923,61110,65132,126242,0.044878093717373946,Texas
10484,2010,Washington,female,2923,61851,65204,127055,0.04482853812649531,Texas
10485,2010,Washington,female,2923,17259,17537,34796,0.16667617038261962,Texas
10486,2010,Washington,female,2923,79500,81037,160537,0.03606994335920629,Texas
10487,2010,Washington,female,2923,28816,29661,58477,0.09854691345537912,Texas
10488,2010,Washington,female,2923,26851,27555,54406,0.10607875158773362,Texas
10489,2010,Washington,female,2923,66754,67781,134535,0.04312417934229356,Texas
10521,2011,Washington,female,2575,8420,8223,16643,0.31314605375167215,Texas
10522,2011,Washington,female,2575,114181,114348,228529,0.02251897715744919,Texas
10523,2011,Washington,female,2575,2510,2330,4840,1.1051502145922747,Texas
10524,2011,Washington,female,2575,13231,11335,24566,0.22717247463608292,Texas
10525,2011,Washington,female,2575,10361,10100,20461,0.25495049504950495,Texas
10526,2011,Washington,female,2575,4966,5059,10025,0.50899387230678,Texas
10527,2011,Washington,female,2575,7108,7047,14155,0.36540371789413933,Texas
10528,2011,Washington,female,2575,13892,13935,27827,0.18478650879081449,Texas
10529,2011,Washington,female,2575,11075,11068,22143,0.23265269244669318,Texas
10530,2011,Washington,female,2575,2844,2681,5525,0.9604625139873182,Texas
10531,2011,Washington,female,2575,5865,6154,12019,0.4184270393240169,Texas
10532,2011,Washington,female,2575,22963,23494,46457,0.10960245168979314,Texas
10533,2011,Washington,female,2575,15614,16080,31694,0.16013681592039802,Texas
10534,2011,Washington,female,2575,76098,73713,149811,0.0349327798353072,Texas
10535,2011,Washington,female,2575,125332,127985,253317,0.020119545259210062,Texas
10536,2011,Washington,female,2575,22018,25068,47086,0.1027205999680868,Texas
10537,2011,Washington,female,2575,12835,12096,24931,0.21288029100529102,Texas
10538,2011,Washington,female,2575,9911,10308,20219,0.2498059759410167,Texas
10539,2011,Washington,female,2575,32002,29826,61828,0.08633407094481325,Texas
10540,2011,Washington,female,2575,5726,6430,12156,0.4004665629860031,Texas
10541,2011,Washington,female,2575,29953,30718,60671,0.08382707207500488,Texas
10542,2011,Washington,female,2575,25253,26748,52001,0.09626887991625542,Texas
10543,2011,Washington,female,2575,287522,294299,581821,0.00874960499356097,Texas
10544,2011,Washington,female,2575,101709,105838,207547,0.024329635858576316,Texas
10545,2011,Washington,female,2575,61110,65132,126242,0.03953509795492231,Texas
10546,2011,Washington,female,2575,61851,65204,127055,0.03949144224280719,Texas
10547,2011,Washington,female,2575,17259,17537,34796,0.1468324114728859,Texas
10548,2011,Washington,female,2575,79500,81037,160537,0.03177560867258166,Texas
10549,2011,Washington,female,2575,28816,29661,58477,0.08681433532247733,Texas
10550,2011,Washington,female,2575,26851,27555,54406,0.09344946470694973,Texas
10551,2011,Washington,female,2575,66754,67781,134535,0.03798999719685458,Texas
10583,2012,Washington,female,1643,8420,8223,16643,0.1998054238112611,Texas
10584,2012,Washington,female,1643,114181,114348,228529,0.014368419211529716,Texas
10585,2012,Washington,female,1643,2510,2330,4840,0.7051502145922747,Texas
10586,2012,Washington,female,1643,13231,11335,24566,0.14494927216585796,Texas
10587,2012,Washington,female,1643,10361,10100,20461,0.16267326732673268,Texas
10588,2012,Washington,female,1643,4966,5059,10025,0.3247677406602095,Texas
10589,2012,Washington,female,1643,7108,7047,14155,0.23314885766993046,Texas
10590,2012,Washington,female,1643,13892,13935,27827,0.11790455687118766,Texas
10591,2012,Washington,female,1643,11075,11068,22143,0.14844597036501625,Texas
10592,2012,Washington,female,1643,2844,2681,5525,0.6128310331965684,Texas
10593,2012,Washington,female,1643,5865,6154,12019,0.266980825479363,Texas
10594,2012,Washington,female,1643,22963,23494,46457,0.06993274878692432,Texas
10595,2012,Washington,female,1643,15614,16080,31694,0.10217661691542289,Texas
10596,2012,Washington,female,1643,76098,73713,149811,0.022289148454139703,Texas
10597,2012,Washington,female,1643,125332,127985,253317,0.012837441887721217,Texas
10598,2012,Washington,female,1643,22018,25068,47086,0.06554172650390937,Texas
10599,2012,Washington,female,1643,12835,12096,24931,0.13583002645502645,Texas
10600,2012,Washington,female,1643,9911,10308,20219,0.1593907644547924,Texas
10601,2012,Washington,female,1643,32002,29826,61828,0.0550861664319721,Texas
10602,2012,Washington,female,1643,5726,6430,12156,0.2555209953343701,Texas
10603,2012,Washington,female,1643,29953,30718,60671,0.053486555114265255,Texas
10604,2012,Washington,female,1643,25253,26748,52001,0.06142515328248841,Texas
10605,2012,Washington,female,1643,287522,294299,581821,0.005582757671619679,Texas
10606,2012,Washington,female,1643,101709,105838,207547,0.015523724938112965,Texas
10607,2012,Washington,female,1643,61110,65132,126242,0.025225695510655285,Texas
10608,2012,Washington,female,1643,61851,65204,127055,0.025197840623274646,Texas
10609,2012,Washington,female,1643,17259,17537,34796,0.09368763186405885,Texas
10610,2012,Washington,female,1643,79500,81037,160537,0.020274689339437543,Texas
10611,2012,Washington,female,1643,28816,29661,58477,0.055392603081487475,Texas
10612,2012,Washington,female,1643,26851,27555,54406,0.0596262021411722,Texas
10613,2012,Washington,female,1643,66754,67781,134535,0.024239831221138666,Texas
10645,2013,Washington,female,1615,8420,8223,16643,0.1964003405083303,Texas
10646,2013,Washington,female,1615,114181,114348,228529,0.01412355266379823,Texas
10647,2013,Washington,female,1615,2510,2330,4840,0.6931330472103004,Texas
10648,2013,Washington,female,1615,13231,11335,24566,0.14247904719894133,Texas
10649,2013,Washington,female,1615,10361,10100,20461,0.1599009900990099,Texas
10650,2013,Washington,female,1615,4966,5059,10025,0.3192330500098834,Texas
10651,2013,Washington,female,1615,7108,7047,14155,0.22917553568894566,Texas
10652,2013,Washington,female,1615,13892,13935,27827,0.11589522784355938,Texas
10653,2013,Washington,female,1615,11075,11068,22143,0.145916154680159,Texas
10654,2013,Washington,female,1615,2844,2681,5525,0.6023871689668034,Texas
10655,2013,Washington,female,1615,5865,6154,12019,0.26243093922651933,Texas
10656,2013,Washington,female,1615,22963,23494,46457,0.06874095513748191,Texas
10657,2013,Washington,female,1615,15614,16080,31694,0.10043532338308457,Texas
10658,2013,Washington,female,1615,76098,73713,149811,0.021909296867581023,Texas
10659,2013,Washington,female,1615,125332,127985,253317,0.012618666249951166,Texas
10660,2013,Washington,female,1615,22018,25068,47086,0.06442476464017871,Texas
10661,2013,Washington,female,1615,12835,12096,24931,0.13351521164021163,Texas
10662,2013,Washington,female,1615,9911,10308,20219,0.156674427629026,Texas
10663,2013,Washington,female,1615,32002,29826,61828,0.054147388184805204,Texas
10664,2013,Washington,female,1615,5726,6430,12156,0.2511664074650078,Texas
10665,2013,Washington,female,1615,29953,30718,60671,0.05257503743733316,Texas
10666,2013,Washington,female,1615,25253,26748,52001,0.06037834604456408,Texas
10667,2013,Washington,female,1615,287522,294299,581821,0.005487616335767366,Texas
10668,2013,Washington,female,1615,101709,105838,207547,0.015259169674408058,Texas
10669,2013,Washington,female,1615,61110,65132,126242,0.024795799299883313,Texas
10670,2013,Washington,female,1615,61851,65204,127055,0.024768419115391693,Texas
10671,2013,Washington,female,1615,17259,17537,34796,0.09209100758396534,Texas
10672,2013,Washington,female,1615,79500,81037,160537,0.0199291681577551,Texas
10673,2013,Washington,female,1615,28816,29661,58477,0.0544486025420586,Texas
10674,2013,Washington,female,1615,26851,27555,54406,0.05861005262202867,Texas
10675,2013,Washington,female,1615,66754,67781,134535,0.023826736105988403,Texas
10707,2014,Washington,female,811,8420,8223,16643,0.0986258056670315,Texas
10708,2014,Washington,female,811,114181,114348,228529,0.007092384650365551,Texas
10709,2014,Washington,female,811,2510,2330,4840,0.348068669527897,Texas
10710,2014,Washington,female,811,13231,11335,24566,0.07154830172033524,Texas
10711,2014,Washington,female,811,10361,10100,20461,0.0802970297029703,Texas
10712,2014,Washington,female,811,4966,5059,10025,0.16030836133623247,Texas
10713,2014,Washington,female,811,7108,7047,14155,0.11508443309209593,Texas
10714,2014,Washington,female,811,13892,13935,27827,0.058198780050233226,Texas
10715,2014,Washington,female,811,11075,11068,22143,0.07327430430068667,Texas
10716,2014,Washington,female,811,2844,2681,5525,0.30249906751212235,Texas
10717,2014,Washington,female,811,5865,6154,12019,0.13178420539486513,Texas
10718,2014,Washington,female,811,22963,23494,46457,0.03451945177492126,Texas
10719,2014,Washington,female,811,15614,16080,31694,0.050435323383084575,Texas
10720,2014,Washington,female,811,76098,73713,149811,0.011002129882110348,Texas
10721,2014,Washington,female,811,125332,127985,253317,0.006336680079696839,Texas
10722,2014,Washington,female,811,22018,25068,47086,0.03235200255305569,Texas
10723,2014,Washington,female,811,12835,12096,24931,0.06704695767195767,Texas
10724,2014,Washington,female,811,9911,10308,20219,0.07867675591773379,Texas
10725,2014,Washington,female,811,32002,29826,61828,0.027191041373298464,Texas
10726,2014,Washington,female,811,5726,6430,12156,0.12612752721617418,Texas
10727,2014,Washington,female,811,29953,30718,60671,0.026401458428283092,Texas
10728,2014,Washington,female,811,25253,26748,52001,0.03032002392702258,Texas
10729,2014,Washington,female,811,287522,294299,581821,0.002755700834865222,Texas
10730,2014,Washington,female,811,101709,105838,207547,0.007662654245167142,Texas
10731,2014,Washington,female,811,61110,65132,126242,0.012451636676288153,Texas
10732,2014,Washington,female,811,61851,65204,127055,0.012437887246181216,Texas
10733,2014,Washington,female,811,17259,17537,34796,0.046245081826994355,Texas
10734,2014,Washington,female,811,79500,81037,160537,0.010007774226587855,Texas
10735,2014,Washington,female,811,28816,29661,58477,0.027342301338457907,Texas
10736,2014,Washington,female,811,26851,27555,54406,0.029432045000907275,Texas
10737,2014,Washington,female,811,66754,67781,134535,0.011965004942387985,Texas
10769,2015,Washington,female,742,8420,8223,16643,0.0902347075276663,Texas
10770,2015,Washington,female,742,114181,114348,228529,0.006488963514884388,Texas
10771,2015,Washington,female,742,2510,2330,4840,0.3184549356223176,Texas
10772,2015,Washington,female,742,13231,11335,24566,0.0654609616232907,Texas
10773,2015,Washington,female,742,10361,10100,20461,0.07346534653465346,Texas
10774,2015,Washington,female,742,4966,5059,10025,0.14666930223364302,Texas
10775,2015,Washington,female,742,7108,7047,14155,0.10529303249609763,Texas
10776,2015,Washington,female,742,13892,13935,27827,0.053247219232149264,Texas
10777,2015,Washington,female,742,11075,11068,22143,0.06704011564871702,Texas
10778,2015,Washington,female,742,2844,2681,5525,0.27676240208877284,Texas
10779,2015,Washington,female,742,5865,6154,12019,0.12057198570035749,Texas
10780,2015,Washington,female,742,22963,23494,46457,0.031582531710223884,Texas
10781,2015,Washington,female,742,15614,16080,31694,0.046144278606965176,Texas
10782,2015,Washington,female,742,76098,73713,149811,0.010066067043805027,Texas
10783,2015,Washington,female,742,125332,127985,253317,0.005797554400906357,Texas
10784,2015,Washington,female,742,22018,25068,47086,0.029599489388862296,Texas
10785,2015,Washington,female,742,12835,12096,24931,0.061342592592592594,Texas
10786,2015,Washington,female,742,9911,10308,20219,0.07198292588280947,Texas
10787,2015,Washington,female,742,32002,29826,61828,0.024877623549922886,Texas
10788,2015,Washington,female,742,5726,6430,12156,0.11539657853810265,Texas
10789,2015,Washington,female,742,29953,30718,60671,0.024155218438700436,Texas
10790,2015,Washington,female,742,25253,26748,52001,0.027740391804994765,Texas
10791,2015,Washington,female,742,287522,294299,581821,0.0025212454000863066,Texas
10792,2015,Washington,female,742,101709,105838,207547,0.007010714488180049,Texas
10793,2015,Washington,female,742,61110,65132,126242,0.011392249585457224,Texas
10794,2015,Washington,female,742,61851,65204,127055,0.011379669958898227,Texas
10795,2015,Washington,female,742,17259,17537,34796,0.04231054342247819,Texas
10796,2015,Washington,female,742,79500,81037,160537,0.009156311314584695,Texas
10797,2015,Washington,female,742,28816,29661,58477,0.025016014294865312,Texas
10798,2015,Washington,female,742,26851,27555,54406,0.026927962257303574,Texas
10799,2015,Washington,female,742,66754,67781,134535,0.010947020551481978,Texas
10831,2016,Washington,female,1251,8420,8223,16643,0.15213425757022983,Texas
10832,2016,Washington,female,1251,114181,114348,228529,0.010940287543288907,Texas
10833,2016,Washington,female,1251,2510,2330,4840,0.5369098712446352,Texas
10834,2016,Washington,female,1251,13231,11335,24566,0.11036612262902515,Texas
10835,2016,Washington,female,1251,10361,10100,20461,0.12386138613861386,Texas
10836,2016,Washington,female,1251,4966,5059,10025,0.2472820715556434,Texas
10837,2016,Washington,female,1251,7108,7047,14155,0.17752234993614305,Texas
10838,2016,Washington,female,1251,13892,13935,27827,0.08977395048439182,Texas
10839,2016,Washington,female,1251,11075,11068,22143,0.11302855077701482,Texas
10840,2016,Washington,female,1251,2844,2681,5525,0.46661693397985826,Texas
10841,2016,Washington,female,1251,5865,6154,12019,0.2032824179395515,Texas
10842,2016,Washington,female,1251,22963,23494,46457,0.05324763769473057,Texas
10843,2016,Washington,female,1251,15614,16080,31694,0.07779850746268657,Texas
10844,2016,Washington,female,1251,76098,73713,149811,0.01697122624231818,Texas
10845,2016,Washington,female,1251,125332,127985,253317,0.0097745829589405,Texas
10846,2016,Washington,female,1251,22018,25068,47086,0.04990426041168023,Texas
10847,2016,Washington,female,1251,12835,12096,24931,0.10342261904761904,Texas
10848,2016,Washington,female,1251,9911,10308,20219,0.12136204889406287,Texas
10849,2016,Washington,female,1251,32002,29826,61828,0.041943270971635485,Texas
10850,2016,Washington,female,1251,5726,6430,12156,0.19455676516329704,Texas
10851,2016,Washington,female,1251,29953,30718,60671,0.04072530763721596,Texas
10852,2016,Washington,female,1251,25253,26748,52001,0.04676985195154778,Texas
10853,2016,Washington,female,1251,287522,294299,581821,0.004250778969687291,Texas
10854,2016,Washington,female,1251,101709,105838,207547,0.01181995124624426,Texas
10855,2016,Washington,female,1251,61110,65132,126242,0.019207148559847693,Texas
10856,2016,Washington,female,1251,61851,65204,127055,0.01918593951291332,Texas
10857,2016,Washington,female,1251,17259,17537,34796,0.07133489194274961,Texas
10858,2016,Washington,female,1251,79500,81037,160537,0.015437392795883362,Texas
10859,2016,Washington,female,1251,28816,29661,58477,0.04217659552948316,Texas
10860,2016,Washington,female,1251,26851,27555,54406,0.045400108873162766,Texas
10861,2016,Washington,female,1251,66754,67781,134535,0.01845649960903498,Texas
10893,2009,Webb,female,6580,132906,139147,272053,0.047288119758241286,Texas
10895,2010,Webb,female,9206,132906,139147,272053,0.06616024779549685,Texas
10897,2011,Webb,female,7294,132906,139147,272053,0.05241938381711427,Texas
10899,2012,Webb,female,8047,132906,139147,272053,0.057830927005253434,Texas
10901,2013,Webb,female,5690,132906,139147,272053,0.040892006295500445,Texas
10903,2014,Webb,female,4702,132906,139147,272053,0.033791601687424094,Texas
10905,2015,Webb,female,6045,132906,139147,272053,0.04344326503625662,Texas
10907,2016,Webb,female,5303,132906,139147,272053,0.0381107749358592,Texas
10909,2009,Wharton,female,3800,20395,21156,41551,0.17961807525051995,Texas
10911,2010,Wharton,female,3349,20395,21156,41551,0.1583002457931556,Texas
10913,2011,Wharton,female,3950,20395,21156,41551,0.18670826243146152,Texas
10915,2012,Wharton,female,2708,20395,21156,41551,0.12800151257326528,Texas
10917,2013,Wharton,female,2299,20395,21156,41551,0.10866893552656456,Texas
10919,2014,Wharton,female,1728,20395,21156,41551,0.08167895632444697,Texas
10921,2015,Wharton,female,1329,20395,21156,41551,0.06281905842314237,Texas
10923,2016,Wharton,female,1735,20395,21156,41551,0.08200983172622424,Texas
10925,2009,Wheeler,female,1569,5007,2932,7939,0.5351296043656207,Texas
10926,2009,Wheeler,female,1569,435,387,822,4.054263565891473,Texas
10927,2009,Wheeler,female,1569,728,698,1426,2.2478510028653296,Texas
10928,2009,Wheeler,female,1569,2844,2638,5482,0.5947687642153147,Texas
10933,2010,Wheeler,female,1725,5007,2932,7939,0.5883356070941337,Texas
10934,2010,Wheeler,female,1725,435,387,822,4.457364341085271,Texas
10935,2010,Wheeler,female,1725,728,698,1426,2.4713467048710602,Texas
10936,2010,Wheeler,female,1725,2844,2638,5482,0.653904473085671,Texas
10941,2011,Wheeler,female,1175,5007,2932,7939,0.40075034106412005,Texas
10942,2011,Wheeler,female,1175,435,387,822,3.0361757105943155,Texas
10943,2011,Wheeler,female,1175,728,698,1426,1.683381088825215,Texas
10944,2011,Wheeler,female,1175,2844,2638,5482,0.44541319181197875,Texas
10949,2012,Wheeler,female,1130,5007,2932,7939,0.38540245566166437,Texas
10950,2012,Wheeler,female,1130,435,387,822,2.9198966408268734,Texas
10951,2012,Wheeler,female,1130,728,698,1426,1.6189111747851004,Texas
10952,2012,Wheeler,female,1130,2844,2638,5482,0.42835481425322214,Texas
10957,2013,Wheeler,female,1224,5007,2932,7939,0.417462482946794,Texas
10958,2013,Wheeler,female,1224,435,387,822,3.1627906976744184,Texas
10959,2013,Wheeler,female,1224,728,698,1426,1.7535816618911175,Texas
10960,2013,Wheeler,female,1224,2844,2638,5482,0.46398786959818045,Texas
10965,2014,Wheeler,female,1355,5007,2932,7939,0.4621418826739427,Texas
10966,2014,Wheeler,female,1355,435,387,822,3.501291989664083,Texas
10967,2014,Wheeler,female,1355,728,698,1426,1.9412607449856734,Texas
10968,2014,Wheeler,female,1355,2844,2638,5482,0.5136467020470054,Texas
10973,2015,Wheeler,female,1347,5007,2932,7939,0.45941336971350616,Texas
10974,2015,Wheeler,female,1347,435,387,822,3.4806201550387597,Texas
10975,2015,Wheeler,female,1347,728,698,1426,1.9297994269340975,Texas
10976,2015,Wheeler,female,1347,2844,2638,5482,0.5106141015921153,Texas
10981,2016,Wheeler,female,1016,5007,2932,7939,0.34652114597544337,Texas
10982,2016,Wheeler,female,1016,435,387,822,2.6253229974160206,Texas
10983,2016,Wheeler,female,1016,728,698,1426,1.4555873925501432,Texas
10984,2016,Wheeler,female,1016,2844,2638,5482,0.38514025777103866,Texas
10989,2009,Wichita,female,3519,1019,1124,2143,3.130782918149466,Texas
10990,2009,Wichita,female,3519,68325,63493,131818,0.05542343250437056,Texas
10993,2010,Wichita,female,3664,1019,1124,2143,3.2597864768683276,Texas
10994,2010,Wichita,female,3664,68325,63493,131818,0.05770714881955491,Texas
10997,2011,Wichita,female,3387,1019,1124,2143,3.013345195729537,Texas
10998,2011,Wichita,female,3387,68325,63493,131818,0.05334446316916826,Texas
11001,2012,Wichita,female,3470,1019,1124,2143,3.087188612099644,Texas
11002,2012,Wichita,female,3470,68325,63493,131818,0.05465169388751516,Texas
11005,2013,Wichita,female,3124,1019,1124,2143,2.7793594306049823,Texas
11006,2013,Wichita,female,3124,68325,63493,131818,0.04920227426645457,Texas
11009,2014,Wichita,female,2523,1019,1124,2143,2.244661921708185,Texas
11010,2014,Wichita,female,2523,68325,63493,131818,0.039736663884207706,Texas
11013,2015,Wichita,female,2493,1019,1124,2143,2.2179715302491103,Texas
11014,2015,Wichita,female,2493,68325,63493,131818,0.03926417085347991,Texas
11017,2016,Wichita,female,2697,1019,1124,2143,2.3994661921708187,Texas
11018,2016,Wichita,female,2697,68325,63493,131818,0.04247712346242893,Texas
11021,2009,Wilbarger,female,2189,6347,6559,12906,0.3337398993749047,Texas
11023,2010,Wilbarger,female,2971,6347,6559,12906,0.4529653910657112,Texas
11025,2011,Wilbarger,female,3214,6347,6559,12906,0.49001372160390305,Texas
11027,2012,Wilbarger,female,2737,6347,6559,12906,0.41728922091782283,Texas
11029,2013,Wilbarger,female,2348,6347,6559,12906,0.3579813996035981,Texas
11031,2014,Wilbarger,female,1599,6347,6559,12906,0.24378716267723738,Texas
11033,2015,Wilbarger,female,1096,6347,6559,12906,0.16709864308583625,Texas
11035,2016,Wilbarger,female,1979,6347,6559,12906,0.3017228236011587,Texas
11037,2009,Willacy,female,4893,11681,10073,21754,0.4857539958304378,Texas
11039,2010,Willacy,female,4124,11681,10073,21754,0.4094112975280453,Texas
11041,2011,Willacy,female,3693,11681,10073,21754,0.3666236473741686,Texas
11043,2012,Willacy,female,3831,11681,10073,21754,0.38032363744663955,Texas
11045,2013,Willacy,female,3431,11681,10073,21754,0.3406135212945498,Texas
11047,2014,Willacy,female,2080,11681,10073,21754,0.20649260399086666,Texas
11049,2015,Willacy,female,1559,11681,10073,21754,0.15477017770276977,Texas
11051,2016,Willacy,female,1468,11681,10073,21754,0.14573612627816937,Texas
11053,2009,Williamson,female,12923,33607,33692,67299,0.38356286358779534,Texas
11054,2009,Williamson,female,12923,107021,111627,218648,0.1157694822937103,Texas
11055,2009,Williamson,female,12923,259443,267614,527057,0.04828970083777381,Texas
11059,2010,Williamson,female,13572,33607,33692,67299,0.4028255965807907,Texas
11060,2010,Williamson,female,13572,107021,111627,218648,0.1215834878658389,Texas
11061,2010,Williamson,female,13572,259443,267614,527057,0.05071483554672027,Texas
11065,2011,Williamson,female,15571,33607,33692,67299,0.4621571886501247,Texas
11066,2011,Williamson,female,15571,107021,111627,218648,0.13949134170048466,Texas
11067,2011,Williamson,female,15571,259443,267614,527057,0.05818454938829807,Texas
11071,2012,Williamson,female,12843,33607,33692,67299,0.3811884126795678,Texas
11072,2012,Williamson,female,12843,107021,111627,218648,0.11505280980407966,Texas
11073,2012,Williamson,female,12843,259443,267614,527057,0.04799076281509936,Texas
11077,2013,Williamson,female,9337,33607,33692,67299,0.27712810162649887,Texas
11078,2013,Williamson,female,9337,107021,111627,218648,0.08364463794601665,Texas
11079,2013,Williamson,female,9337,259443,267614,527057,0.03488980397139163,Texas
11083,2014,Williamson,female,8668,33607,33692,67299,0.25727175590644663,Texas
11084,2014,Williamson,female,8668,107021,111627,218648,0.07765146425148038,Texas
11085,2014,Williamson,female,8668,259443,267614,527057,0.03238993475677655,Texas
11089,2015,Williamson,female,5443,33607,33692,67299,0.16155170366852664,Texas
11090,2015,Williamson,female,5443,107021,111627,218648,0.048760604513245,Texas
11091,2015,Williamson,female,5443,259443,267614,527057,0.020338995717712825,Texas
11095,2016,Williamson,female,4526,33607,33692,67299,0.13433456013296924,Texas
11096,2016,Williamson,female,4526,107021,111627,218648,0.040545746100853736,Texas
11097,2016,Williamson,female,4526,259443,267614,527057,0.016912418632806955,Texas
11101,2009,Wilson,female,2599,4318,4462,8780,0.5824742268041238,Texas
11102,2009,Wilson,female,2599,38362,42974,81336,0.06047842881742449,Texas
11103,2009,Wilson,female,2599,65056,67607,132663,0.03844276480246128,Texas
11104,2009,Wilson,female,2599,24197,24001,48198,0.10828715470188742,Texas
11109,2010,Wilson,female,3240,4318,4462,8780,0.7261317794710892,Texas
11110,2010,Wilson,female,3240,38362,42974,81336,0.07539442453576581,Texas
11111,2010,Wilson,female,3240,65056,67607,132663,0.04792403153519606,Texas
11112,2010,Wilson,female,3240,24197,24001,48198,0.13499437523436522,Texas
11117,2011,Wilson,female,2500,4318,4462,8780,0.5602868668758404,Texas
11118,2011,Wilson,female,2500,38362,42974,81336,0.058174710289942755,Texas
11119,2011,Wilson,female,2500,65056,67607,132663,0.0369784193944414,Texas
11120,2011,Wilson,female,2500,24197,24001,48198,0.10416232656972627,Texas
11125,2012,Wilson,female,2597,4318,4462,8780,0.582025997310623,Texas
11126,2012,Wilson,female,2597,38362,42974,81336,0.060431889049192535,Texas
11127,2012,Wilson,female,2597,65056,67607,132663,0.03841318206694573,Texas
11128,2012,Wilson,female,2597,24197,24001,48198,0.10820382484063164,Texas
11133,2013,Wilson,female,2013,4318,4462,8780,0.4511429852084267,Texas
11134,2013,Wilson,female,2013,38362,42974,81336,0.04684227672546191,Texas
11135,2013,Wilson,female,2013,65056,67607,132663,0.02977502329640422,Texas
11136,2013,Wilson,female,2013,24197,24001,48198,0.08387150535394358,Texas
11141,2014,Wilson,female,1669,4318,4462,8780,0.37404751232631106,Texas
11142,2014,Wilson,female,1669,38362,42974,81336,0.03883743658956578,Texas
11143,2014,Wilson,female,1669,65056,67607,132663,0.024686792787729082,Texas
11144,2014,Wilson,female,1669,24197,24001,48198,0.06953876921794926,Texas
11149,2015,Wilson,female,3260,4318,4462,8780,0.7306140744060959,Texas
11150,2015,Wilson,female,3260,38362,42974,81336,0.07585982221808535,Texas
11151,2015,Wilson,female,3260,65056,67607,132663,0.04821985889035159,Texas
11152,2015,Wilson,female,3260,24197,24001,48198,0.13582767384692304,Texas
11157,2016,Wilson,female,3465,4318,4462,8780,0.7765575974899148,Texas
11158,2016,Wilson,female,3465,38362,42974,81336,0.08063014846186066,Texas
11159,2016,Wilson,female,3465,65056,67607,132663,0.05125208928069579,Texas
11160,2016,Wilson,female,3465,24197,24001,48198,0.1443689846256406,Texas
11165,2009,Winkler,female,347,3977,3825,7802,0.09071895424836601,Texas
11167,2010,Winkler,female,258,3977,3825,7802,0.06745098039215686,Texas
11169,2011,Winkler,female,178,3977,3825,7802,0.0465359477124183,Texas
11171,2012,Winkler,female,173,3977,3825,7802,0.045228758169934644,Texas
11173,2013,Winkler,female,102,3977,3825,7802,0.02666666666666667,Texas
11175,2014,Winkler,female,299,3977,3825,7802,0.07816993464052288,Texas
11177,2015,Winkler,female,16,3977,3825,7802,0.004183006535947713,Texas
11179,2016,Winkler,female,130,3977,3825,7802,0.03398692810457516,Texas
11181,2009,Wise,female,10581,32424,32215,64639,0.3284494800558746,Texas
11182,2009,Wise,female,10581,20490,18535,39025,0.5708659293229026,Texas
11185,2010,Wise,female,9877,32424,32215,64639,0.3065963060686016,Texas
11186,2010,Wise,female,9877,20490,18535,39025,0.5328837334772053,Texas
11189,2011,Wise,female,9285,32424,32215,64639,0.28821977339748567,Texas
11190,2011,Wise,female,9285,20490,18535,39025,0.5009441596978689,Texas
11193,2012,Wise,female,7849,32424,32215,64639,0.24364426509390036,Texas
11194,2012,Wise,female,7849,20490,18535,39025,0.423469112489884,Texas
11197,2013,Wise,female,7698,32424,32215,64639,0.23895700760515287,Texas
11198,2013,Wise,female,7698,20490,18535,39025,0.4153223630968438,Texas
11201,2014,Wise,female,7381,32424,32215,64639,0.22911687102281547,Texas
11202,2014,Wise,female,7381,20490,18535,39025,0.39821958456973294,Texas
11205,2015,Wise,female,5759,32424,32215,64639,0.1787676548191836,Texas
11206,2015,Wise,female,5759,20490,18535,39025,0.31070946857297005,Texas
11209,2016,Wise,female,6859,32424,32215,64639,0.2129132391742977,Texas
11210,2016,Wise,female,6859,20490,18535,39025,0.3700566495818721,Texas
11213,2009,Wood,female,4048,63995,65941,129936,0.06138821067317754,Texas
11214,2009,Wood,female,4048,21807,22008,43815,0.18393311523082514,Texas
11215,2009,Wood,female,4048,41246,44310,85556,0.09135635296772737,Texas
11216,2009,Wood,female,4048,36056,37218,73274,0.10876457628029448,Texas
11221,2010,Wood,female,3621,63995,65941,129936,0.05491272501175293,Texas
11222,2010,Wood,female,3621,21807,22008,43815,0.16453107960741548,Texas
11223,2010,Wood,female,3621,41246,44310,85556,0.08171970209884902,Texas
11224,2010,Wood,female,3621,36056,37218,73274,0.09729163308076737,Texas
11229,2011,Wood,female,3859,63995,65941,129936,0.0585220121017273,Texas
11230,2011,Wood,female,3859,21807,22008,43815,0.17534532897128316,Texas
11231,2011,Wood,female,3859,41246,44310,85556,0.08709095012412547,Texas
11232,2011,Wood,female,3859,36056,37218,73274,0.1036863883067333,Texas
11237,2012,Wood,female,3423,63995,65941,129936,0.05191004079404316,Texas
11238,2012,Wood,female,3423,21807,22008,43815,0.15553435114503816,Texas
11239,2012,Wood,female,3423,41246,44310,85556,0.07725118483412323,Texas
11240,2012,Wood,female,3423,36056,37218,73274,0.0919716266322747,Texas
11245,2013,Wood,female,3724,63995,65941,129936,0.056474727407834276,Texas
11246,2013,Wood,female,3724,21807,22008,43815,0.1692111959287532,Texas
11247,2013,Wood,female,3724,41246,44310,85556,0.08404423380726699,Texas
11248,2013,Wood,female,3724,36056,37218,73274,0.10005911118276103,Texas
11253,2014,Wood,female,3596,63995,65941,129936,0.054533598216587556,Texas
11254,2014,Wood,female,3596,21807,22008,43815,0.163395129043984,Texas
11255,2014,Wood,female,3596,41246,44310,85556,0.08115549537350485,Texas
11256,2014,Wood,female,3596,36056,37218,73274,0.09661991509484658,Texas
11261,2015,Wood,female,2358,63995,65941,129936,0.03575923931999818,Texas
11262,2015,Wood,female,2358,21807,22008,43815,0.10714285714285714,Texas
11263,2015,Wood,female,2358,41246,44310,85556,0.05321597833446175,Texas
11264,2015,Wood,female,2358,36056,37218,73274,0.06335644043204901,Texas
11269,2016,Wood,female,3431,63995,65941,129936,0.05203136136849608,Texas
11270,2016,Wood,female,3431,21807,22008,43815,0.15589785532533623,Texas
11271,2016,Wood,female,3431,41246,44310,85556,0.07743173098623335,Texas
11272,2016,Wood,female,3431,36056,37218,73274,0.09218657638776936,Texas
11277,2009,Yoakum,female,621,4438,4133,8571,0.15025405274618922,Texas
11279,2010,Yoakum,female,673,4438,4133,8571,0.16283571255746432,Texas
11281,2011,Yoakum,female,485,4438,4133,8571,0.1173481732397774,Texas
11283,2012,Yoakum,female,434,4438,4133,8571,0.10500846842487298,Texas
11285,2013,Yoakum,female,232,4438,4133,8571,0.056133559157996615,Texas
11287,2014,Yoakum,female,361,4438,4133,8571,0.08734575368981369,Texas
11289,2015,Yoakum,female,242,4438,4133,8571,0.05855310912170336,Texas
11291,2016,Yoakum,female,275,4438,4133,8571,0.06653762400193564,Texas
11293,2009,Young,female,2459,8930,9184,18114,0.2677482578397213,Texas
11295,2010,Young,female,2298,8930,9184,18114,0.2502177700348432,Texas
11297,2011,Young,female,2055,8930,9184,18114,0.22375871080139373,Texas
11299,2012,Young,female,2481,8930,9184,18114,0.27014372822299654,Texas
11301,2013,Young,female,2012,8930,9184,18114,0.2190766550522648,Texas
11303,2014,Young,female,1243,8930,9184,18114,0.13534407665505227,Texas
11305,2015,Young,female,815,8930,9184,18114,0.08874128919860627,Texas
11307,2016,Young,female,1253,8930,9184,18114,0.1364329268292683,Texas
11309,2009,Zapata,female,1847,7177,7192,14369,0.2568131256952169,Texas
11311,2010,Zapata,female,1259,7177,7192,14369,0.17505561735261402,Texas
11313,2011,Zapata,female,1014,7177,7192,14369,0.14098998887652947,Texas
11315,2012,Zapata,female,631,7177,7192,14369,0.08773637374860957,Texas
11317,2013,Zapata,female,1220,7177,7192,14369,0.1696329254727475,Texas
11319,2014,Zapata,female,1190,7177,7192,14369,0.16546162402669634,Texas
11321,2015,Zapata,female,1206,7177,7192,14369,0.16768631813125695,Texas
11323,2016,Zapata,female,2659,7177,7192,14369,0.36971635150166854,Texas
11325,2009,Zavala,female,1973,6208,5923,12131,0.3331082221847037,Texas
11327,2010,Zavala,female,2098,6208,5923,12131,0.3542123923687321,Texas
11329,2011,Zavala,female,1279,6208,5923,12131,0.21593786932297823,Texas
11331,2012,Zavala,female,676,6208,5923,12131,0.1141313523552254,Texas
11333,2013,Zavala,female,785,6208,5923,12131,0.1325341887556981,Texas
11335,2014,Zavala,female,815,6208,5923,12131,0.13759918959986495,Texas
11337,2015,Zavala,female,858,6208,5923,12131,0.1448590241431707,Texas
11339,2016,Zavala,female,1795,6208,5923,12131,0.3030558838426473,Texas
5,2009,Anderson,male,6421,3932,3920,7852,1.6330111902339777,Texas
6,2009,Anderson,male,6421,10873,11341,22214,0.5905453876575002,Texas
7,2009,Anderson,male,6421,94565,101430,195995,0.0679003859778988,Texas
8,2009,Anderson,male,6421,36904,38871,75775,0.17399197918924778,Texas
9,2009,Anderson,male,6421,35412,22451,57863,0.18132271546368461,Texas
15,2010,Anderson,male,6101,3932,3920,7852,1.5516276703967447,Texas
16,2010,Anderson,male,6101,10873,11341,22214,0.5611146877586682,Texas
17,2010,Anderson,male,6101,94565,101430,195995,0.06451647015280496,Texas
18,2010,Anderson,male,6101,36904,38871,75775,0.16532083243008888,Texas
19,2010,Anderson,male,6101,35412,22451,57863,0.1722862306562747,Texas
25,2011,Anderson,male,9936,3932,3920,7852,2.5269582909460833,Texas
26,2011,Anderson,male,9936,10873,11341,22214,0.9138232318587326,Texas
27,2011,Anderson,male,9936,94565,101430,195995,0.10507058636916407,Texas
28,2011,Anderson,male,9936,36904,38871,75775,0.2692391068718838,Texas
29,2011,Anderson,male,9936,35412,22451,57863,0.2805828532700779,Texas
35,2012,Anderson,male,8707,3932,3920,7852,2.2143947100712107,Texas
36,2012,Anderson,male,8707,10873,11341,22214,0.8007909500597811,Texas
37,2012,Anderson,male,8707,94565,101430,195995,0.092074234653413,Texas
38,2012,Anderson,male,8707,36904,38871,75775,0.23593648384998916,Texas
39,2012,Anderson,male,8707,35412,22451,57863,0.24587710380661923,Texas
45,2013,Anderson,male,8092,3932,3920,7852,2.0579857578840284,Texas
46,2013,Anderson,male,8092,10873,11341,22214,0.7442288236917134,Texas
47,2013,Anderson,male,8092,94565,101430,195995,0.08557077142706075,Texas
48,2013,Anderson,male,8092,36904,38871,75775,0.21927162367223066,Texas
49,2013,Anderson,male,8092,35412,22451,57863,0.2285101095673783,Texas
55,2014,Anderson,male,6677,3932,3920,7852,1.698118006103764,Texas
56,2014,Anderson,male,6677,10873,11341,22214,0.6140899475765658,Texas
57,2014,Anderson,male,6677,94565,101430,195995,0.07060751863797388,Texas
58,2014,Anderson,male,6677,36904,38871,75775,0.1809288965965749,Texas
59,2014,Anderson,male,6677,35412,22451,57863,0.18855190330961255,Texas
65,2015,Anderson,male,4390,3932,3920,7852,1.1164801627670398,Texas
66,2015,Anderson,male,4390,10873,11341,22214,0.40375241423710106,Texas
67,2015,Anderson,male,4390,94565,101430,195995,0.046423095225506264,Texas
68,2015,Anderson,male,4390,36904,38871,75775,0.11895729460221115,Texas
69,2015,Anderson,male,4390,35412,22451,57863,0.1239692759516548,Texas
75,2016,Anderson,male,4616,3932,3920,7852,1.1739572736520854,Texas
76,2016,Anderson,male,4616,10873,11341,22214,0.42453784604065115,Texas
77,2016,Anderson,male,4616,94565,101430,195995,0.0488129857769788,Texas
78,2016,Anderson,male,4616,36904,38871,75775,0.12508129200086712,Texas
79,2016,Anderson,male,4616,35412,22451,57863,0.13035129334688805,Texas
81,2009,Andrews,male,2663,9102,8716,17818,0.2925730608657438,Texas
83,2010,Andrews,male,2179,9102,8716,17818,0.23939793451988575,Texas
85,2011,Andrews,male,2910,9102,8716,17818,0.3197099538562953,Texas
87,2012,Andrews,male,4108,9102,8716,17818,0.45132937815864643,Texas
89,2013,Andrews,male,1644,9102,8716,17818,0.1806196440342782,Texas
91,2014,Andrews,male,1115,9102,8716,17818,0.12250054932981762,Texas
93,2015,Andrews,male,1487,9102,8716,17818,0.16337068776093167,Texas
95,2016,Andrews,male,2602,9102,8716,17818,0.2858712370907493,Texas
97,2009,Angelina,male,8365,42659,44948,87607,0.1960899224079327,Texas
99,2010,Angelina,male,9755,42659,44948,87607,0.22867390234182705,Texas
101,2011,Angelina,male,7884,42659,44948,87607,0.18481445884807426,Texas
103,2012,Angelina,male,8551,42659,44948,87607,0.20045008087390703,Texas
105,2013,Angelina,male,7668,42659,44948,87607,0.17975104901662017,Texas
107,2014,Angelina,male,6268,42659,44948,87607,0.14693265196089922,Texas
109,2015,Angelina,male,7048,42659,44948,87607,0.16521718746337233,Texas
111,2016,Angelina,male,7829,42659,44948,87607,0.1835251646780281,Texas
113,2009,Aransas,male,2882,12026,12737,24763,0.2396474305671046,Texas
115,2010,Aransas,male,1886,12026,12737,24763,0.15682687510394147,Texas
117,2011,Aransas,male,1724,12026,12737,24763,0.1433560618659571,Texas
119,2012,Aransas,male,2595,12026,12737,24763,0.215782471312157,Texas
121,2013,Aransas,male,3305,12026,12737,24763,0.2748212206885082,Texas
123,2014,Aransas,male,2366,12026,12737,24763,0.19674039580908032,Texas
125,2015,Aransas,male,1749,12026,12737,24763,0.14543489106934973,Texas
127,2016,Aransas,male,2065,12026,12737,24763,0.17171129220023282,Texas
129,2009,Archer,male,3524,4326,4463,8789,0.8146093388811836,Texas
131,2010,Archer,male,4932,4326,4463,8789,1.1400832177531206,Texas
133,2011,Archer,male,4977,4326,4463,8789,1.1504854368932038,Texas
135,2012,Archer,male,4375,4326,4463,8789,1.0113268608414239,Texas
137,2013,Archer,male,3538,4326,4463,8789,0.8178455848358761,Texas
139,2014,Archer,male,2001,4326,4463,8789,0.46255201109570043,Texas
141,2015,Archer,male,2424,4326,4463,8789,0.5603328710124826,Texas
143,2016,Archer,male,3074,4326,4463,8789,0.7105871474803513,Texas
146,2009,Armstrong,male,2268,33003,33328,66331,0.06872102536133079,Texas
147,2009,Armstrong,male,2268,960,956,1916,2.3625,Texas
150,2010,Armstrong,male,1640,33003,33328,66331,0.04969245220131503,Texas
151,2010,Armstrong,male,1640,960,956,1916,1.7083333333333333,Texas
154,2011,Armstrong,male,2383,33003,33328,66331,0.07220555707056935,Texas
155,2011,Armstrong,male,2383,960,956,1916,2.482291666666667,Texas
158,2012,Armstrong,male,3288,33003,33328,66331,0.09962730660849013,Texas
159,2012,Armstrong,male,3288,960,956,1916,3.425,Texas
162,2013,Armstrong,male,2323,33003,33328,66331,0.07038754052661879,Texas
163,2013,Armstrong,male,2323,960,956,1916,2.419791666666667,Texas
166,2014,Armstrong,male,1917,33003,33328,66331,0.05808562857922007,Texas
167,2014,Armstrong,male,1917,960,956,1916,1.996875,Texas
170,2015,Armstrong,male,1512,33003,33328,66331,0.04581401690755386,Texas
171,2015,Armstrong,male,1512,960,956,1916,1.575,Texas
174,2016,Armstrong,male,1055,33003,33328,66331,0.03196679089779717,Texas
175,2016,Armstrong,male,1055,960,956,1916,1.0989583333333333,Texas
177,2009,Atascosa,male,7227,24398,24430,48828,0.2962128043282236,Texas
179,2010,Atascosa,male,7743,24398,24430,48828,0.31736207885892287,Texas
181,2011,Atascosa,male,10251,24398,24430,48828,0.4201573899499959,Texas
183,2012,Atascosa,male,10970,24398,24430,48828,0.44962701860808263,Texas
185,2013,Atascosa,male,10114,24398,24430,48828,0.414542175588163,Texas
187,2014,Atascosa,male,11048,24398,24430,48828,0.4528240019673744,Texas
189,2015,Atascosa,male,9179,24398,24430,48828,0.3762193622428068,Texas
191,2016,Atascosa,male,7382,24398,24430,48828,0.30256578408066237,Texas
193,2009,Austin,male,5311,14684,14881,29565,0.3616861890493054,Texas
195,2010,Austin,male,5910,14684,14881,29565,0.4024788885862163,Texas
197,2011,Austin,male,6481,14684,14881,29565,0.4413647507491147,Texas
199,2012,Austin,male,6175,14684,14881,29565,0.42052574230454914,Texas
201,2013,Austin,male,5607,14684,14881,29565,0.38184418414600924,Texas
203,2014,Austin,male,4976,14684,14881,29565,0.3388722418959412,Texas
205,2015,Austin,male,2612,14684,14881,29565,0.17788068646145463,Texas
207,2016,Austin,male,3123,14684,14881,29565,0.21268046853718334,Texas
209,2009,Bailey,male,2033,3640,3452,7092,0.5585164835164835,Texas
211,2010,Bailey,male,1354,3640,3452,7092,0.371978021978022,Texas
213,2011,Bailey,male,2955,3640,3452,7092,0.8118131868131868,Texas
215,2012,Bailey,male,2233,3640,3452,7092,0.6134615384615385,Texas
217,2013,Bailey,male,1740,3640,3452,7092,0.47802197802197804,Texas
219,2014,Bailey,male,1308,3640,3452,7092,0.35934065934065934,Texas
221,2015,Bailey,male,1874,3640,3452,7092,0.5148351648351648,Texas
223,2016,Bailey,male,697,3640,3452,7092,0.1914835164835165,Texas
225,2009,Bandera,male,2843,11032,10731,21763,0.2577048585931835,Texas
227,2010,Bandera,male,3387,11032,10731,21763,0.30701595358955763,Texas
229,2011,Bandera,male,3660,11032,10731,21763,0.33176214648295865,Texas
231,2012,Bandera,male,3875,11032,10731,21763,0.3512509064539521,Texas
233,2013,Bandera,male,3144,11032,10731,21763,0.2849891225525743,Texas
235,2014,Bandera,male,2219,11032,10731,21763,0.20114213197969544,Texas
237,2015,Bandera,male,2136,11032,10731,21763,0.19361856417693982,Texas
239,2016,Bandera,male,1972,11032,10731,21763,0.1787527193618564,Texas
241,2009,Bastrop,male,8539,42014,40563,82577,0.20324177655067358,Texas
243,2010,Bastrop,male,10713,42014,40563,82577,0.25498643309373065,Texas
245,2011,Bastrop,male,11202,42014,40563,82577,0.26662541057742656,Texas
247,2012,Bastrop,male,13521,42014,40563,82577,0.32182129766268386,Texas
249,2013,Bastrop,male,12772,42014,40563,82577,0.3039939067929738,Texas
251,2014,Bastrop,male,8901,42014,40563,82577,0.21185795211120104,Texas
253,2015,Bastrop,male,4528,42014,40563,82577,0.10777359927643167,Texas
255,2016,Bastrop,male,4932,42014,40563,82577,0.11738944161469986,Texas
257,2009,Baylor,male,1483,1752,1839,3591,0.8464611872146118,Texas
259,2010,Baylor,male,1910,1752,1839,3591,1.0901826484018264,Texas
261,2011,Baylor,male,1567,1752,1839,3591,0.894406392694064,Texas
263,2012,Baylor,male,1489,1752,1839,3591,0.8498858447488584,Texas
265,2013,Baylor,male,916,1752,1839,3591,0.5228310502283106,Texas
267,2014,Baylor,male,844,1752,1839,3591,0.4817351598173516,Texas
269,2015,Baylor,male,967,1752,1839,3591,0.5519406392694064,Texas
271,2016,Baylor,male,449,1752,1839,3591,0.2562785388127854,Texas
273,2009,Bee,male,2494,19911,12780,32691,0.1252573954095726,Texas
275,2010,Bee,male,3698,19911,12780,32691,0.1857264828486766,Texas
277,2011,Bee,male,3877,19911,12780,32691,0.194716488373261,Texas
279,2012,Bee,male,6347,19911,12780,32691,0.3187685199136156,Texas
281,2013,Bee,male,5735,19911,12780,32691,0.2880317412485561,Texas
283,2014,Bee,male,5137,19911,12780,32691,0.2579980915072071,Texas
285,2015,Bee,male,3510,19911,12780,32691,0.17628446587313545,Texas
287,2016,Bee,male,4038,19911,12780,32691,0.2028024709959319,Texas
290,2009,Bell,male,19947,13325,13863,27188,1.4969606003752345,Texas
291,2009,Bell,male,19947,170918,171318,342236,0.11670508664973847,Texas
294,2010,Bell,male,21528,13325,13863,27188,1.615609756097561,Texas
295,2010,Bell,male,21528,170918,171318,342236,0.12595513638118863,Texas
298,2011,Bell,male,20898,13325,13863,27188,1.5683302063789868,Texas
299,2011,Bell,male,20898,170918,171318,342236,0.12226915830983279,Texas
302,2012,Bell,male,19679,13325,13863,27188,1.4768480300187616,Texas
303,2012,Bell,male,19679,170918,171318,342236,0.11513708327970137,Texas
306,2013,Bell,male,18321,13325,13863,27188,1.374934333958724,Texas
307,2013,Bell,male,18321,170918,171318,342236,0.10719175277033431,Texas
310,2014,Bell,male,14052,13325,13863,27188,1.0545590994371483,Texas
311,2014,Bell,male,14052,170918,171318,342236,0.08221486326776582,Texas
314,2015,Bell,male,11067,13325,13863,27188,0.8305440900562852,Texas
315,2015,Bell,male,11067,170918,171318,342236,0.06475034812015118,Texas
318,2016,Bell,male,11445,13325,13863,27188,0.8589118198874296,Texas
319,2016,Bell,male,11445,170918,171318,342236,0.0669619349629647,Texas
321,2009,Bexar,male,8495,950030,975835,1925865,0.00894182288980348,Texas
323,2010,Bexar,male,9485,950030,975835,1925865,0.009983895245413302,Texas
325,2011,Bexar,male,10409,950030,975835,1925865,0.010956496110649137,Texas
327,2012,Bexar,male,13123,950030,975835,1925865,0.013813248002694652,Texas
329,2013,Bexar,male,12733,950030,975835,1925865,0.013402734650484721,Texas
331,2014,Bexar,male,11305,950030,975835,1925865,0.011899624222392977,Texas
333,2015,Bexar,male,9227,950030,975835,1925865,0.009712324873951348,Texas
335,2016,Bexar,male,7183,950030,975835,1925865,0.0075608138690357145,Texas
337,2009,Blanco,male,3157,5781,5498,11279,0.5460992907801419,Texas
339,2010,Blanco,male,2800,5781,5498,11279,0.4843452689846047,Texas
341,2011,Blanco,male,3319,5781,5498,11279,0.5741221241999654,Texas
343,2012,Blanco,male,3106,5781,5498,11279,0.5372772876664937,Texas
345,2013,Blanco,male,2378,5781,5498,11279,0.41134751773049644,Texas
347,2014,Blanco,male,1793,5781,5498,11279,0.3101539526033558,Texas
349,2015,Blanco,male,1620,5781,5498,11279,0.2802283341982356,Texas
351,2016,Blanco,male,1755,5781,5498,11279,0.3035806953814219,Texas
353,2009,Borden,male,106,346,319,665,0.3063583815028902,Texas
355,2010,Borden,male,114,346,319,665,0.32947976878612717,Texas
357,2011,Borden,male,133,346,319,665,0.38439306358381503,Texas
359,2012,Borden,male,101,346,319,665,0.29190751445086704,Texas
361,2013,Borden,male,62,346,319,665,0.1791907514450867,Texas
363,2014,Borden,male,43,346,319,665,0.12427745664739884,Texas
365,2015,Borden,male,14,346,319,665,0.04046242774566474,Texas
367,2016,Borden,male,21,346,319,665,0.06069364161849711,Texas
369,2009,Bosque,male,2939,8935,9187,18122,0.3289311695579183,Texas
371,2010,Bosque,male,3408,8935,9187,18122,0.3814213766088416,Texas
373,2011,Bosque,male,3601,8935,9187,18122,0.40302182428651373,Texas
375,2012,Bosque,male,3876,8935,9187,18122,0.43379966424174593,Texas
377,2013,Bosque,male,3762,8935,9187,18122,0.42104085058757695,Texas
379,2014,Bosque,male,3411,8935,9187,18122,0.3817571348628987,Texas
381,2015,Bosque,male,1789,8935,9187,18122,0.20022383883603806,Texas
383,2016,Bosque,male,1604,8935,9187,18122,0.1795187465025182,Texas
385,2009,Bowie,male,13737,47275,46583,93858,0.29057641459545214,Texas
387,2010,Bowie,male,13643,47275,46583,93858,0.2885880486515071,Texas
389,2011,Bowie,male,14013,47275,46583,93858,0.2964145954521417,Texas
391,2012,Bowie,male,10423,47275,46583,93858,0.22047593865679535,Texas
393,2013,Bowie,male,8506,47275,46583,93858,0.17992596509783185,Texas
395,2014,Bowie,male,8036,47275,46583,93858,0.16998413537810683,Texas
397,2015,Bowie,male,7030,47275,46583,93858,0.14870438921205711,Texas
399,2016,Bowie,male,7296,47275,46583,93858,0.15433104177683765,Texas
401,2009,Brazoria,male,24875,179060,174939,353999,0.13891991511225288,Texas
403,2010,Brazoria,male,25867,179060,174939,353999,0.14445995755612645,Texas
405,2011,Brazoria,male,28257,179060,174939,353999,0.15780743884731374,Texas
407,2012,Brazoria,male,21166,179060,174939,353999,0.11820618786998771,Texas
409,2013,Brazoria,male,20994,179060,174939,353999,0.11724561599463867,Texas
411,2014,Brazoria,male,17236,179060,174939,353999,0.09625823746230314,Texas
413,2015,Brazoria,male,15201,179060,174939,353999,0.08489333184407462,Texas
415,2016,Brazoria,male,18020,179060,174939,353999,0.10063665810342902,Texas
417,2009,Brazos,male,8128,111074,108119,219193,0.07317644093127104,Texas
419,2010,Brazos,male,11762,111074,108119,219193,0.1058933683850406,Texas
421,2011,Brazos,male,9914,111074,108119,219193,0.08925581144102131,Texas
423,2012,Brazos,male,10493,111074,108119,219193,0.09446855249653384,Texas
425,2013,Brazos,male,10619,111074,108119,219193,0.09560293137908062,Texas
427,2014,Brazos,male,8019,111074,108119,219193,0.07219511316779804,Texas
429,2015,Brazos,male,5253,111074,108119,219193,0.047292795793795125,Texas
431,2016,Brazos,male,7514,111074,108119,219193,0.06764859463060663,Texas
433,2009,Brewster,male,8824,4558,4658,9216,1.9359368143922773,Texas
435,2010,Brewster,male,6093,4558,4658,9216,1.3367705133830627,Texas
437,2011,Brewster,male,5026,4558,4658,9216,1.1026766125493637,Texas
439,2012,Brewster,male,3701,4558,4658,9216,0.811978938130759,Texas
441,2013,Brewster,male,2166,4558,4658,9216,0.47520842474769637,Texas
443,2014,Brewster,male,3232,4558,4658,9216,0.709082931110136,Texas
445,2015,Brewster,male,3337,4558,4658,9216,0.7321193505923651,Texas
447,2016,Brewster,male,4411,4558,4658,9216,0.9677490127248793,Texas
449,2009,Briscoe,male,205,831,715,1546,0.246690734055355,Texas
451,2010,Briscoe,male,431,831,715,1546,0.5186522262334536,Texas
453,2011,Briscoe,male,466,831,715,1546,0.5607701564380265,Texas
455,2012,Briscoe,male,322,831,715,1546,0.38748495788206977,Texas
457,2013,Briscoe,male,155,831,715,1546,0.1865222623345367,Texas
459,2014,Briscoe,male,223,831,715,1546,0.2683513838748496,Texas
461,2015,Briscoe,male,237,831,715,1546,0.2851985559566787,Texas
463,2016,Briscoe,male,392,831,715,1546,0.4717208182912154,Texas
466,2009,Brooks,male,11068,7608,8014,15622,1.4547844374342798,Texas
467,2009,Brooks,male,11068,3724,3456,7180,2.9720730397422126,Texas
470,2010,Brooks,male,8006,7608,8014,15622,1.0523133543638274,Texas
471,2010,Brooks,male,8006,3724,3456,7180,2.1498388829215895,Texas
474,2011,Brooks,male,6027,7608,8014,15622,0.792192429022082,Texas
475,2011,Brooks,male,6027,3724,3456,7180,1.618421052631579,Texas
478,2012,Brooks,male,3927,7608,8014,15622,0.5161671924290221,Texas
479,2012,Brooks,male,3927,3724,3456,7180,1.0545112781954886,Texas
482,2013,Brooks,male,3100,7608,8014,15622,0.407465825446898,Texas
483,2013,Brooks,male,3100,3724,3456,7180,0.832438238453276,Texas
486,2014,Brooks,male,2535,7608,8014,15622,0.3332018927444795,Texas
487,2014,Brooks,male,2535,3724,3456,7180,0.680719656283566,Texas
490,2015,Brooks,male,3477,7608,8014,15622,0.45701892744479494,Texas
491,2015,Brooks,male,3477,3724,3456,7180,0.9336734693877551,Texas
494,2016,Brooks,male,5563,7608,8014,15622,0.7312039957939012,Texas
495,2016,Brooks,male,5563,3724,3456,7180,1.4938238453276047,Texas
505,2009,Brown,male,6076,4238,2437,6675,1.4336951392166115,Texas
506,2009,Brown,male,6076,7441,7593,15034,0.8165569143932268,Texas
507,2009,Brown,male,6076,4685,4979,9664,1.2969050160085378,Texas
508,2009,Brown,male,6076,12653,12558,25211,0.4802023235596301,Texas
509,2009,Brown,male,6076,1430,1558,2988,4.248951048951049,Texas
510,2009,Brown,male,6076,21649,22030,43679,0.2806596147628066,Texas
511,2009,Brown,male,6076,19060,19780,38840,0.3187827911857293,Texas
512,2009,Brown,male,6076,18774,19060,37834,0.32363907531692765,Texas
513,2009,Brown,male,6076,128824,130962,259786,0.04716512451096069,Texas
523,2010,Brown,male,5242,4238,2437,6675,1.2369042000943842,Texas
524,2010,Brown,male,5242,7441,7593,15034,0.7044752049455718,Texas
525,2010,Brown,male,5242,4685,4979,9664,1.11889007470651,Texas
526,2010,Brown,male,5242,12653,12558,25211,0.41428910139887776,Texas
527,2010,Brown,male,5242,1430,1558,2988,3.6657342657342658,Texas
528,2010,Brown,male,5242,21649,22030,43679,0.24213589542242137,Texas
529,2010,Brown,male,5242,19060,19780,38840,0.2750262329485834,Texas
530,2010,Brown,male,5242,18774,19060,37834,0.2792159369340577,Texas
531,2010,Brown,male,5242,128824,130962,259786,0.040691175557349565,Texas
541,2011,Brown,male,6436,4238,2437,6675,1.51864086833412,Texas
542,2011,Brown,male,6436,7441,7593,15034,0.8649375083994086,Texas
543,2011,Brown,male,6436,4685,4979,9664,1.3737459978655282,Texas
544,2011,Brown,male,6436,12653,12558,25211,0.5086540741326168,Texas
545,2011,Brown,male,6436,1430,1558,2988,4.500699300699301,Texas
546,2011,Brown,male,6436,21649,22030,43679,0.2972885583629729,Texas
547,2011,Brown,male,6436,19060,19780,38840,0.33767051416579225,Texas
548,2011,Brown,male,6436,18774,19060,37834,0.3428145307339938,Texas
549,2011,Brown,male,6436,128824,130962,259786,0.04995963485064895,Texas
559,2012,Brown,male,5560,4238,2437,6675,1.311939594148183,Texas
560,2012,Brown,male,5560,7441,7593,15034,0.7472113963176993,Texas
561,2012,Brown,male,5560,4685,4979,9664,1.1867662753468518,Texas
562,2012,Brown,male,5560,12653,12558,25211,0.4394214810716826,Texas
563,2012,Brown,male,5560,1430,1558,2988,3.888111888111888,Texas
564,2012,Brown,male,5560,21649,22030,43679,0.25682479560256827,Texas
565,2012,Brown,male,5560,19060,19780,38840,0.291710388247639,Texas
566,2012,Brown,male,5560,18774,19060,37834,0.2961542558857995,Texas
567,2012,Brown,male,5560,128824,130962,259786,0.043159659690740856,Texas
577,2013,Brown,male,4699,4238,2437,6675,1.1087777253421425,Texas
578,2013,Brown,male,4699,7441,7593,15034,0.6315011423195807,Texas
579,2013,Brown,male,4699,4685,4979,9664,1.0029882604055496,Texas
580,2013,Brown,male,4699,12653,12558,25211,0.3713743776179562,Texas
581,2013,Brown,male,4699,1430,1558,2988,3.286013986013986,Texas
582,2013,Brown,male,4699,21649,22030,43679,0.21705390549217055,Texas
583,2013,Brown,male,4699,19060,19780,38840,0.24653725078698846,Texas
584,2013,Brown,male,4699,18774,19060,37834,0.2502929583466496,Texas
585,2013,Brown,male,4699,128824,130962,259786,0.03647612246165311,Texas
595,2014,Brown,male,3491,4238,2437,6675,0.8237376120811704,Texas
596,2014,Brown,male,3491,7441,7593,15034,0.469157371321059,Texas
597,2014,Brown,male,3491,4685,4979,9664,0.7451440768409818,Texas
598,2014,Brown,male,3491,12653,12558,25211,0.2759029479174899,Texas
599,2014,Brown,male,3491,1430,1558,2988,2.4412587412587414,Texas
600,2014,Brown,male,3491,21649,22030,43679,0.16125456141161254,Texas
601,2014,Brown,male,3491,19060,19780,38840,0.18315844700944386,Texas
602,2014,Brown,male,3491,18774,19060,37834,0.1859486523916054,Texas
603,2014,Brown,male,3491,128824,130962,259786,0.027098987766254735,Texas
613,2015,Brown,male,1977,4238,2437,6675,0.46649362907031616,Texas
614,2015,Brown,male,1977,7441,7593,15034,0.2656900954172826,Texas
615,2015,Brown,male,1977,4685,4979,9664,0.42198505869797226,Texas
616,2015,Brown,male,1977,12653,12558,25211,0.15624753022998497,Texas
617,2015,Brown,male,1977,1430,1558,2988,1.3825174825174824,Texas
618,2015,Brown,male,1977,21649,22030,43679,0.0913206152709132,Texas
619,2015,Brown,male,1977,19060,19780,38840,0.10372507869884574,Texas
620,2015,Brown,male,1977,18774,19060,37834,0.10530520933205496,Texas
621,2015,Brown,male,1977,128824,130962,259786,0.015346519282121343,Texas
631,2016,Brown,male,2878,4238,2437,6675,0.6790939122227466,Texas
632,2016,Brown,male,2878,7441,7593,15034,0.3867759709716436,Texas
633,2016,Brown,male,2878,4685,4979,9664,0.6143009605122732,Texas
634,2016,Brown,male,2878,12653,12558,25211,0.22745593930293212,Texas
635,2016,Brown,male,2878,1430,1558,2988,2.0125874125874126,Texas
636,2016,Brown,male,2878,21649,22030,43679,0.1329391657813294,Texas
637,2016,Brown,male,2878,19060,19780,38840,0.15099685204617,Texas
638,2016,Brown,male,2878,18774,19060,37834,0.15329711302865665,Texas
639,2016,Brown,male,2878,128824,130962,259786,0.02234055766006334,Texas
641,2009,Burleson,male,4568,8977,8886,17863,0.5088559652445137,Texas
643,2010,Burleson,male,6103,8977,8886,17863,0.6798485017266347,Texas
645,2011,Burleson,male,8945,8977,8886,17863,0.9964353347443466,Texas
647,2012,Burleson,male,6515,8977,8886,17863,0.7257435668931714,Texas
649,2013,Burleson,male,2924,8977,8886,17863,0.3257212877353236,Texas
651,2014,Burleson,male,2985,8977,8886,17863,0.33251643087891275,Texas
653,2015,Burleson,male,3300,8977,8886,17863,0.3676061044892503,Texas
655,2016,Burleson,male,3535,8977,8886,17863,0.3937841149604545,Texas
657,2009,Burnet,male,5382,22642,23108,45750,0.23769984983658687,Texas
659,2010,Burnet,male,6275,22642,23108,45750,0.27713982863704617,Texas
661,2011,Burnet,male,5967,22642,23108,45750,0.2635367900362159,Texas
663,2012,Burnet,male,6361,22642,23108,45750,0.2809380796749404,Texas
665,2013,Burnet,male,8751,22642,23108,45750,0.3864941259606042,Texas
667,2014,Burnet,male,5190,22642,23108,45750,0.2292200335659394,Texas
669,2015,Burnet,male,4123,22642,23108,45750,0.1820952212702058,Texas
671,2016,Burnet,male,2957,22642,23108,45750,0.1305980037099196,Texas
677,2009,Caldwell,male,3491,6168,6559,12727,0.5659857328145266,Texas
678,2009,Caldwell,male,3491,5277,4719,9996,0.661550123176047,Texas
679,2009,Caldwell,male,3491,4585,4464,9049,0.7613958560523446,Texas
680,2009,Caldwell,male,3491,40354,41425,81779,0.08650939188184567,Texas
681,2009,Caldwell,male,3491,20893,20508,41401,0.16708945579859283,Texas
687,2010,Caldwell,male,3891,6168,6559,12727,0.6308365758754864,Texas
688,2010,Caldwell,male,3891,5277,4719,9996,0.7373507674815236,Texas
689,2010,Caldwell,male,3891,4585,4464,9049,0.8486368593238822,Texas
690,2010,Caldwell,male,3891,40354,41425,81779,0.09642166823611042,Texas
691,2010,Caldwell,male,3891,20893,20508,41401,0.18623462403675872,Texas
697,2011,Caldwell,male,6333,6168,6559,12727,1.0267509727626458,Texas
698,2011,Caldwell,male,6333,5277,4719,9996,1.2001137009664582,Texas
699,2011,Caldwell,male,6333,4585,4464,9049,1.3812431842966195,Texas
700,2011,Caldwell,male,6333,40354,41425,81779,0.15693611537889676,Texas
701,2011,Caldwell,male,6333,20893,20508,41401,0.3031158761307615,Texas
707,2012,Caldwell,male,5149,6168,6559,12727,0.834792477302205,Texas
708,2012,Caldwell,male,5149,5277,4719,9996,0.9757437938222475,Texas
709,2012,Caldwell,male,5149,4585,4464,9049,1.123009814612868,Texas
710,2012,Caldwell,male,5149,40354,41425,81779,0.12759577737027308,Texas
711,2012,Caldwell,male,5149,20893,20508,41401,0.24644617814579045,Texas
717,2013,Caldwell,male,4425,6168,6559,12727,0.7174124513618677,Texas
718,2013,Caldwell,male,4425,5277,4719,9996,0.8385446276293349,Texas
719,2013,Caldwell,male,4425,4585,4464,9049,0.965103598691385,Texas
720,2013,Caldwell,male,4425,40354,41425,81779,0.10965455716905387,Texas
721,2013,Caldwell,male,4425,20893,20508,41401,0.21179342363471018,Texas
727,2014,Caldwell,male,4852,6168,6559,12727,0.7866407263294423,Texas
728,2014,Caldwell,male,4852,5277,4719,9996,0.9194618154254312,Texas
729,2014,Caldwell,male,4852,4585,4464,9049,1.0582333696837514,Texas
730,2014,Caldwell,male,4852,40354,41425,81779,0.12023591217723151,Texas
731,2014,Caldwell,male,4852,20893,20508,41401,0.23223089072895228,Texas
737,2015,Caldwell,male,2684,6168,6559,12727,0.4351491569390402,Texas
738,2015,Caldwell,male,2684,5277,4719,9996,0.508622323289748,Texas
739,2015,Caldwell,male,2684,4585,4464,9049,0.5853871319520174,Texas
740,2015,Caldwell,male,2684,40354,41425,81779,0.06651137433711651,Texas
741,2015,Caldwell,male,2684,20893,20508,41401,0.12846407887809314,Texas
747,2016,Caldwell,male,3399,6168,6559,12727,0.5510700389105059,Texas
748,2016,Caldwell,male,3399,5277,4719,9996,0.6441159749857874,Texas
749,2016,Caldwell,male,3399,4585,4464,9049,0.7413304252998909,Texas
750,2016,Caldwell,male,3399,40354,41425,81779,0.08422956832036477,Texas
751,2016,Caldwell,male,3399,20893,20508,41401,0.16268606710381467,Texas
763,2009,Calhoun,male,3884,55315,59783,115098,0.07021603543342674,Texas
764,2009,Calhoun,male,3884,2607,2595,5202,1.4898350594553127,Texas
765,2009,Calhoun,male,3884,8048,6396,14444,0.4826043737574553,Texas
766,2009,Calhoun,male,3884,3875,2553,6428,1.0023225806451612,Texas
767,2009,Calhoun,male,3884,2435,2423,4858,1.5950718685831622,Texas
768,2009,Calhoun,male,3884,5044,4736,9780,0.7700237906423474,Texas
769,2009,Calhoun,male,3884,65782,68691,134473,0.059043507342434104,Texas
770,2009,Calhoun,male,3884,6991,7580,14571,0.5555714490058646,Texas
771,2009,Calhoun,male,3884,7013,7700,14713,0.5538286040211037,Texas
772,2009,Calhoun,male,3884,11062,10745,21807,0.3511119146628096,Texas
773,2009,Calhoun,male,3884,3642,3754,7396,1.0664470071389347,Texas
785,2010,Calhoun,male,2991,55315,59783,115098,0.0540721323330019,Texas
786,2010,Calhoun,male,2991,2607,2595,5202,1.147295742232451,Texas
787,2010,Calhoun,male,2991,8048,6396,14444,0.3716451292246521,Texas
788,2010,Calhoun,male,2991,3875,2553,6428,0.7718709677419355,Texas
789,2010,Calhoun,male,2991,2435,2423,4858,1.2283367556468172,Texas
790,2010,Calhoun,male,2991,5044,4736,9780,0.5929817605075337,Texas
791,2010,Calhoun,male,2991,65782,68691,134473,0.045468365206287435,Texas
792,2010,Calhoun,male,2991,6991,7580,14571,0.4278357888714061,Texas
793,2010,Calhoun,male,2991,7013,7700,14713,0.4264936546413803,Texas
794,2010,Calhoun,male,2991,11062,10745,21807,0.2703851021515097,Texas
795,2010,Calhoun,male,2991,3642,3754,7396,0.8212520593080724,Texas
807,2011,Calhoun,male,3800,55315,59783,115098,0.06869746000180783,Texas
808,2011,Calhoun,male,3800,2607,2595,5202,1.457614115841964,Texas
809,2011,Calhoun,male,3800,8048,6396,14444,0.4721669980119284,Texas
810,2011,Calhoun,male,3800,3875,2553,6428,0.9806451612903225,Texas
811,2011,Calhoun,male,3800,2435,2423,4858,1.5605749486652978,Texas
812,2011,Calhoun,male,3800,5044,4736,9780,0.753370340999207,Texas
813,2011,Calhoun,male,3800,65782,68691,134473,0.05776656228147518,Texas
814,2011,Calhoun,male,3800,6991,7580,14571,0.5435560005721642,Texas
815,2011,Calhoun,male,3800,7013,7700,14713,0.5418508484243548,Texas
816,2011,Calhoun,male,3800,11062,10745,21807,0.34351835111191464,Texas
817,2011,Calhoun,male,3800,3642,3754,7396,1.043382756727073,Texas
829,2012,Calhoun,male,3963,55315,59783,115098,0.07164421947030643,Texas
830,2012,Calhoun,male,3963,2607,2595,5202,1.520138089758343,Texas
831,2012,Calhoun,male,3963,8048,6396,14444,0.49242047713717696,Texas
832,2012,Calhoun,male,3963,3875,2553,6428,1.022709677419355,Texas
833,2012,Calhoun,male,3963,2435,2423,4858,1.6275154004106775,Texas
834,2012,Calhoun,male,3963,5044,4736,9780,0.785685963521015,Texas
835,2012,Calhoun,male,3963,65782,68691,134473,0.060244443768812134,Texas
836,2012,Calhoun,male,3963,6991,7580,14571,0.5668716921756544,Texas
837,2012,Calhoun,male,3963,7013,7700,14713,0.565093397975189,Texas
838,2012,Calhoun,male,3963,11062,10745,21807,0.3582534803832942,Texas
839,2012,Calhoun,male,3963,3642,3754,7396,1.088138385502471,Texas
851,2013,Calhoun,male,3373,55315,59783,115098,0.06097803489107837,Texas
852,2013,Calhoun,male,3373,2607,2595,5202,1.2938243191407748,Texas
853,2013,Calhoun,male,3373,8048,6396,14444,0.419110337972167,Texas
854,2013,Calhoun,male,3373,3875,2553,6428,0.8704516129032258,Texas
855,2013,Calhoun,male,3373,2435,2423,4858,1.3852156057494867,Texas
856,2013,Calhoun,male,3373,5044,4736,9780,0.6687153053132434,Texas
857,2013,Calhoun,male,3373,65782,68691,134473,0.05127542488826731,Texas
858,2013,Calhoun,male,3373,6991,7580,14571,0.4824774710341868,Texas
859,2013,Calhoun,male,3373,7013,7700,14713,0.48096392414088124,Texas
860,2013,Calhoun,male,3373,11062,10745,21807,0.3049177363948653,Texas
861,2013,Calhoun,male,3373,3642,3754,7396,0.9261394838001098,Texas
873,2014,Calhoun,male,2760,55315,59783,115098,0.0498960498960499,Texas
874,2014,Calhoun,male,2760,2607,2595,5202,1.0586881472957423,Texas
875,2014,Calhoun,male,2760,8048,6396,14444,0.3429423459244533,Texas
876,2014,Calhoun,male,2760,3875,2553,6428,0.712258064516129,Texas
877,2014,Calhoun,male,2760,2435,2423,4858,1.1334702258726899,Texas
878,2014,Calhoun,male,2760,5044,4736,9780,0.5471847739888978,Texas
879,2014,Calhoun,male,2760,65782,68691,134473,0.04195676628865039,Texas
880,2014,Calhoun,male,2760,6991,7580,14571,0.3947933056787298,Texas
881,2014,Calhoun,male,2760,7013,7700,14713,0.39355482675032083,Texas
882,2014,Calhoun,male,2760,11062,10745,21807,0.24950280238654854,Texas
883,2014,Calhoun,male,2760,3642,3754,7396,0.7578253706754531,Texas
895,2015,Calhoun,male,1617,55315,59783,115098,0.029232577058664014,Texas
896,2015,Calhoun,male,1617,2607,2595,5202,0.620253164556962,Texas
897,2015,Calhoun,male,1617,8048,6396,14444,0.20091948310139165,Texas
898,2015,Calhoun,male,1617,3875,2553,6428,0.41729032258064513,Texas
899,2015,Calhoun,male,1617,2435,2423,4858,0.6640657084188911,Texas
900,2015,Calhoun,male,1617,5044,4736,9780,0.32057890563045205,Texas
901,2015,Calhoun,male,1617,65782,68691,134473,0.024581192423459304,Texas
902,2015,Calhoun,male,1617,6991,7580,14571,0.2312973823487341,Texas
903,2015,Calhoun,male,1617,7013,7700,14713,0.23057179523741622,Texas
904,2015,Calhoun,male,1617,11062,10745,21807,0.1461760983547279,Texas
905,2015,Calhoun,male,1617,3642,3754,7396,0.4439868204283361,Texas
917,2016,Calhoun,male,1799,55315,59783,115098,0.03252282382717165,Texas
918,2016,Calhoun,male,1799,2607,2595,5202,0.6900652090525509,Texas
919,2016,Calhoun,male,1799,8048,6396,14444,0.2235337972166998,Texas
920,2016,Calhoun,male,1799,3875,2553,6428,0.46425806451612905,Texas
921,2016,Calhoun,male,1799,2435,2423,4858,0.7388090349075975,Texas
922,2016,Calhoun,male,1799,5044,4736,9780,0.35666137985725616,Texas
923,2016,Calhoun,male,1799,65782,68691,134473,0.027347906722203642,Texas
924,2016,Calhoun,male,1799,6991,7580,14571,0.2573308539550851,Texas
925,2016,Calhoun,male,1799,7013,7700,14713,0.25652359903037214,Texas
926,2016,Calhoun,male,1799,11062,10745,21807,0.16262881938166696,Texas
927,2016,Calhoun,male,1799,3642,3754,7396,0.4939593629873696,Texas
929,2009,Callahan,male,5837,6763,7007,13770,0.8630785154517226,Texas
931,2010,Callahan,male,7100,6763,7007,13770,1.0498299571196215,Texas
933,2011,Callahan,male,8768,6763,7007,13770,1.2964660653556115,Texas
935,2012,Callahan,male,6803,6763,7007,13770,1.005914534969688,Texas
937,2013,Callahan,male,4153,6763,7007,13770,0.6140765932278575,Texas
939,2014,Callahan,male,4783,6763,7007,13770,0.7072305190004435,Texas
941,2015,Callahan,male,3756,6763,7007,13770,0.555374833653704,Texas
943,2016,Callahan,male,4457,6763,7007,13770,0.6590270589974864,Texas
947,2009,Cameron,male,26418,3357,3511,6868,7.86952636282395,Texas
948,2009,Cameron,male,26418,2369,2317,4686,11.151540734487126,Texas
949,2009,Cameron,male,26418,204788,216962,421750,0.12900169931831942,Texas
953,2010,Cameron,male,29283,3357,3511,6868,8.722966934763182,Texas
954,2010,Cameron,male,29283,2369,2317,4686,12.360911777121148,Texas
955,2010,Cameron,male,29283,204788,216962,421750,0.1429917768619255,Texas
959,2011,Cameron,male,31545,3357,3511,6868,9.396782841823056,Texas
960,2011,Cameron,male,31545,2369,2317,4686,13.315745040101309,Texas
961,2011,Cameron,male,31545,204788,216962,421750,0.15403734593823856,Texas
965,2012,Cameron,male,26243,3357,3511,6868,7.817396484956807,Texas
966,2012,Cameron,male,26243,2369,2317,4686,11.077669902912621,Texas
967,2012,Cameron,male,26243,204788,216962,421750,0.12814715705998397,Texas
971,2013,Cameron,male,26925,3357,3511,6868,8.020554066130474,Texas
972,2013,Cameron,male,26925,2369,2317,4686,11.365555086534403,Texas
973,2013,Cameron,male,26925,204788,216962,421750,0.1314774303181827,Texas
977,2014,Cameron,male,16947,3357,3511,6868,5.048257372654155,Texas
978,2014,Cameron,male,16947,2369,2317,4686,7.153651329674968,Texas
979,2014,Cameron,male,16947,204788,216962,421750,0.08275387229720492,Texas
983,2015,Cameron,male,12400,3357,3511,6868,3.6937742031575813,Texas
984,2015,Cameron,male,12400,2369,2317,4686,5.23427606585057,Texas
985,2015,Cameron,male,12400,204788,216962,421750,0.06055042287634041,Texas
989,2016,Cameron,male,19145,3357,3511,6868,5.703008638665475,Texas
990,2016,Cameron,male,19145,2369,2317,4686,8.081468974250738,Texas
991,2016,Cameron,male,19145,204788,216962,421750,0.09348692306189815,Texas
993,2009,Camp,male,1353,6220,6593,12813,0.21752411575562702,Texas
995,2010,Camp,male,1273,6220,6593,12813,0.20466237942122187,Texas
997,2011,Camp,male,2521,6220,6593,12813,0.4053054662379421,Texas
999,2012,Camp,male,2271,6220,6593,12813,0.36511254019292605,Texas
1001,2013,Camp,male,1576,6220,6593,12813,0.25337620578778136,Texas
1003,2014,Camp,male,1833,6220,6593,12813,0.2946945337620579,Texas
1005,2015,Camp,male,646,6220,6593,12813,0.10385852090032155,Texas
1007,2016,Camp,male,705,6220,6593,12813,0.11334405144694534,Texas
1009,2009,Carson,male,10455,2820,3212,6032,3.7074468085106385,Texas
1011,2010,Carson,male,10065,2820,3212,6032,3.5691489361702127,Texas
1013,2011,Carson,male,9117,2820,3212,6032,3.2329787234042553,Texas
1015,2012,Carson,male,8578,2820,3212,6032,3.041843971631206,Texas
1017,2013,Carson,male,7210,2820,3212,6032,2.5567375886524824,Texas
1019,2014,Carson,male,5694,2820,3212,6032,2.019148936170213,Texas
1021,2015,Carson,male,4357,2820,3212,6032,1.5450354609929078,Texas
1023,2016,Carson,male,4983,2820,3212,6032,1.7670212765957447,Texas
1033,2009,Cass,male,7954,6353,6312,12665,1.2520069258617976,Texas
1034,2009,Cass,male,7954,19082,19002,38084,0.41683261712608743,Texas
1035,2009,Cass,male,7954,6547,6644,13191,1.214907591263174,Texas
1036,2009,Cass,male,7954,25789,25671,51460,0.30842607313195547,Texas
1037,2009,Cass,male,7954,14798,14224,29022,0.5375050682524666,Texas
1038,2009,Cass,male,7954,50364,52314,102678,0.1579302676514971,Texas
1039,2009,Cass,male,7954,12929,12773,25702,0.6152061257637869,Texas
1040,2009,Cass,male,7954,88346,85856,174202,0.0900323727163652,Texas
1041,2009,Cass,male,7954,14692,15395,30087,0.5413830656139396,Texas
1051,2010,Cass,male,7910,6353,6312,12665,1.2450810640642216,Texas
1052,2010,Cass,male,7910,19082,19002,38084,0.4145267791636097,Texas
1053,2010,Cass,male,7910,6547,6644,13191,1.2081869558576448,Texas
1054,2010,Cass,male,7910,25789,25671,51460,0.3067199193454574,Texas
1055,2010,Cass,male,7910,14798,14224,29022,0.5345316934720908,Texas
1056,2010,Cass,male,7910,50364,52314,102678,0.15705662774998014,Texas
1057,2010,Cass,male,7910,12929,12773,25702,0.6118029236599891,Texas
1058,2010,Cass,male,7910,88346,85856,174202,0.08953433092613135,Texas
1059,2010,Cass,male,7910,14692,15395,30087,0.5383882384971413,Texas
1069,2011,Cass,male,7471,6353,6312,12665,1.175979852038407,Texas
1070,2011,Cass,male,7471,19082,19002,38084,0.39152080494707053,Texas
1071,2011,Cass,male,7471,6547,6644,13191,1.1411333435161142,Texas
1072,2011,Cass,male,7471,25789,25671,51460,0.28969715770289656,Texas
1073,2011,Cass,male,7471,14798,14224,29022,0.5048655223678875,Texas
1074,2011,Cass,male,7471,50364,52314,102678,0.14834008418711778,Texas
1075,2011,Cass,male,7471,12929,12773,25702,0.5778482481243715,Texas
1076,2011,Cass,male,7471,88346,85856,174202,0.08456523215538904,Texas
1077,2011,Cass,male,7471,14692,15395,30087,0.5085080315818132,Texas
1087,2012,Cass,male,7919,6353,6312,12665,1.2464977176137257,Texas
1088,2012,Cass,male,7919,19082,19002,38084,0.41499842783775287,Texas
1089,2012,Cass,male,7919,6547,6644,13191,1.209561631281503,Texas
1090,2012,Cass,male,7919,25789,25671,51460,0.3070689053472411,Texas
1091,2012,Cass,male,7919,14798,14224,29022,0.5351398837680768,Texas
1092,2012,Cass,male,7919,50364,52314,102678,0.15723532682074498,Texas
1093,2012,Cass,male,7919,12929,12773,25702,0.6124990331812206,Texas
1094,2012,Cass,male,7919,88346,85856,174202,0.08963620311049736,Texas
1095,2012,Cass,male,7919,14692,15395,30087,0.5390008167710318,Texas
1105,2013,Cass,male,7232,6353,6312,12665,1.138359830001574,Texas
1106,2013,Cass,male,7232,19082,19002,38084,0.37899591237815744,Texas
1107,2013,Cass,male,7232,6547,6644,13191,1.1046280739269894,Texas
1108,2013,Cass,male,7232,25789,25671,51460,0.28042964054441816,Texas
1109,2013,Cass,male,7232,14798,14224,29022,0.488714691174483,Texas
1110,2013,Cass,male,7232,50364,52314,102678,0.14359463108569614,Texas
1111,2013,Cass,male,7232,12929,12773,25702,0.5593626730605615,Texas
1112,2013,Cass,male,7232,88346,85856,174202,0.08185995970389151,Texas
1113,2013,Cass,male,7232,14692,15395,30087,0.49224067519738635,Texas
1123,2014,Cass,male,5601,6353,6312,12665,0.8816307256414292,Texas
1124,2014,Cass,male,5601,19082,19002,38084,0.29352269154176713,Texas
1125,2014,Cass,male,5601,6547,6644,13191,0.8555063387811211,Texas
1126,2014,Cass,male,5601,25789,25671,51460,0.2171856217767265,Texas
1127,2014,Cass,male,5601,14798,14224,29022,0.3784970942019192,Texas
1128,2014,Cass,male,5601,50364,52314,102678,0.11121038837264713,Texas
1129,2014,Cass,male,5601,12929,12773,25702,0.43321215871297086,Texas
1130,2014,Cass,male,5601,88346,85856,174202,0.06339845607045028,Texas
1131,2014,Cass,male,5601,14692,15395,30087,0.3812278791178873,Texas
1141,2015,Cass,male,4551,6353,6312,12665,0.7163544781992759,Texas
1142,2015,Cass,male,4551,19082,19002,38084,0.23849701289173042,Texas
1143,2015,Cass,male,4551,6547,6644,13191,0.6951275393309913,Texas
1144,2015,Cass,male,4551,25789,25671,51460,0.17647058823529413,Texas
1145,2015,Cass,male,4551,14798,14224,29022,0.30754155967022573,Texas
1146,2015,Cass,male,4551,50364,52314,102678,0.0903621634500834,Texas
1147,2015,Cass,male,4551,12929,12773,25702,0.3519993812359811,Texas
1148,2015,Cass,male,4551,88346,85856,174202,0.051513367894415144,Texas
1149,2015,Cass,male,4551,14692,15395,30087,0.3097604138306561,Texas
1159,2016,Cass,male,5261,6353,6312,12665,0.8281127026601606,Texas
1160,2016,Cass,male,5261,19082,19002,38084,0.27570485274080286,Texas
1161,2016,Cass,male,5261,6547,6644,13191,0.8035741561020314,Texas
1162,2016,Cass,male,5261,25789,25671,51460,0.2040017061537865,Texas
1163,2016,Cass,male,5261,14798,14224,29022,0.3555210163535613,Texas
1164,2016,Cass,male,5261,50364,52314,102678,0.10445953458819791,Texas
1165,2016,Cass,male,5261,12929,12773,25702,0.40691468791089797,Texas
1166,2016,Cass,male,5261,88346,85856,174202,0.059549951327734135,Texas
1167,2016,Cass,male,5261,14692,15395,30087,0.3580860332153553,Texas
1169,2009,Castro,male,2550,3905,3882,7787,0.6530089628681178,Texas
1171,2010,Castro,male,2820,3905,3882,7787,0.7221510883482715,Texas
1173,2011,Castro,male,2652,3905,3882,7787,0.6791293213828425,Texas
1175,2012,Castro,male,3233,3905,3882,7787,0.8279129321382842,Texas
1177,2013,Castro,male,2705,3905,3882,7787,0.6927016645326505,Texas
1179,2014,Castro,male,2159,3905,3882,7787,0.5528809218950064,Texas
1181,2015,Castro,male,1830,3905,3882,7787,0.4686299615877081,Texas
1183,2016,Castro,male,2104,3905,3882,7787,0.5387964148527529,Texas
1186,2009,Chambers,male,12417,16257,17569,33826,0.7637940579442701,Texas
1187,2009,Chambers,male,12417,20377,19915,40292,0.60936349806154,Texas
1190,2010,Chambers,male,16140,16257,17569,33826,0.9928031002029895,Texas
1191,2010,Chambers,male,16140,20377,19915,40292,0.7920694901114002,Texas
1194,2011,Chambers,male,17239,16257,17569,33826,1.0604047487236268,Texas
1195,2011,Chambers,male,17239,20377,19915,40292,0.8460028463463709,Texas
1198,2012,Chambers,male,18323,16257,17569,33826,1.1270837177831088,Texas
1199,2012,Chambers,male,18323,20377,19915,40292,0.8992000785198999,Texas
1202,2013,Chambers,male,16436,16257,17569,33826,1.0110106415697853,Texas
1203,2013,Chambers,male,16436,20377,19915,40292,0.8065956715905187,Texas
1206,2014,Chambers,male,12933,16257,17569,33826,0.7955342314080088,Texas
1207,2014,Chambers,male,12933,20377,19915,40292,0.6346861657751386,Texas
1210,2015,Chambers,male,11627,16257,17569,33826,0.7151996063234299,Texas
1211,2015,Chambers,male,11627,20377,19915,40292,0.5705942974922708,Texas
1214,2016,Chambers,male,8936,16257,17569,33826,0.549670910992188,Texas
1215,2016,Chambers,male,8936,20377,19915,40292,0.4385336408696079,Texas
1224,2009,Cherokee,male,5231,12820,13033,25853,0.4080343213728549,Texas
1225,2009,Cherokee,male,5231,119270,122640,241910,0.04385847237360611,Texas
1226,2009,Cherokee,male,5231,5796,5672,11468,0.9025189786059351,Texas
1227,2009,Cherokee,male,5231,9998,10333,20331,0.5232046409281856,Texas
1228,2009,Cherokee,male,5231,13583,14085,27668,0.3851137451225797,Texas
1229,2009,Cherokee,male,5231,23863,24736,48599,0.21920965511461257,Texas
1230,2009,Cherokee,male,5231,27529,29182,56711,0.19001779941152966,Texas
1231,2009,Cherokee,male,5231,26607,25296,51903,0.19660239786522343,Texas
1240,2010,Cherokee,male,6450,12820,13033,25853,0.5031201248049922,Texas
1241,2010,Cherokee,male,6450,119270,122640,241910,0.054078980464492325,Texas
1242,2010,Cherokee,male,6450,5796,5672,11468,1.1128364389233953,Texas
1243,2010,Cherokee,male,6450,9998,10333,20331,0.6451290258051611,Texas
1244,2010,Cherokee,male,6450,13583,14085,27668,0.4748582787307664,Texas
1245,2010,Cherokee,male,6450,23863,24736,48599,0.2702929220969702,Texas
1246,2010,Cherokee,male,6450,27529,29182,56711,0.23429837625776453,Texas
1247,2010,Cherokee,male,6450,26607,25296,51903,0.24241740895253128,Texas
1256,2011,Cherokee,male,8054,12820,13033,25853,0.6282371294851794,Texas
1257,2011,Cherokee,male,8054,119270,122640,241910,0.06752745870713507,Texas
1258,2011,Cherokee,male,8054,5796,5672,11468,1.3895790200138025,Texas
1259,2011,Cherokee,male,8054,9998,10333,20331,0.8055611122224445,Texas
1260,2011,Cherokee,male,8054,13583,14085,27668,0.5929470661856733,Texas
1261,2011,Cherokee,male,8054,23863,24736,48599,0.3375099526463563,Texas
1262,2011,Cherokee,male,8054,27529,29182,56711,0.29256420502016056,Texas
1263,2011,Cherokee,male,8054,26607,25296,51903,0.30270229638816853,Texas
1272,2012,Cherokee,male,9014,12820,13033,25853,0.7031201248049922,Texas
1273,2012,Cherokee,male,9014,119270,122640,241910,0.0755764232413851,Texas
1274,2012,Cherokee,male,9014,5796,5672,11468,1.5552104899930987,Texas
1275,2012,Cherokee,male,9014,9998,10333,20331,0.9015803160632127,Texas
1276,2012,Cherokee,male,9014,13583,14085,27668,0.6636236472060664,Texas
1277,2012,Cherokee,male,9014,23863,24736,48599,0.37773959686544023,Texas
1278,2012,Cherokee,male,9014,27529,29182,56711,0.3274365214864325,Texas
1279,2012,Cherokee,male,9014,26607,25296,51903,0.33878302702296387,Texas
1288,2013,Cherokee,male,8251,12820,13033,25853,0.643603744149766,Texas
1289,2013,Cherokee,male,8251,119270,122640,241910,0.06917917330426762,Texas
1290,2013,Cherokee,male,8251,5796,5672,11468,1.423567977915804,Texas
1291,2013,Cherokee,male,8251,9998,10333,20331,0.8252650530106022,Texas
1292,2013,Cherokee,male,8251,13583,14085,27668,0.6074504895825664,Texas
1293,2013,Cherokee,male,8251,23863,24736,48599,0.34576541088714746,Texas
1294,2013,Cherokee,male,8251,27529,29182,56711,0.2997202949616768,Texas
1295,2013,Cherokee,male,8251,26607,25296,51903,0.3101063629871838,Texas
1304,2014,Cherokee,male,6201,12820,13033,25853,0.4836973478939158,Texas
1305,2014,Cherokee,male,6201,119270,122640,241910,0.05199128028842123,Texas
1306,2014,Cherokee,male,6201,5796,5672,11468,1.0698757763975155,Texas
1307,2014,Cherokee,male,6201,9998,10333,20331,0.6202240448089618,Texas
1308,2014,Cherokee,male,6201,13583,14085,27668,0.4565265405286019,Texas
1309,2014,Cherokee,male,6201,23863,24736,48599,0.2598583581276453,Texas
1310,2014,Cherokee,male,6201,27529,29182,56711,0.22525336917432526,Texas
1311,2014,Cherokee,male,6201,26607,25296,51903,0.23305896944413124,Texas
1320,2015,Cherokee,male,4125,12820,13033,25853,0.3217628705148206,Texas
1321,2015,Cherokee,male,4125,119270,122640,241910,0.03458539448310556,Texas
1322,2015,Cherokee,male,4125,5796,5672,11468,0.7116977225672878,Texas
1323,2015,Cherokee,male,4125,9998,10333,20331,0.41258251650330063,Texas
1324,2015,Cherokee,male,4125,13583,14085,27668,0.30368843407200175,Texas
1325,2015,Cherokee,male,4125,23863,24736,48599,0.17286175250387628,Texas
1326,2015,Cherokee,male,4125,27529,29182,56711,0.1498419848160122,Texas
1327,2015,Cherokee,male,4125,26607,25296,51903,0.15503438944638628,Texas
1336,2016,Cherokee,male,4509,12820,13033,25853,0.3517160686427457,Texas
1337,2016,Cherokee,male,4509,119270,122640,241910,0.03780498029680557,Texas
1338,2016,Cherokee,male,4509,5796,5672,11468,0.7779503105590062,Texas
1339,2016,Cherokee,male,4509,9998,10333,20331,0.45099019803960794,Texas
1340,2016,Cherokee,male,4509,13583,14085,27668,0.33195906648015905,Texas
1341,2016,Cherokee,male,4509,23863,24736,48599,0.18895361019150986,Texas
1342,2016,Cherokee,male,4509,27529,29182,56711,0.16379091140252097,Texas
1343,2016,Cherokee,male,4509,26607,25296,51903,0.16946668170030443,Texas
1345,2009,Childress,male,4348,4449,2777,7226,0.9772982692739941,Texas
1347,2010,Childress,male,3265,4449,2777,7226,0.7338727804000899,Texas
1349,2011,Childress,male,3482,4449,2777,7226,0.7826477860193302,Texas
1351,2012,Childress,male,4580,4449,2777,7226,1.029444819060463,Texas
1353,2013,Childress,male,2889,4449,2777,7226,0.6493594066082266,Texas
1355,2014,Childress,male,2153,4449,2777,7226,0.48392897280287706,Texas
1357,2015,Childress,male,2205,4449,2777,7226,0.49561699258260283,Texas
1359,2016,Childress,male,2008,4449,2777,7226,0.451337379186334,Texas
1378,2009,Clay,male,7018,6464,6914,13378,1.0857054455445545,Texas
1379,2009,Clay,male,7018,7414,7647,15061,0.9465875370919882,Texas
1380,2009,Clay,male,7018,102225,105066,207291,0.06865248226950355,Texas
1381,2009,Clay,male,7018,1473,1528,3001,4.764426340801086,Texas
1382,2009,Clay,male,7018,6586,6752,13338,1.0655936835712116,Texas
1383,2009,Clay,male,7018,12935,13333,26268,0.5425589485890994,Texas
1384,2009,Clay,male,7018,8051,8262,16313,0.8716929573965967,Texas
1385,2009,Clay,male,7018,4078,4064,8142,1.7209416380578715,Texas
1386,2009,Clay,male,7018,10827,9794,20621,0.648194328992334,Texas
1387,2009,Clay,male,7018,31010,31791,62801,0.22631409222831345,Texas
1388,2009,Clay,male,7018,9177,10631,19808,0.7647379317859867,Texas
1389,2009,Clay,male,7018,117296,121868,239164,0.05983153730732506,Texas
1390,2009,Clay,male,7018,3165,3067,6232,2.2173775671406,Texas
1391,2009,Clay,male,7018,5125,5688,10813,1.3693658536585367,Texas
1392,2009,Clay,male,7018,6879,7046,13925,1.0202064253525223,Texas
1393,2009,Clay,male,7018,3771,3915,7686,1.8610448156987536,Texas
1394,2009,Clay,male,7018,5195,5192,10387,1.3509143407122233,Texas
1395,2009,Clay,male,7018,4388,4397,8785,1.5993618960802187,Texas
1414,2010,Clay,male,5267,6464,6914,13378,0.8148205445544554,Texas
1415,2010,Clay,male,5267,7414,7647,15061,0.7104127326679256,Texas
1416,2010,Clay,male,5267,102225,105066,207291,0.05152359990217657,Texas
1417,2010,Clay,male,5267,1473,1528,3001,3.575695858791582,Texas
1418,2010,Clay,male,5267,6586,6752,13338,0.79972669298512,Texas
1419,2010,Clay,male,5267,12935,13333,26268,0.4071897951294936,Texas
1420,2010,Clay,male,5267,8051,8262,16313,0.6542044466525897,Texas
1421,2010,Clay,male,5267,4078,4064,8142,1.2915644923982343,Texas
1422,2010,Clay,male,5267,10827,9794,20621,0.4864690126535513,Texas
1423,2010,Clay,male,5267,31010,31791,62801,0.16984843598839083,Texas
1424,2010,Clay,male,5267,9177,10631,19808,0.5739348370927319,Texas
1425,2010,Clay,male,5267,117296,121868,239164,0.04490349202018824,Texas
1426,2010,Clay,male,5267,3165,3067,6232,1.6641390205371247,Texas
1427,2010,Clay,male,5267,5125,5688,10813,1.0277073170731708,Texas
1428,2010,Clay,male,5267,6879,7046,13925,0.7656636138973688,Texas
1429,2010,Clay,male,5267,3771,3915,7686,1.3967117475470698,Texas
1430,2010,Clay,male,5267,5195,5192,10387,1.0138594802694898,Texas
1431,2010,Clay,male,5267,4388,4397,8785,1.2003190519598905,Texas
1450,2011,Clay,male,5490,6464,6914,13378,0.849319306930693,Texas
1451,2011,Clay,male,5490,7414,7647,15061,0.7404909630428919,Texas
1452,2011,Clay,male,5490,102225,105066,207291,0.0537050623624358,Texas
1453,2011,Clay,male,5490,1473,1528,3001,3.7270875763747453,Texas
1454,2011,Clay,male,5490,6586,6752,13338,0.8335863953841481,Texas
1455,2011,Clay,male,5490,12935,13333,26268,0.42442984151526864,Texas
1456,2011,Clay,male,5490,8051,8262,16313,0.681902869208794,Texas
1457,2011,Clay,male,5490,4078,4064,8142,1.3462481608631682,Texas
1458,2011,Clay,male,5490,10827,9794,20621,0.5070656691604323,Texas
1459,2011,Clay,male,5490,31010,31791,62801,0.17703966462431472,Texas
1460,2011,Clay,male,5490,9177,10631,19808,0.5982347172278523,Texas
1461,2011,Clay,male,5490,117296,121868,239164,0.04680466512072023,Texas
1462,2011,Clay,male,5490,3165,3067,6232,1.7345971563981042,Texas
1463,2011,Clay,male,5490,5125,5688,10813,1.071219512195122,Texas
1464,2011,Clay,male,5490,6879,7046,13925,0.7980811164413432,Texas
1465,2011,Clay,male,5490,3771,3915,7686,1.4558472553699284,Texas
1466,2011,Clay,male,5490,5195,5192,10387,1.0567853705486043,Texas
1467,2011,Clay,male,5490,4388,4397,8785,1.2511394712853237,Texas
1486,2012,Clay,male,5638,6464,6914,13378,0.8722153465346535,Texas
1487,2012,Clay,male,5638,7414,7647,15061,0.760453196654977,Texas
1488,2012,Clay,male,5638,102225,105066,207291,0.055152849107361214,Texas
1489,2012,Clay,male,5638,1473,1528,3001,3.8275627970128987,Texas
1490,2012,Clay,male,5638,6586,6752,13338,0.8560583054965077,Texas
1491,2012,Clay,male,5638,12935,13333,26268,0.4358716660224198,Texas
1492,2012,Clay,male,5638,8051,8262,16313,0.7002856787976649,Texas
1493,2012,Clay,male,5638,4078,4064,8142,1.3825404610102991,Texas
1494,2012,Clay,male,5638,10827,9794,20621,0.5207351990394384,Texas
1495,2012,Clay,male,5638,31010,31791,62801,0.181812318606901,Texas
1496,2012,Clay,male,5638,9177,10631,19808,0.6143619919363627,Texas
1497,2012,Clay,male,5638,117296,121868,239164,0.04806643022779975,Texas
1498,2012,Clay,male,5638,3165,3067,6232,1.7813586097946288,Texas
1499,2012,Clay,male,5638,5125,5688,10813,1.1000975609756098,Texas
1500,2012,Clay,male,5638,6879,7046,13925,0.8195958714929495,Texas
1501,2012,Clay,male,5638,3771,3915,7686,1.4950941394855477,Texas
1502,2012,Clay,male,5638,5195,5192,10387,1.085274302213667,Texas
1503,2012,Clay,male,5638,4388,4397,8785,1.2848678213309024,Texas
1522,2013,Clay,male,6503,6464,6914,13378,1.0060334158415842,Texas
1523,2013,Clay,male,6503,7414,7647,15061,0.877124359320205,Texas
1524,2013,Clay,male,6503,102225,105066,207291,0.06361457569087796,Texas
1525,2013,Clay,male,6503,1473,1528,3001,4.41479972844535,Texas
1526,2013,Clay,male,6503,6586,6752,13338,0.98739750986942,Texas
1527,2013,Clay,male,6503,12935,13333,26268,0.5027444916892153,Texas
1528,2013,Clay,male,6503,8051,8262,16313,0.8077257483542417,Texas
1529,2013,Clay,male,6503,4078,4064,8142,1.5946542422756254,Texas
1530,2013,Clay,male,6503,10827,9794,20621,0.6006280594809273,Texas
1531,2013,Clay,male,6503,31010,31791,62801,0.20970654627539503,Texas
1532,2013,Clay,male,6503,9177,10631,19808,0.7086193745232647,Texas
1533,2013,Clay,male,6503,117296,121868,239164,0.055440935752284815,Texas
1534,2013,Clay,male,6503,3165,3067,6232,2.054660347551343,Texas
1535,2013,Clay,male,6503,5125,5688,10813,1.2688780487804878,Texas
1536,2013,Clay,male,6503,6879,7046,13925,0.9453408925715947,Texas
1537,2013,Clay,male,6503,3771,3915,7686,1.724476266242376,Texas
1538,2013,Clay,male,6503,5195,5192,10387,1.2517805582290664,Texas
1539,2013,Clay,male,6503,4388,4397,8785,1.481996353691887,Texas
1558,2014,Clay,male,4461,6464,6914,13378,0.6901299504950495,Texas
1559,2014,Clay,male,4461,7414,7647,15061,0.601699487456164,Texas
1560,2014,Clay,male,4461,102225,105066,207291,0.04363903154805576,Texas
1561,2014,Clay,male,4461,1473,1528,3001,3.0285132382892055,Texas
1562,2014,Clay,male,4461,6586,6752,13338,0.6773458852110538,Texas
1563,2014,Clay,male,4461,12935,13333,26268,0.3448782373405489,Texas
1564,2014,Clay,male,4461,8051,8262,16313,0.5540926592969817,Texas
1565,2014,Clay,male,4461,4078,4064,8142,1.0939185875429132,Texas
1566,2014,Clay,male,4461,10827,9794,20621,0.4120254918259906,Texas
1567,2014,Clay,male,4461,31010,31791,62801,0.14385682038052242,Texas
1568,2014,Clay,male,4461,9177,10631,19808,0.486106570774763,Texas
1569,2014,Clay,male,4461,117296,121868,239164,0.038031987450552446,Texas
1570,2014,Clay,male,4461,3165,3067,6232,1.409478672985782,Texas
1571,2014,Clay,male,4461,5125,5688,10813,0.8704390243902439,Texas
1572,2014,Clay,male,4461,6879,7046,13925,0.6484954208460532,Texas
1573,2014,Clay,male,4461,3771,3915,7686,1.182975338106603,Texas
1574,2014,Clay,male,4461,5195,5192,10387,0.8587102983638114,Texas
1575,2014,Clay,male,4461,4388,4397,8785,1.0166362807657248,Texas
1594,2015,Clay,male,2903,6464,6914,13378,0.44910272277227725,Texas
1595,2015,Clay,male,2903,7414,7647,15061,0.39155651470191527,Texas
1596,2015,Clay,male,2903,102225,105066,207291,0.028398141354854488,Texas
1597,2015,Clay,male,2903,1473,1528,3001,1.9708078750848608,Texas
1598,2015,Clay,male,2903,6586,6752,13338,0.4407834801093228,Texas
1599,2015,Clay,male,2903,12935,13333,26268,0.22442984151526865,Texas
1600,2015,Clay,male,2903,8051,8262,16313,0.3605763259222457,Texas
1601,2015,Clay,male,2903,4078,4064,8142,0.7118685630210888,Texas
1602,2015,Clay,male,2903,10827,9794,20621,0.26812598134293897,Texas
1603,2015,Clay,male,2903,31010,31791,62801,0.09361496291518864,Texas
1604,2015,Clay,male,2903,9177,10631,19808,0.3163343140459845,Texas
1605,2015,Clay,male,2903,117296,121868,239164,0.024749352066566636,Texas
1606,2015,Clay,male,2903,3165,3067,6232,0.9172195892575039,Texas
1607,2015,Clay,male,2903,5125,5688,10813,0.5664390243902439,Texas
1608,2015,Clay,male,2903,6879,7046,13925,0.42200901293792703,Texas
1609,2015,Clay,male,2903,3771,3915,7686,0.769822328294882,Texas
1610,2015,Clay,male,2903,5195,5192,10387,0.5588065447545717,Texas
1611,2015,Clay,male,2903,4388,4397,8785,0.6615770282588879,Texas
1630,2016,Clay,male,3772,6464,6914,13378,0.5835396039603961,Texas
1631,2016,Clay,male,3772,7414,7647,15061,0.5087671971944969,Texas
1632,2016,Clay,male,3772,102225,105066,207291,0.03689899730985571,Texas
1633,2016,Clay,male,3772,1473,1528,3001,2.5607603530210454,Texas
1634,2016,Clay,male,3772,6586,6752,13338,0.5727300334041907,Texas
1635,2016,Clay,male,3772,12935,13333,26268,0.2916119056822574,Texas
1636,2016,Clay,male,3772,8051,8262,16313,0.46851322817041363,Texas
1637,2016,Clay,male,3772,4078,4064,8142,0.9249632172633644,Texas
1638,2016,Clay,male,3772,10827,9794,20621,0.3483882885379145,Texas
1639,2016,Clay,male,3772,31010,31791,62801,0.1216381812318607,Texas
1640,2016,Clay,male,3772,9177,10631,19808,0.41102756892230574,Texas
1641,2016,Clay,male,3772,117296,121868,239164,0.032157959350702495,Texas
1642,2016,Clay,male,3772,3165,3067,6232,1.1917851500789889,Texas
1643,2016,Clay,male,3772,5125,5688,10813,0.736,Texas
1644,2016,Clay,male,3772,6879,7046,13925,0.5483355138828319,Texas
1645,2016,Clay,male,3772,3771,3915,7686,1.00026518164943,Texas
1646,2016,Clay,male,3772,5195,5192,10387,0.7260827718960539,Texas
1647,2016,Clay,male,3772,4388,4397,8785,0.8596171376481313,Texas
1649,2009,Cochran,male,302,1491,1413,2904,0.20254862508383636,Texas
1651,2010,Cochran,male,342,1491,1413,2904,0.22937625754527163,Texas
1653,2011,Cochran,male,220,1491,1413,2904,0.14755197853789404,Texas
1655,2012,Cochran,male,194,1491,1413,2904,0.1301140174379611,Texas
1657,2013,Cochran,male,200,1491,1413,2904,0.1341381623071764,Texas
1659,2014,Cochran,male,110,1491,1413,2904,0.07377598926894702,Texas
1661,2015,Cochran,male,83,1491,1413,2904,0.055667337357478204,Texas
1663,2016,Cochran,male,51,1491,1413,2904,0.03420523138832998,Texas
1665,2009,Coke,male,1527,1606,1669,3275,0.9508094645080947,Texas
1667,2010,Coke,male,476,1606,1669,3275,0.29638854296388545,Texas
1669,2011,Coke,male,938,1606,1669,3275,0.5840597758405978,Texas
1671,2012,Coke,male,553,1606,1669,3275,0.3443337484433375,Texas
1673,2013,Coke,male,119,1606,1669,3275,0.07409713574097136,Texas
1675,2014,Coke,male,513,1606,1669,3275,0.3194271481942715,Texas
1677,2015,Coke,male,774,1606,1669,3275,0.48194271481942713,Texas
1679,2016,Coke,male,474,1606,1669,3275,0.29514321295143214,Texas
1681,2009,Coleman,male,1707,4220,4171,8391,0.40450236966824643,Texas
1683,2010,Coleman,male,2562,4220,4171,8391,0.6071090047393365,Texas
1685,2011,Coleman,male,2161,4220,4171,8391,0.512085308056872,Texas
1687,2012,Coleman,male,2341,4220,4171,8391,0.554739336492891,Texas
1689,2013,Coleman,male,1960,4220,4171,8391,0.46445497630331756,Texas
1691,2014,Coleman,male,1484,4220,4171,8391,0.35165876777251187,Texas
1693,2015,Coleman,male,963,4220,4171,8391,0.22819905213270142,Texas
1695,2016,Coleman,male,1084,4220,4171,8391,0.25687203791469193,Texas
1697,2009,Collin,male,23718,464248,480102,944350,0.051089073081628786,Texas
1699,2010,Collin,male,18233,464248,480102,944350,0.03927426720201272,Texas
1701,2011,Collin,male,20367,464248,480102,944350,0.04387094828626079,Texas
1703,2012,Collin,male,22281,464248,480102,944350,0.04799374472264824,Texas
1705,2013,Collin,male,16980,464248,480102,944350,0.03657527873033379,Texas
1707,2014,Collin,male,11604,464248,480102,944350,0.024995261153521395,Texas
1709,2015,Collin,male,13773,464248,480102,944350,0.02966733297720184,Texas
1711,2016,Collin,male,14512,464248,480102,944350,0.031259154589788216,Texas
1713,2009,Collingsworth,male,720,1496,1500,2996,0.48128342245989303,Texas
1715,2010,Collingsworth,male,587,1496,1500,2996,0.39237967914438504,Texas
1717,2011,Collingsworth,male,463,1496,1500,2996,0.3094919786096257,Texas
1719,2012,Collingsworth,male,676,1496,1500,2996,0.45187165775401067,Texas
1721,2013,Collingsworth,male,282,1496,1500,2996,0.18850267379679145,Texas
1723,2014,Collingsworth,male,276,1496,1500,2996,0.18449197860962566,Texas
1725,2015,Collingsworth,male,824,1496,1500,2996,0.5508021390374331,Texas
1727,2016,Collingsworth,male,615,1496,1500,2996,0.41109625668449196,Texas
1729,2009,Colorado,male,9707,10538,10484,21022,0.9211425317897134,Texas
1731,2010,Colorado,male,11365,10538,10484,21022,1.0784778895426077,Texas
1733,2011,Colorado,male,9735,10538,10484,21022,0.9237995824634656,Texas
1735,2012,Colorado,male,8357,10538,10484,21022,0.7930347314480927,Texas
1737,2013,Colorado,male,5862,10538,10484,21022,0.5562725374833934,Texas
1739,2014,Colorado,male,7380,10538,10484,21022,0.700322641867527,Texas
1741,2015,Colorado,male,6717,10538,10484,21022,0.6374074776997533,Texas
1743,2016,Colorado,male,6220,10538,10484,21022,0.5902448282406528,Texas
1745,2009,Comal,male,8588,66793,68304,135097,0.12857634782087943,Texas
1747,2010,Comal,male,8456,66793,68304,135097,0.12660009282409834,Texas
1749,2011,Comal,male,9162,66793,68304,135097,0.13717006273112453,Texas
1751,2012,Comal,male,9759,66793,68304,135097,0.14610812510292995,Texas
1753,2013,Comal,male,8309,66793,68304,135097,0.12439926339586484,Texas
1755,2014,Comal,male,7790,66793,68304,135097,0.11662898806761188,Texas
1757,2015,Comal,male,6741,66793,68304,135097,0.10092374949470753,Texas
1759,2016,Comal,male,6315,66793,68304,135097,0.09454583564145944,Texas
1763,2009,Comanche,male,2700,912,868,1780,2.960526315789474,Texas
1764,2009,Comanche,male,2700,63585,58976,122561,0.04246284501061571,Texas
1765,2009,Comanche,male,2700,6738,6757,13495,0.40071237756010686,Texas
1769,2010,Comanche,male,3233,912,868,1780,3.544956140350877,Texas
1770,2010,Comanche,male,3233,63585,58976,122561,0.050845325155303926,Texas
1771,2010,Comanche,male,3233,6738,6757,13495,0.4798159691303057,Texas
1775,2011,Comanche,male,3038,912,868,1780,3.331140350877193,Texas
1776,2011,Comanche,male,3038,63585,58976,122561,0.04777856412675945,Texas
1777,2011,Comanche,male,3038,6738,6757,13495,0.45087563075096465,Texas
1781,2012,Comanche,male,3039,912,868,1780,3.3322368421052633,Texas
1782,2012,Comanche,male,3039,63585,58976,122561,0.047794291106393015,Texas
1783,2012,Comanche,male,3039,6738,6757,13495,0.4510240427426536,Texas
1787,2013,Comanche,male,1984,912,868,1780,2.175438596491228,Texas
1788,2013,Comanche,male,1984,63585,58976,122561,0.031202327592985767,Texas
1789,2013,Comanche,male,1984,6738,6757,13495,0.2944493915108341,Texas
1793,2014,Comanche,male,1209,912,868,1780,1.325657894736842,Texas
1794,2014,Comanche,male,1209,63585,58976,122561,0.019013918376975702,Texas
1795,2014,Comanche,male,1209,6738,6757,13495,0.1794300979519145,Texas
1799,2015,Comanche,male,1201,912,868,1780,1.3168859649122806,Texas
1800,2015,Comanche,male,1201,63585,58976,122561,0.01888810253990721,Texas
1801,2015,Comanche,male,1201,6738,6757,13495,0.1782428020184031,Texas
1805,2016,Comanche,male,1241,912,868,1780,1.3607456140350878,Texas
1806,2016,Comanche,male,1241,63585,58976,122561,0.019517181725249667,Texas
1807,2016,Comanche,male,1241,6738,6757,13495,0.18417928168596023,Texas
1809,2009,Concho,male,2549,2802,1431,4233,0.9097073518915061,Texas
1811,2010,Concho,male,1564,2802,1431,4233,0.5581727337615988,Texas
1813,2011,Concho,male,1663,2802,1431,4233,0.5935046395431834,Texas
1815,2012,Concho,male,1553,2802,1431,4233,0.5542469664525339,Texas
1817,2013,Concho,male,1246,2802,1431,4233,0.4446823697359029,Texas
1819,2014,Concho,male,1511,2802,1431,4233,0.5392576730906495,Texas
1821,2015,Concho,male,883,2802,1431,4233,0.31513204853675947,Texas
1823,2016,Concho,male,559,2802,1431,4233,0.19950035688793719,Texas
1825,2009,Cooke,male,10105,19660,19911,39571,0.5139877924720244,Texas
1827,2010,Cooke,male,9565,19660,19911,39571,0.4865208545269583,Texas
1829,2011,Cooke,male,10215,19660,19911,39571,0.5195829094608342,Texas
1831,2012,Cooke,male,10148,19660,19911,39571,0.51617497456765,Texas
1833,2013,Cooke,male,9491,19660,19911,39571,0.48275686673448626,Texas
1835,2014,Cooke,male,6825,19660,19911,39571,0.34715157680569686,Texas
1837,2015,Cooke,male,5069,19660,19911,39571,0.2578331637843337,Texas
1839,2016,Cooke,male,6608,19660,19911,39571,0.33611393692777214,Texas
1841,2009,Coryell,male,3424,37630,37759,75389,0.09099123040127557,Texas
1843,2010,Coryell,male,4243,37630,37759,75389,0.11275577996279564,Texas
1845,2011,Coryell,male,4197,37630,37759,75389,0.11153335104969439,Texas
1847,2012,Coryell,male,4034,37630,37759,75389,0.10720170077066171,Texas
1849,2013,Coryell,male,3836,37630,37759,75389,0.10193994153600851,Texas
1851,2014,Coryell,male,2755,37630,37759,75389,0.07321286207812915,Texas
1853,2015,Coryell,male,2051,37630,37759,75389,0.05450438479936221,Texas
1855,2016,Coryell,male,2454,37630,37759,75389,0.06521392505979272,Texas
1857,2009,Cottle,male,1124,792,831,1623,1.4191919191919191,Texas
1859,2010,Cottle,male,1667,792,831,1623,2.1047979797979797,Texas
1861,2011,Cottle,male,1689,792,831,1623,2.132575757575758,Texas
1863,2012,Cottle,male,1299,792,831,1623,1.6401515151515151,Texas
1865,2013,Cottle,male,389,792,831,1623,0.4911616161616162,Texas
1867,2014,Cottle,male,523,792,831,1623,0.6603535353535354,Texas
1869,2015,Cottle,male,264,792,831,1623,0.3333333333333333,Texas
1871,2016,Cottle,male,436,792,831,1623,0.5505050505050505,Texas
1873,2009,Crane,male,746,2511,2328,4839,0.29709279171644765,Texas
1875,2010,Crane,male,536,2511,2328,4839,0.21346077260055754,Texas
1877,2011,Crane,male,672,2511,2328,4839,0.26762246117084826,Texas
1879,2012,Crane,male,1132,2511,2328,4839,0.45081640780565513,Texas
1881,2013,Crane,male,657,2511,2328,4839,0.2616487455197133,Texas
1883,2014,Crane,male,524,2511,2328,4839,0.20868180007964954,Texas
1885,2015,Crane,male,390,2511,2328,4839,0.15531660692951016,Texas
1887,2016,Crane,male,760,2511,2328,4839,0.302668259657507,Texas
1890,2009,Crockett,male,7739,6907,7592,14499,1.1204575068770812,Texas
1891,2009,Crockett,male,7739,1771,1862,3633,4.369847543760587,Texas
1894,2010,Crockett,male,5868,6907,7592,14499,0.8495728970609526,Texas
1895,2010,Crockett,male,5868,1771,1862,3633,3.313382269904009,Texas
1898,2011,Crockett,male,6002,6907,7592,14499,0.8689735051397134,Texas
1899,2011,Crockett,male,6002,1771,1862,3633,3.389045736871824,Texas
1902,2012,Crockett,male,4718,6907,7592,14499,0.6830751411611409,Texas
1903,2012,Crockett,male,4718,1771,1862,3633,2.66403162055336,Texas
1906,2013,Crockett,male,4046,6907,7592,14499,0.5857825394527291,Texas
1907,2013,Crockett,male,4046,1771,1862,3633,2.2845849802371543,Texas
1910,2014,Crockett,male,4457,6907,7592,14499,0.6452873896047489,Texas
1911,2014,Crockett,male,4457,1771,1862,3633,2.5166572557876905,Texas
1914,2015,Crockett,male,5796,6907,7592,14499,0.8391486897350514,Texas
1915,2015,Crockett,male,5796,1771,1862,3633,3.272727272727273,Texas
1918,2016,Crockett,male,6507,6907,7592,14499,0.9420877370783264,Texas
1919,2016,Crockett,male,6507,1771,1862,3633,3.674195369847544,Texas
1921,2009,Crosby,male,2361,2921,2940,5861,0.8082848339609723,Texas
1923,2010,Crosby,male,1940,2921,2940,5861,0.6641561109209175,Texas
1925,2011,Crosby,male,2170,2921,2940,5861,0.7428962684012325,Texas
1927,2012,Crosby,male,1641,2921,2940,5861,0.561793906196508,Texas
1929,2013,Crosby,male,673,2921,2940,5861,0.23040054775761726,Texas
1931,2014,Crosby,male,706,2921,2940,5861,0.24169804861348854,Texas
1933,2015,Crosby,male,704,2921,2940,5861,0.24101335159192058,Texas
1935,2016,Crosby,male,1139,2921,2940,5861,0.38993495378295107,Texas
1937,2009,Culberson,male,7630,1231,1010,2241,6.19821283509342,Texas
1939,2010,Culberson,male,7187,1231,1010,2241,5.838342810722989,Texas
1941,2011,Culberson,male,6800,1231,1010,2241,5.523964256701868,Texas
1943,2012,Culberson,male,4031,1231,1010,2241,3.274573517465475,Texas
1945,2013,Culberson,male,4980,1231,1010,2241,4.04549147034931,Texas
1947,2014,Culberson,male,3951,1231,1010,2241,3.2095857026807475,Texas
1949,2015,Culberson,male,10169,1231,1010,2241,8.260763606823721,Texas
1951,2016,Culberson,male,11793,1231,1010,2241,9.580016246953695,Texas
1953,2009,Dallam,male,2131,3795,3448,7243,0.5615283267457181,Texas
1955,2010,Dallam,male,2780,3795,3448,7243,0.7325428194993412,Texas
1957,2011,Dallam,male,3934,3795,3448,7243,1.036627140974967,Texas
1959,2012,Dallam,male,2513,3795,3448,7243,0.6621870882740448,Texas
1961,2013,Dallam,male,2563,3795,3448,7243,0.6753623188405797,Texas
1963,2014,Dallam,male,1757,3795,3448,7243,0.4629776021080369,Texas
1965,2015,Dallam,male,1446,3795,3448,7243,0.38102766798418974,Texas
1967,2016,Dallam,male,1392,3795,3448,7243,0.366798418972332,Texas
1973,2009,Dallas,male,10262,18448,21581,40029,0.556266261925412,Texas
1974,2009,Dallas,male,10262,3618,3814,7432,2.8363736871199556,Texas
1975,2009,Dallas,male,10262,41367,42635,84002,0.24807213479343437,Texas
1976,2009,Dallas,male,10262,8212,8287,16499,1.2496346809547005,Texas
1977,2009,Dallas,male,10262,1275226,1311326,2586552,0.008047201045148075,Texas
1983,2010,Dallas,male,9711,18448,21581,40029,0.5263985255854293,Texas
1984,2010,Dallas,male,9711,3618,3814,7432,2.68407960199005,Texas
1985,2010,Dallas,male,9711,41367,42635,84002,0.23475233882079918,Texas
1986,2010,Dallas,male,9711,8212,8287,16499,1.182537749634681,Texas
1987,2010,Dallas,male,9711,1275226,1311326,2586552,0.0076151207707496555,Texas
1993,2011,Dallas,male,13067,18448,21581,40029,0.7083152645273201,Texas
1994,2011,Dallas,male,13067,3618,3814,7432,3.611663902708679,Texas
1995,2011,Dallas,male,13067,41367,42635,84002,0.31587980757608725,Texas
1996,2011,Dallas,male,13067,8212,8287,16499,1.5912079883097905,Texas
1997,2011,Dallas,male,13067,1275226,1311326,2586552,0.010246811153473973,Texas
2003,2012,Dallas,male,17926,18448,21581,40029,0.9717042497831744,Texas
2004,2012,Dallas,male,17926,3618,3814,7432,4.954671088999447,Texas
2005,2012,Dallas,male,17926,41367,42635,84002,0.4333405854908502,Texas
2006,2012,Dallas,male,17926,8212,8287,16499,2.1829030686799804,Texas
2007,2012,Dallas,male,17926,1275226,1311326,2586552,0.014057116150392165,Texas
2013,2013,Dallas,male,14014,18448,21581,40029,0.7596487424111015,Texas
2014,2013,Dallas,male,14014,3618,3814,7432,3.873410724156993,Texas
2015,2013,Dallas,male,14014,41367,42635,84002,0.3387724514709793,Texas
2016,2013,Dallas,male,14014,8212,8287,16499,1.706527033609352,Texas
2017,2013,Dallas,male,14014,1275226,1311326,2586552,0.010989424619636048,Texas
2023,2014,Dallas,male,7309,18448,21581,40029,0.3961947094535993,Texas
2024,2014,Dallas,male,7309,3618,3814,7432,2.0201768933112216,Texas
2025,2014,Dallas,male,7309,41367,42635,84002,0.17668673096912998,Texas
2026,2014,Dallas,male,7309,8212,8287,16499,0.8900389673648319,Texas
2027,2014,Dallas,male,7309,1275226,1311326,2586552,0.005731533077274146,Texas
2033,2015,Dallas,male,6396,18448,21581,40029,0.3467042497831743,Texas
2034,2015,Dallas,male,6396,3618,3814,7432,1.7678275290215588,Texas
2035,2015,Dallas,male,6396,41367,42635,84002,0.1546159982594822,Texas
2036,2015,Dallas,male,6396,8212,8287,16499,0.7788602045786653,Texas
2037,2015,Dallas,male,6396,1275226,1311326,2586552,0.00501558155181905,Texas
2043,2016,Dallas,male,5556,18448,21581,40029,0.30117085862966175,Texas
2044,2016,Dallas,male,5556,3618,3814,7432,1.5356550580431176,Texas
2045,2016,Dallas,male,5556,41367,42635,84002,0.13430995721227065,Texas
2046,2016,Dallas,male,5556,8212,8287,16499,0.6765708718947882,Texas
2047,2016,Dallas,male,5556,1275226,1311326,2586552,0.004356874781411295,Texas
2052,2009,Dawson,male,2229,11774,12087,23861,0.1893154408017666,Texas
2053,2009,Dawson,male,2229,4877,4314,9191,0.4570432643018249,Texas
2054,2009,Dawson,male,2229,12241,11563,23804,0.1820929662609264,Texas
2055,2009,Dawson,male,2229,7235,5729,12964,0.30808569454042845,Texas
2060,2010,Dawson,male,3265,11774,12087,23861,0.27730592831662987,Texas
2061,2010,Dawson,male,3265,4877,4314,9191,0.6694689358212016,Texas
2062,2010,Dawson,male,3265,12241,11563,23804,0.26672657462625604,Texas
2063,2010,Dawson,male,3265,7235,5729,12964,0.4512785072563925,Texas
2068,2011,Dawson,male,4632,11774,12087,23861,0.39340920672668594,Texas
2069,2011,Dawson,male,4632,4877,4314,9191,0.9497641993028502,Texas
2070,2011,Dawson,male,4632,12241,11563,23804,0.3784004574789641,Texas
2071,2011,Dawson,male,4632,7235,5729,12964,0.6402211472011058,Texas
2076,2012,Dawson,male,4661,11774,12087,23861,0.39587226091387806,Texas
2077,2012,Dawson,male,4661,4877,4314,9191,0.9557104777527168,Texas
2078,2012,Dawson,male,4661,12241,11563,23804,0.38076954497181603,Texas
2079,2012,Dawson,male,4661,7235,5729,12964,0.6442294402211473,Texas
2084,2013,Dawson,male,2458,11774,12087,23861,0.20876507559028368,Texas
2085,2013,Dawson,male,2458,4877,4314,9191,0.5039983596473242,Texas
2086,2013,Dawson,male,2458,12241,11563,23804,0.20080058818723961,Texas
2087,2013,Dawson,male,2458,7235,5729,12964,0.33973738769868694,Texas
2092,2014,Dawson,male,1545,11774,12087,23861,0.13122133514523526,Texas
2093,2014,Dawson,male,1545,4877,4314,9191,0.3167931105187615,Texas
2094,2014,Dawson,male,1545,12241,11563,23804,0.12621517849848868,Texas
2095,2014,Dawson,male,1545,7235,5729,12964,0.21354526606772634,Texas
2100,2015,Dawson,male,2141,11774,12087,23861,0.18184134533718363,Texas
2101,2015,Dawson,male,2141,4877,4314,9191,0.4389993848677466,Texas
2102,2015,Dawson,male,2141,12241,11563,23804,0.17490401111020343,Texas
2103,2015,Dawson,male,2141,7235,5729,12964,0.295922598479613,Texas
2108,2016,Dawson,male,1360,11774,12087,23861,0.11550874808900968,Texas
2109,2016,Dawson,male,1360,4877,4314,9191,0.2788599548903014,Texas
2110,2016,Dawson,male,1360,12241,11563,23804,0.11110203414753697,Texas
2111,2016,Dawson,male,1360,7235,5729,12964,0.18797512093987562,Texas
2113,2009,Deaf Smith,male,3832,9507,9392,18899,0.4030714210581677,Texas
2115,2010,Deaf Smith,male,4619,9507,9392,18899,0.48585252971494686,Texas
2117,2011,Deaf Smith,male,2724,9507,9392,18899,0.28652571789207953,Texas
2119,2012,Deaf Smith,male,2133,9507,9392,18899,0.2243609971599874,Texas
2121,2013,Deaf Smith,male,2904,9507,9392,18899,0.305459135373935,Texas
2123,2014,Deaf Smith,male,2252,9507,9392,18899,0.23687808982854738,Texas
2125,2015,Deaf Smith,male,1714,9507,9392,18899,0.18028820868833492,Texas
2127,2016,Deaf Smith,male,3072,9507,9392,18899,0.3231303250236668,Texas
2131,2009,Delta,male,816,15235,15111,30346,0.05356087955365934,Texas
2132,2009,Delta,male,816,17998,18192,36190,0.045338370930103344,Texas
2133,2009,Delta,male,816,2527,2688,5215,0.3229125445191927,Texas
2137,2010,Delta,male,886,15235,15111,30346,0.05815556284870364,Texas
2138,2010,Delta,male,886,17998,18192,36190,0.04922769196577397,Texas
2139,2010,Delta,male,886,2527,2688,5215,0.3506133755441235,Texas
2143,2011,Delta,male,843,15235,15111,30346,0.05533311453889071,Texas
2144,2011,Delta,male,843,17998,18192,36190,0.04683853761529059,Texas
2145,2011,Delta,male,843,2527,2688,5215,0.333597150771666,Texas
2149,2012,Delta,male,743,15235,15111,30346,0.04876928126025599,Texas
2150,2012,Delta,male,743,17998,18192,36190,0.04128236470718969,Texas
2151,2012,Delta,male,743,2527,2688,5215,0.29402453502176495,Texas
2155,2013,Delta,male,437,15235,15111,30346,0.028683951427633737,Texas
2156,2013,Delta,male,437,17998,18192,36190,0.024280475608400933,Texas
2157,2013,Delta,male,437,2527,2688,5215,0.17293233082706766,Texas
2161,2014,Delta,male,419,15235,15111,30346,0.02750246143747949,Texas
2162,2014,Delta,male,419,17998,18192,36190,0.02328036448494277,Texas
2163,2014,Delta,male,419,2527,2688,5215,0.16580925999208548,Texas
2167,2015,Delta,male,404,15235,15111,30346,0.02651788644568428,Texas
2168,2015,Delta,male,404,17998,18192,36190,0.022446938548727636,Texas
2169,2015,Delta,male,404,2527,2688,5215,0.1598733676296003,Texas
2173,2016,Delta,male,352,15235,15111,30346,0.023104693140794223,Texas
2174,2016,Delta,male,352,17998,18192,36190,0.019557728636515167,Texas
2175,2016,Delta,male,352,2527,2688,5215,0.13929560743965175,Texas
2177,2009,Denton,male,20761,397140,409907,807047,0.05227627536888754,Texas
2179,2010,Denton,male,20327,397140,409907,807047,0.05118346175152339,Texas
2181,2011,Denton,male,20889,397140,409907,807047,0.05259857984589817,Texas
2183,2012,Denton,male,18700,397140,409907,807047,0.04708666968827114,Texas
2185,2013,Denton,male,14345,397140,409907,807047,0.03612076345872992,Texas
2187,2014,Denton,male,12133,397140,409907,807047,0.03055093921539004,Texas
2189,2015,Denton,male,12100,397140,409907,807047,0.030467845092410736,Texas
2191,2016,Denton,male,13123,397140,409907,807047,0.0330437629047691,Texas
2193,2009,Dickens,male,2093,1143,1073,2216,1.831146106736658,Texas
2195,2010,Dickens,male,1754,1143,1073,2216,1.5345581802274715,Texas
2197,2011,Dickens,male,2092,1143,1073,2216,1.8302712160979877,Texas
2199,2012,Dickens,male,1512,1143,1073,2216,1.3228346456692914,Texas
2201,2013,Dickens,male,521,1143,1073,2216,0.4558180227471566,Texas
2203,2014,Dickens,male,668,1143,1073,2216,0.584426946631671,Texas
2205,2015,Dickens,male,250,1143,1073,2216,0.21872265966754156,Texas
2207,2016,Dickens,male,851,1143,1073,2216,0.7445319335083115,Texas
2209,2009,Dimmit,male,2831,5186,5477,10663,0.5458927882761281,Texas
2211,2010,Dimmit,male,3620,5186,5477,10663,0.6980331662167374,Texas
2213,2011,Dimmit,male,2554,5186,5477,10663,0.4924797531816429,Texas
2215,2012,Dimmit,male,3361,5186,5477,10663,0.6480910142691862,Texas
2217,2013,Dimmit,male,1838,5186,5477,10663,0.3544157346702661,Texas
2219,2014,Dimmit,male,1249,5186,5477,10663,0.24084072502892404,Texas
2221,2015,Dimmit,male,2622,5186,5477,10663,0.5055919784033938,Texas
2223,2016,Dimmit,male,2958,5186,5477,10663,0.5703817971461628,Texas
2225,2009,Donley,male,3687,1634,1753,3387,2.2564259485924114,Texas
2227,2010,Donley,male,3533,1634,1753,3387,2.1621787025703796,Texas
2229,2011,Donley,male,3635,1634,1753,3387,2.2246022031823744,Texas
2231,2012,Donley,male,4038,1634,1753,3387,2.471236230110159,Texas
2233,2013,Donley,male,4838,1634,1753,3387,2.960832313341493,Texas
2235,2014,Donley,male,4633,1634,1753,3387,2.835373317013464,Texas
2237,2015,Donley,male,4397,1634,1753,3387,2.6909424724602204,Texas
2239,2016,Donley,male,4454,1634,1753,3387,2.725826193390453,Texas
2242,2009,Duval,male,5666,448163,476066,924229,0.012642721509807815,Texas
2243,2009,Duval,male,5666,5758,5597,11355,0.9840222299409517,Texas
2246,2010,Duval,male,3357,448163,476066,924229,0.0074905782048049485,Texas
2247,2010,Duval,male,3357,5758,5597,11355,0.5830149357415769,Texas
2250,2011,Duval,male,2039,448163,476066,924229,0.0045496839319622544,Texas
2251,2011,Duval,male,2039,5758,5597,11355,0.35411601250434177,Texas
2254,2012,Duval,male,1813,448163,476066,924229,0.004045403123417149,Texas
2255,2012,Duval,male,1813,5758,5597,11355,0.3148662730114623,Texas
2258,2013,Duval,male,1683,448163,476066,924229,0.003755330091953151,Texas
2259,2013,Duval,male,1683,5758,5597,11355,0.29228898923237234,Texas
2262,2014,Duval,male,3001,448163,476066,924229,0.006696224364795844,Texas
2263,2014,Duval,male,3001,5758,5597,11355,0.5211879124696075,Texas
2266,2015,Duval,male,2413,448163,476066,924229,0.005384201730174066,Texas
2267,2015,Duval,male,2413,5758,5597,11355,0.4190691212226468,Texas
2270,2016,Duval,male,2269,448163,476066,924229,0.005062890064552406,Texas
2271,2016,Duval,male,2269,5758,5597,11355,0.39406043765196247,Texas
2273,2009,Eastland,male,7358,9245,9025,18270,0.7958896700919416,Texas
2275,2010,Eastland,male,9186,9245,9025,18270,0.9936181719848567,Texas
2277,2011,Eastland,male,9580,9245,9025,18270,1.0362358031368306,Texas
2279,2012,Eastland,male,9496,9245,9025,18270,1.027149810708491,Texas
2281,2013,Eastland,male,7234,9245,9025,18270,0.7824770146024879,Texas
2283,2014,Eastland,male,8075,9245,9025,18270,0.8734451054624122,Texas
2285,2015,Eastland,male,4527,9245,9025,18270,0.48967009194159006,Texas
2287,2016,Eastland,male,6239,9245,9025,18270,0.6748512709572742,Texas
2289,2009,Ector,male,9168,80249,78093,158342,0.11424441426061384,Texas
2291,2010,Ector,male,9238,80249,78093,158342,0.1151166992735112,Texas
2293,2011,Ector,male,8854,80249,78093,158342,0.1103315929170457,Texas
2295,2012,Ector,male,8409,80249,78093,158342,0.1047863524779125,Texas
2297,2013,Ector,male,6429,80249,78093,158342,0.08011314782738725,Texas
2299,2014,Ector,male,9905,80249,78093,158342,0.12342832932497601,Texas
2301,2015,Ector,male,7937,80249,78093,158342,0.09890465924809032,Texas
2303,2016,Ector,male,7424,80249,78093,158342,0.0925120562249997,Texas
2307,2009,Edwards,male,247,3231,3276,6507,0.07644692045806252,Texas
2308,2009,Edwards,male,247,1494,1431,2925,0.16532797858099063,Texas
2309,2009,Edwards,male,247,1062,993,2055,0.23258003766478344,Texas
2313,2010,Edwards,male,226,3231,3276,6507,0.06994738471061591,Texas
2314,2010,Edwards,male,226,1494,1431,2925,0.15127175368139223,Texas
2315,2010,Edwards,male,226,1062,993,2055,0.2128060263653484,Texas
2319,2011,Edwards,male,118,3231,3276,6507,0.036521200866604764,Texas
2320,2011,Edwards,male,118,1494,1431,2925,0.07898259705488621,Texas
2321,2011,Edwards,male,118,1062,993,2055,0.1111111111111111,Texas
2325,2012,Edwards,male,61,3231,3276,6507,0.01887960383782111,Texas
2326,2012,Edwards,male,61,1494,1431,2925,0.040829986613119144,Texas
2327,2012,Edwards,male,61,1062,993,2055,0.05743879472693032,Texas
2331,2013,Edwards,male,244,3231,3276,6507,0.07551841535128444,Texas
2332,2013,Edwards,male,244,1494,1431,2925,0.16331994645247658,Texas
2333,2013,Edwards,male,244,1062,993,2055,0.2297551789077213,Texas
2337,2014,Edwards,male,86,3231,3276,6507,0.02661714639430517,Texas
2338,2014,Edwards,male,86,1494,1431,2925,0.05756358768406961,Texas
2339,2014,Edwards,male,86,1062,993,2055,0.08097928436911488,Texas
2343,2015,Edwards,male,115,3231,3276,6507,0.03559269575982668,Texas
2344,2015,Edwards,male,115,1494,1431,2925,0.07697456492637215,Texas
2345,2015,Edwards,male,115,1062,993,2055,0.10828625235404897,Texas
2349,2016,Edwards,male,303,3231,3276,6507,0.09377901578458682,Texas
2350,2016,Edwards,male,303,1494,1431,2925,0.20281124497991967,Texas
2351,2016,Edwards,male,303,1062,993,2055,0.2853107344632768,Texas
2354,2009,El Paso,male,22355,347478,340675,688153,0.06433500825951571,Texas
2355,2009,El Paso,male,22355,411682,425972,837654,0.05430162115419183,Texas
2358,2010,El Paso,male,29148,347478,340675,688153,0.08388444736069621,Texas
2359,2010,El Paso,male,29148,411682,425972,837654,0.07080222113184448,Texas
2362,2011,El Paso,male,30208,347478,340675,688153,0.0869350002014516,Texas
2363,2011,El Paso,male,30208,411682,425972,837654,0.07337702401368046,Texas
2366,2012,El Paso,male,28328,347478,340675,688153,0.08152458572916847,Texas
2367,2012,El Paso,male,28328,411682,425972,837654,0.06881039248740532,Texas
2370,2013,El Paso,male,22353,347478,340675,688153,0.06432925249943881,Texas
2371,2013,El Paso,male,22353,411682,425972,837654,0.054296763035546855,Texas
2374,2014,El Paso,male,17025,347478,340675,688153,0.04899590765458533,Texas
2375,2014,El Paso,male,17025,411682,425972,837654,0.04135473496533732,Texas
2378,2015,El Paso,male,30425,347478,340675,688153,0.08755950016979493,Texas
2379,2015,El Paso,male,30425,411682,425972,837654,0.07390412988666009,Texas
2382,2016,El Paso,male,37442,347478,340675,688153,0.10775358439958789,Texas
2383,2016,El Paso,male,37442,411682,425972,837654,0.09094883915254978,Texas
2387,2009,Ellis,male,13808,14394,14484,28878,0.9592885924690844,Texas
2388,2009,Ellis,male,13808,1954,2118,4072,7.066530194472876,Texas
2389,2009,Ellis,male,13808,83184,85654,168838,0.16599346028082324,Texas
2393,2010,Ellis,male,8224,14394,14484,28878,0.5713491732666389,Texas
2394,2010,Ellis,male,8224,1954,2118,4072,4.208802456499488,Texas
2395,2010,Ellis,male,8224,83184,85654,168838,0.09886516637814964,Texas
2399,2011,Ellis,male,8901,14394,14484,28878,0.6183826594414339,Texas
2400,2011,Ellis,male,8901,1954,2118,4072,4.555271238485159,Texas
2401,2011,Ellis,male,8901,83184,85654,168838,0.10700375072129256,Texas
2405,2012,Ellis,male,7375,14394,14484,28878,0.5123662637209948,Texas
2406,2012,Ellis,male,7375,1954,2118,4072,3.7743091095189354,Texas
2407,2012,Ellis,male,7375,83184,85654,168838,0.08865887670705905,Texas
2411,2013,Ellis,male,7646,14394,14484,28878,0.5311935528692511,Texas
2412,2013,Ellis,male,7646,1954,2118,4072,3.9129989764585464,Texas
2413,2013,Ellis,male,7646,83184,85654,168838,0.09191671475283708,Texas
2417,2014,Ellis,male,7404,14394,14484,28878,0.5143809920800333,Texas
2418,2014,Ellis,male,7404,1954,2118,4072,3.789150460593654,Texas
2419,2014,Ellis,male,7404,83184,85654,168838,0.08900750144258511,Texas
2423,2015,Ellis,male,5250,14394,14484,28878,0.36473530637765733,Texas
2424,2015,Ellis,male,5250,1954,2118,4072,2.6867963152507675,Texas
2425,2015,Ellis,male,5250,83184,85654,168838,0.0631130986728217,Texas
2429,2016,Ellis,male,8091,14394,14484,28878,0.5621092121717383,Texas
2430,2016,Ellis,male,8091,1954,2118,4072,4.140736949846469,Texas
2431,2016,Ellis,male,8091,83184,85654,168838,0.09726630121177149,Texas
2433,2009,Erath,male,6340,20216,21266,41482,0.313612979817966,Texas
2435,2010,Erath,male,7377,20216,21266,41482,0.3649089829837752,Texas
2437,2011,Erath,male,8467,20216,21266,41482,0.4188266719430154,Texas
2439,2012,Erath,male,8365,20216,21266,41482,0.41378116343490307,Texas
2441,2013,Erath,male,7545,20216,21266,41482,0.3732192322912545,Texas
2443,2014,Erath,male,5604,20216,21266,41482,0.27720617332805697,Texas
2445,2015,Erath,male,4212,20216,21266,41482,0.20834982192322912,Texas
2447,2016,Erath,male,4560,20216,21266,41482,0.22556390977443608,Texas
2449,2009,Falls,male,3977,8189,9110,17299,0.48565148369764316,Texas
2451,2010,Falls,male,4772,8189,9110,17299,0.5827329344242276,Texas
2453,2011,Falls,male,3225,8189,9110,17299,0.39382097936255955,Texas
2455,2012,Falls,male,3117,8189,9110,17299,0.3806325558676273,Texas
2457,2013,Falls,male,2490,8189,9110,17299,0.30406643057760413,Texas
2459,2014,Falls,male,1585,8189,9110,17299,0.19355232629136646,Texas
2461,2015,Falls,male,1341,8189,9110,17299,0.16375625839540847,Texas
2463,2016,Falls,male,1799,8189,9110,17299,0.21968494321650994,Texas
2466,2009,Fannin,male,3947,12086,12839,24925,0.3265762038722489,Texas
2467,2009,Fannin,male,3947,18034,16141,34175,0.2188643673061994,Texas
2470,2010,Fannin,male,3514,12086,12839,24925,0.29074962766837664,Texas
2471,2010,Fannin,male,3514,18034,16141,34175,0.19485416435621603,Texas
2474,2011,Fannin,male,2888,12086,12839,24925,0.23895416184014562,Texas
2475,2011,Fannin,male,2888,18034,16141,34175,0.16014195408672507,Texas
2478,2012,Fannin,male,2200,12086,12839,24925,0.18202879364554028,Texas
2479,2012,Fannin,male,2200,18034,16141,34175,0.1219917932793612,Texas
2482,2013,Fannin,male,2687,12086,12839,24925,0.22232334932980308,Texas
2483,2013,Fannin,male,2687,18034,16141,34175,0.14899634024620162,Texas
2486,2014,Fannin,male,2355,12086,12839,24925,0.19485354956147607,Texas
2487,2014,Fannin,male,2355,18034,16141,34175,0.13058666962404347,Texas
2490,2015,Fannin,male,2543,12086,12839,24925,0.21040873738209498,Texas
2491,2015,Fannin,male,2543,18034,16141,34175,0.14101142286791615,Texas
2494,2016,Fannin,male,2568,12086,12839,24925,0.2124772464007943,Texas
2495,2016,Fannin,male,2568,18034,16141,34175,0.14239769324609072,Texas
2507,2009,Fayette,male,6254,8170,8415,16585,0.7654834761321909,Texas
2508,2009,Fayette,male,6254,54055,57314,111369,0.1156969753029322,Texas
2509,2009,Fayette,male,6254,11580,10144,21724,0.5400690846286701,Texas
2510,2009,Fayette,male,6254,11474,11785,23259,0.5450583928882692,Texas
2511,2009,Fayette,male,6254,9998,9931,19929,0.6255251050210042,Texas
2512,2009,Fayette,male,6254,156453,162281,318734,0.03997366621285626,Texas
2513,2009,Fayette,male,6254,13960,14685,28645,0.4479942693409742,Texas
2514,2009,Fayette,male,6254,65327,66962,132289,0.09573377011036784,Texas
2515,2009,Fayette,male,6254,19510,20182,39692,0.32055356227575604,Texas
2516,2009,Fayette,male,6254,12351,12715,25066,0.5063557606671525,Texas
2517,2009,Fayette,male,6254,22099,22027,44126,0.28299923073442235,Texas
2529,2010,Fayette,male,4789,8170,8415,16585,0.5861689106487148,Texas
2530,2010,Fayette,male,4789,54055,57314,111369,0.08859494958838221,Texas
2531,2010,Fayette,male,4789,11580,10144,21724,0.4135578583765112,Texas
2532,2010,Fayette,male,4789,11474,11785,23259,0.4173784207774098,Texas
2533,2010,Fayette,male,4789,9998,9931,19929,0.478995799159832,Texas
2534,2010,Fayette,male,4789,156453,162281,318734,0.030609831706646724,Texas
2535,2010,Fayette,male,4789,13960,14685,28645,0.3430515759312321,Texas
2536,2010,Fayette,male,4789,65327,66962,132289,0.073308126808211,Texas
2537,2010,Fayette,male,4789,19510,20182,39692,0.24546386468477704,Texas
2538,2010,Fayette,male,4789,12351,12715,25066,0.38774188324832,Texas
2539,2010,Fayette,male,4789,22099,22027,44126,0.21670663830942577,Texas
2551,2011,Fayette,male,6121,8170,8415,16585,0.749204406364749,Texas
2552,2011,Fayette,male,6121,54055,57314,111369,0.11323651836092868,Texas
2553,2011,Fayette,male,6121,11580,10144,21724,0.5285837651122626,Texas
2554,2011,Fayette,male,6121,11474,11785,23259,0.5334669687990239,Texas
2555,2011,Fayette,male,6121,9998,9931,19929,0.6122224444888977,Texas
2556,2011,Fayette,male,6121,156453,162281,318734,0.03912357065700242,Texas
2557,2011,Fayette,male,6121,13960,14685,28645,0.4384670487106017,Texas
2558,2011,Fayette,male,6121,65327,66962,132289,0.0936978584658717,Texas
2559,2011,Fayette,male,6121,19510,20182,39692,0.31373654536135315,Texas
2560,2011,Fayette,male,6121,12351,12715,25066,0.49558740182981137,Texas
2561,2011,Fayette,male,6121,22099,22027,44126,0.276980858862392,Texas
2573,2012,Fayette,male,6501,8170,8415,16585,0.7957160342717259,Texas
2574,2012,Fayette,male,6501,54055,57314,111369,0.12026639533808159,Texas
2575,2012,Fayette,male,6501,11580,10144,21724,0.56139896373057,Texas
2576,2012,Fayette,male,6501,11474,11785,23259,0.5665853233397246,Texas
2577,2012,Fayette,male,6501,9998,9931,19929,0.6502300460092019,Texas
2578,2012,Fayette,male,6501,156453,162281,318734,0.041552415102299095,Texas
2579,2012,Fayette,male,6501,13960,14685,28645,0.46568767908309455,Texas
2580,2012,Fayette,male,6501,65327,66962,132289,0.09951474887871783,Texas
2581,2012,Fayette,male,6501,19510,20182,39692,0.33321373654536135,Texas
2582,2012,Fayette,male,6501,12351,12715,25066,0.5263541413650716,Texas
2583,2012,Fayette,male,6501,22099,22027,44126,0.29417620706819314,Texas
2595,2013,Fayette,male,5465,8170,8415,16585,0.6689106487148103,Texas
2596,2013,Fayette,male,5465,54055,57314,111369,0.1011007307372121,Texas
2597,2013,Fayette,male,5465,11580,10144,21724,0.47193436960276336,Texas
2598,2013,Fayette,male,5465,11474,11785,23259,0.47629423043402475,Texas
2599,2013,Fayette,male,5465,9998,9931,19929,0.5466093218643728,Texas
2600,2013,Fayette,male,5465,156453,162281,318734,0.03493061814091133,Texas
2601,2013,Fayette,male,5465,13960,14685,28645,0.3914756446991404,Texas
2602,2013,Fayette,male,5465,65327,66962,132289,0.0836560687005373,Texas
2603,2013,Fayette,male,5465,19510,20182,39692,0.28011276268580215,Texas
2604,2013,Fayette,male,5465,12351,12715,25066,0.44247429357946727,Texas
2605,2013,Fayette,male,5465,22099,22027,44126,0.24729625774921943,Texas
2617,2014,Fayette,male,5275,8170,8415,16585,0.6456548347613219,Texas
2618,2014,Fayette,male,5275,54055,57314,111369,0.09758579224863564,Texas
2619,2014,Fayette,male,5275,11580,10144,21724,0.45552677029360966,Texas
2620,2014,Fayette,male,5275,11474,11785,23259,0.4597350531636744,Texas
2621,2014,Fayette,male,5275,9998,9931,19929,0.5276055211042209,Texas
2622,2014,Fayette,male,5275,156453,162281,318734,0.03371619591826299,Texas
2623,2014,Fayette,male,5275,13960,14685,28645,0.377865329512894,Texas
2624,2014,Fayette,male,5275,65327,66962,132289,0.08074762349411423,Texas
2625,2014,Fayette,male,5275,19510,20182,39692,0.2703741670937981,Texas
2626,2014,Fayette,male,5275,12351,12715,25066,0.4270909238118371,Texas
2627,2014,Fayette,male,5275,22099,22027,44126,0.23869858364631885,Texas
2639,2015,Fayette,male,5271,8170,8415,16585,0.6451652386780906,Texas
2640,2015,Fayette,male,5271,54055,57314,111369,0.09751179354361299,Texas
2641,2015,Fayette,male,5271,11580,10144,21724,0.45518134715025904,Texas
2642,2015,Fayette,male,5271,11474,11785,23259,0.45938643890535125,Texas
2643,2015,Fayette,male,5271,9998,9931,19929,0.5272054410882177,Texas
2644,2015,Fayette,male,5271,156453,162281,318734,0.033690629134628294,Texas
2645,2015,Fayette,male,5271,13960,14685,28645,0.3775787965616046,Texas
2646,2015,Fayette,male,5271,65327,66962,132289,0.08068639306871585,Texas
2647,2015,Fayette,male,5271,19510,20182,39692,0.27016914402870323,Texas
2648,2015,Fayette,male,5271,12351,12715,25066,0.42676706339567644,Texas
2649,2015,Fayette,male,5271,22099,22027,44126,0.23851757998099463,Texas
2661,2016,Fayette,male,3987,8170,8415,16585,0.4880048959608323,Texas
2662,2016,Fayette,male,3987,54055,57314,111369,0.07375820923133845,Texas
2663,2016,Fayette,male,3987,11580,10144,21724,0.344300518134715,Texas
2664,2016,Fayette,male,3987,11474,11785,23259,0.3474812619836151,Texas
2665,2016,Fayette,male,3987,9998,9931,19929,0.39877975595119025,Texas
2666,2016,Fayette,male,3987,156453,162281,318734,0.025483691587889015,Texas
2667,2016,Fayette,male,3987,13960,14685,28645,0.2856017191977077,Texas
2668,2016,Fayette,male,3987,65327,66962,132289,0.06103142651583572,Texas
2669,2016,Fayette,male,3987,19510,20182,39692,0.204356740133265,Texas
2670,2016,Fayette,male,3987,12351,12715,25066,0.3228078698081127,Texas
2671,2016,Fayette,male,3987,22099,22027,44126,0.18041540341191908,Texas
2673,2009,Fisher,male,846,1879,2004,3883,0.45023948908994144,Texas
2675,2010,Fisher,male,835,1879,2004,3883,0.44438531133581693,Texas
2677,2011,Fisher,male,734,1879,2004,3883,0.39063331559340075,Texas
2679,2012,Fisher,male,989,1879,2004,3883,0.5263437998935604,Texas
2681,2013,Fisher,male,882,1879,2004,3883,0.46939861628525814,Texas
2683,2014,Fisher,male,652,1879,2004,3883,0.3469930814262906,Texas
2685,2015,Fisher,male,482,1879,2004,3883,0.25651942522618415,Texas
2687,2016,Fisher,male,675,1879,2004,3883,0.35923363491218735,Texas
2694,2009,Floyd,male,740,46810,50014,96824,0.015808587908566547,Texas
2695,2009,Floyd,male,740,37135,39674,76809,0.019927292311835196,Texas
2696,2009,Floyd,male,740,7766,8092,15858,0.09528714911151172,Texas
2697,2009,Floyd,male,740,18070,18856,36926,0.04095185390149419,Texas
2698,2009,Floyd,male,740,2885,2987,5872,0.2564991334488735,Texas
2699,2009,Floyd,male,740,7824,7842,15666,0.09458077709611452,Texas
2706,2010,Floyd,male,832,46810,50014,96824,0.017773979918820765,Texas
2707,2010,Floyd,male,832,37135,39674,76809,0.02240473946411741,Texas
2708,2010,Floyd,male,832,7766,8092,15858,0.10713365954159156,Texas
2709,2010,Floyd,male,832,18070,18856,36926,0.0460431654676259,Texas
2710,2010,Floyd,male,832,2885,2987,5872,0.28838821490467936,Texas
2711,2010,Floyd,male,832,7824,7842,15666,0.10633946830265849,Texas
2718,2011,Floyd,male,944,46810,50014,96824,0.020166631061738945,Texas
2719,2011,Floyd,male,944,37135,39674,76809,0.02542076208428706,Texas
2720,2011,Floyd,male,944,7766,8092,15858,0.12155549832603657,Texas
2721,2011,Floyd,male,944,18070,18856,36926,0.05224128389596015,Texas
2722,2011,Floyd,male,944,2885,2987,5872,0.327209705372617,Texas
2723,2011,Floyd,male,944,7824,7842,15666,0.12065439672801637,Texas
2730,2012,Floyd,male,1050,46810,50014,96824,0.022431104464857937,Texas
2731,2012,Floyd,male,1050,37135,39674,76809,0.02827521206409048,Texas
2732,2012,Floyd,male,1050,7766,8092,15858,0.13520473860417204,Texas
2733,2012,Floyd,male,1050,18070,18856,36926,0.058107360265633644,Texas
2734,2012,Floyd,male,1050,2885,2987,5872,0.36395147313691506,Texas
2735,2012,Floyd,male,1050,7824,7842,15666,0.13420245398773006,Texas
2742,2013,Floyd,male,194,46810,50014,96824,0.004144413586840419,Texas
2743,2013,Floyd,male,194,37135,39674,76809,0.005224182038508146,Texas
2744,2013,Floyd,male,194,7766,8092,15858,0.02498068503734226,Texas
2745,2013,Floyd,male,194,18070,18856,36926,0.010736026563364693,Texas
2746,2013,Floyd,male,194,2885,2987,5872,0.06724436741767764,Texas
2747,2013,Floyd,male,194,7824,7842,15666,0.02479550102249489,Texas
2754,2014,Floyd,male,351,46810,50014,96824,0.007498397778252511,Texas
2755,2014,Floyd,male,351,37135,39674,76809,0.009451999461424531,Texas
2756,2014,Floyd,male,351,7766,8092,15858,0.04519701261910894,Texas
2757,2014,Floyd,male,351,18070,18856,36926,0.019424460431654675,Texas
2758,2014,Floyd,male,351,2885,2987,5872,0.12166377816291161,Texas
2759,2014,Floyd,male,351,7824,7842,15666,0.04486196319018405,Texas
2766,2015,Floyd,male,482,46810,50014,96824,0.010296945097201454,Texas
2767,2015,Floyd,male,482,37135,39674,76809,0.01297966877608725,Texas
2768,2015,Floyd,male,482,7766,8092,15858,0.062065413340200874,Texas
2769,2015,Floyd,male,482,18070,18856,36926,0.02667404537908135,Texas
2770,2015,Floyd,male,482,2885,2987,5872,0.16707105719237436,Texas
2771,2015,Floyd,male,482,7824,7842,15666,0.06160531697341513,Texas
2778,2016,Floyd,male,584,46810,50014,96824,0.012475966673787652,Texas
2779,2016,Floyd,male,584,37135,39674,76809,0.01572640366231318,Texas
2780,2016,Floyd,male,584,7766,8092,15858,0.0751995879474633,Texas
2781,2016,Floyd,male,584,18070,18856,36926,0.032318760376314336,Texas
2782,2016,Floyd,male,584,2885,2987,5872,0.2024263431542461,Texas
2783,2016,Floyd,male,584,7824,7842,15666,0.07464212678936605,Texas
2785,2009,Foard,male,133,712,696,1408,0.18679775280898878,Texas
2787,2010,Foard,male,173,712,696,1408,0.24297752808988765,Texas
2789,2011,Foard,male,217,712,696,1408,0.3047752808988764,Texas
2791,2012,Foard,male,218,712,696,1408,0.3061797752808989,Texas
2793,2013,Foard,male,88,712,696,1408,0.12359550561797752,Texas
2795,2014,Foard,male,160,712,696,1408,0.2247191011235955,Texas
2797,2015,Foard,male,97,712,696,1408,0.13623595505617977,Texas
2799,2016,Foard,male,176,712,696,1408,0.24719101123595505,Texas
2801,2009,Fort Bend,male,18930,363177,376165,739342,0.05212334481533797,Texas
2803,2010,Fort Bend,male,17584,363177,376165,739342,0.04841716298113592,Texas
2805,2011,Fort Bend,male,22598,363177,376165,739342,0.062223103335288306,Texas
2807,2012,Fort Bend,male,23652,363177,376165,739342,0.0651252694966917,Texas
2809,2013,Fort Bend,male,19848,363177,376165,739342,0.05465103792365706,Texas
2811,2014,Fort Bend,male,15884,363177,376165,739342,0.04373624981758206,Texas
2813,2015,Fort Bend,male,16655,363177,376165,739342,0.04585918161117031,Texas
2815,2016,Fort Bend,male,16852,363177,376165,739342,0.046401616842476255,Texas
2841,2009,Franklin,male,4213,15602,15940,31542,0.2700294833995642,Texas
2842,2009,Franklin,male,4213,8675,9105,17780,0.4856484149855908,Texas
2843,2009,Franklin,male,4213,6714,5022,11736,0.6274947870122133,Texas
2844,2009,Franklin,male,4213,10853,11661,22514,0.3881875978991984,Texas
2845,2009,Franklin,male,4213,6787,6492,13279,0.6207455429497569,Texas
2846,2009,Franklin,male,4213,19285,19842,39127,0.2184599429608504,Texas
2847,2009,Franklin,male,4213,11426,11416,22842,0.3687204621039734,Texas
2848,2009,Franklin,male,4213,5117,5128,10245,0.8233339847566934,Texas
2849,2009,Franklin,male,4213,12567,12996,25563,0.3352430970000796,Texas
2850,2009,Franklin,male,4213,24390,25906,50296,0.17273472734727346,Texas
2851,2009,Franklin,male,4213,9981,10341,20322,0.42210199378819757,Texas
2852,2009,Franklin,male,4213,14651,15368,30019,0.28755716333356085,Texas
2853,2009,Franklin,male,4213,34601,36334,70935,0.12175948672003699,Texas
2854,2009,Franklin,male,4213,3706,4051,7757,1.1368051807879116,Texas
2855,2009,Franklin,male,4213,51339,51442,102781,0.0820623697384055,Texas
2856,2009,Franklin,male,4213,1490,1516,3006,2.82751677852349,Texas
2857,2009,Franklin,male,4213,27816,22876,50692,0.1514595916019557,Texas
2858,2009,Franklin,male,4213,32281,32621,64902,0.13051020724265047,Texas
2859,2009,Franklin,male,4213,622353,652980,1275333,0.006769470059596403,Texas
2860,2009,Franklin,male,4213,75503,78248,153751,0.05579910732023893,Texas
2861,2009,Franklin,male,4213,20414,21098,41512,0.20637797589889292,Texas
2862,2009,Franklin,male,4213,5362,5317,10679,0.7857142857142857,Texas
2863,2009,Franklin,male,4213,24357,24668,49025,0.17296875641499362,Texas
2864,2009,Franklin,male,4213,27532,28701,56233,0.15302193810838297,Texas
2865,2009,Franklin,male,4213,47145,43515,90660,0.08936260473008803,Texas
2891,2010,Franklin,male,3482,15602,15940,31542,0.22317651583130368,Texas
2892,2010,Franklin,male,3482,8675,9105,17780,0.40138328530259365,Texas
2893,2010,Franklin,male,3482,6714,5022,11736,0.5186178135239797,Texas
2894,2010,Franklin,male,3482,10853,11661,22514,0.3208329494149083,Texas
2895,2010,Franklin,male,3482,6787,6492,13279,0.5130396345955504,Texas
2896,2010,Franklin,male,3482,19285,19842,39127,0.18055483536427275,Texas
2897,2010,Franklin,male,3482,11426,11416,22842,0.30474356730264307,Texas
2898,2010,Franklin,male,3482,5117,5128,10245,0.6804768418995505,Texas
2899,2010,Franklin,male,3482,12567,12996,25563,0.2770748786504337,Texas
2900,2010,Franklin,male,3482,24390,25906,50296,0.14276342763427635,Texas
2901,2010,Franklin,male,3482,9981,10341,20322,0.3488628393948502,Texas
2902,2010,Franklin,male,3482,14651,15368,30019,0.23766295815985258,Texas
2903,2010,Franklin,male,3482,34601,36334,70935,0.10063292968411318,Texas
2904,2010,Franklin,male,3482,3706,4051,7757,0.9395574743658931,Texas
2905,2010,Franklin,male,3482,51339,51442,102781,0.06782368180135959,Texas
2906,2010,Franklin,male,3482,1490,1516,3006,2.3369127516778523,Texas
2907,2010,Franklin,male,3482,27816,22876,50692,0.12517975266033937,Texas
2908,2010,Franklin,male,3482,32281,32621,64902,0.10786530776617825,Texas
2909,2010,Franklin,male,3482,622353,652980,1275333,0.005594895501427647,Texas
2910,2010,Franklin,male,3482,75503,78248,153751,0.04611737281962306,Texas
2911,2010,Franklin,male,3482,20414,21098,41512,0.17056921720387969,Texas
2912,2010,Franklin,male,3482,5362,5317,10679,0.649384558000746,Texas
2913,2010,Franklin,male,3482,24357,24668,49025,0.14295685018680462,Texas
2914,2010,Franklin,male,3482,27532,28701,56233,0.126471015545547,Texas
2915,2010,Franklin,male,3482,47145,43515,90660,0.0738572489129282,Texas
2941,2011,Franklin,male,2742,15602,15940,31542,0.17574669914113575,Texas
2942,2011,Franklin,male,2742,8675,9105,17780,0.3160806916426513,Texas
2943,2011,Franklin,male,2742,6714,5022,11736,0.40840035746201964,Texas
2944,2011,Franklin,male,2742,10853,11661,22514,0.25264903713259007,Texas
2945,2011,Franklin,male,2742,6787,6492,13279,0.40400766170620306,Texas
2946,2011,Franklin,male,2742,19285,19842,39127,0.14218304381643765,Texas
2947,2011,Franklin,male,2742,11426,11416,22842,0.23997899527393662,Texas
2948,2011,Franklin,male,2742,5117,5128,10245,0.5358608559702951,Texas
2949,2011,Franklin,male,2742,12567,12996,25563,0.21819049892575793,Texas
2950,2011,Franklin,male,2742,24390,25906,50296,0.11242312423124232,Texas
2951,2011,Franklin,male,2742,9981,10341,20322,0.274721971746318,Texas
2952,2011,Franklin,male,2742,14651,15368,30019,0.18715446044638592,Texas
2953,2011,Franklin,male,2742,34601,36334,70935,0.07924626455882779,Texas
2954,2011,Franklin,male,2742,3706,4051,7757,0.7398812736103616,Texas
2955,2011,Franklin,male,2742,51339,51442,102781,0.053409688540875355,Texas
2956,2011,Franklin,male,2742,1490,1516,3006,1.840268456375839,Texas
2957,2011,Franklin,male,2742,27816,22876,50692,0.09857635893011217,Texas
2958,2011,Franklin,male,2742,32281,32621,64902,0.08494160651776587,Texas
2959,2011,Franklin,male,2742,622353,652980,1275333,0.004405859696988686,Texas
2960,2011,Franklin,male,2742,75503,78248,153751,0.036316437757440104,Texas
2961,2011,Franklin,male,2742,20414,21098,41512,0.13431958459880475,Texas
2962,2011,Franklin,male,2742,5362,5317,10679,0.5113763521074226,Texas
2963,2011,Franklin,male,2742,24357,24668,49025,0.1125754403251632,Texas
2964,2011,Franklin,male,2742,27532,28701,56233,0.09959320063925614,Texas
2965,2011,Franklin,male,2742,47145,43515,90660,0.05816099268215081,Texas
2991,2012,Franklin,male,3171,15602,15940,31542,0.20324317395205743,Texas
2992,2012,Franklin,male,3171,8675,9105,17780,0.3655331412103746,Texas
2993,2012,Franklin,male,3171,6714,5022,11736,0.47229669347631814,Texas
2994,2012,Franklin,male,3171,10853,11661,22514,0.292177278171934,Texas
2995,2012,Franklin,male,3171,6787,6492,13279,0.46721673788124357,Texas
2996,2012,Franklin,male,3171,19285,19842,39127,0.16442831215970963,Texas
2997,2012,Franklin,male,3171,11426,11416,22842,0.2775249431122002,Texas
2998,2012,Franklin,male,3171,5117,5128,10245,0.6196990424076607,Texas
2999,2012,Franklin,male,3171,12567,12996,25563,0.252327524468847,Texas
3000,2012,Franklin,male,3171,24390,25906,50296,0.13001230012300122,Texas
3001,2012,Franklin,male,3171,9981,10341,20322,0.31770363691012926,Texas
3002,2012,Franklin,male,3171,14651,15368,30019,0.2164357381748686,Texas
3003,2012,Franklin,male,3171,34601,36334,70935,0.09164475015172972,Texas
3004,2012,Franklin,male,3171,3706,4051,7757,0.8556395035078251,Texas
3005,2012,Franklin,male,3171,51339,51442,102781,0.06176590895810203,Texas
3006,2012,Franklin,male,3171,1490,1516,3006,2.128187919463087,Texas
3007,2012,Franklin,male,3171,27816,22876,50692,0.11399913718723037,Texas
3008,2012,Franklin,male,3171,32281,32621,64902,0.09823115764691305,Texas
3009,2012,Franklin,male,3171,622353,652980,1275333,0.005095179102535057,Texas
3010,2012,Franklin,male,3171,75503,78248,153751,0.04199833119213806,Texas
3011,2012,Franklin,male,3171,20414,21098,41512,0.15533457431174685,Texas
3012,2012,Franklin,male,3171,5362,5317,10679,0.5913838120104439,Texas
3013,2012,Franklin,male,3171,24357,24668,49025,0.13018844685306072,Texas
3014,2012,Franklin,male,3171,27532,28701,56233,0.11517506901060584,Texas
3015,2012,Franklin,male,3171,47145,43515,90660,0.06726057906458797,Texas
3041,2013,Franklin,male,3216,15602,15940,31542,0.20612741956159467,Texas
3042,2013,Franklin,male,3216,8675,9105,17780,0.3707204610951009,Texas
3043,2013,Franklin,male,3216,6714,5022,11736,0.47899910634495085,Texas
3044,2013,Franklin,male,3216,10853,11661,22514,0.296323597162075,Texas
3045,2013,Franklin,male,3216,6787,6492,13279,0.4738470605569471,Texas
3046,2013,Franklin,male,3216,19285,19842,39127,0.16676173191599689,Texas
3047,2013,Franklin,male,3216,11426,11416,22842,0.281463329249081,Texas
3048,2013,Franklin,male,3216,5117,5128,10245,0.6284932577682236,Texas
3049,2013,Franklin,male,3216,12567,12996,25563,0.25590833134399615,Texas
3050,2013,Franklin,male,3216,24390,25906,50296,0.13185731857318572,Texas
3051,2013,Franklin,male,3216,9981,10341,20322,0.3222122031860535,Texas
3052,2013,Franklin,male,3216,14651,15368,30019,0.2195072008736605,Texas
3053,2013,Franklin,male,3216,34601,36334,70935,0.09294529059853761,Texas
3054,2013,Franklin,male,3216,3706,4051,7757,0.8677819751753912,Texas
3055,2013,Franklin,male,3216,51339,51442,102781,0.06264243557529364,Texas
3056,2013,Franklin,male,3216,1490,1516,3006,2.1583892617449663,Texas
3057,2013,Franklin,male,3216,27816,22876,50692,0.11561691113028473,Texas
3058,2013,Franklin,male,3216,32281,32621,64902,0.0996251665066138,Texas
3059,2013,Franklin,male,3216,622353,652980,1275333,0.0051674853338860745,Texas
3060,2013,Franklin,male,3216,75503,78248,153751,0.04259433399997351,Texas
3061,2013,Franklin,male,3216,20414,21098,41512,0.15753894386205544,Texas
3062,2013,Franklin,male,3216,5362,5317,10679,0.5997762029093622,Texas
3063,2013,Franklin,male,3216,24357,24668,49025,0.1320359650203227,Texas
3064,2013,Franklin,male,3216,27532,28701,56233,0.11680953072788028,Texas
3065,2013,Franklin,male,3216,47145,43515,90660,0.06821508113267578,Texas
3091,2014,Franklin,male,2512,15602,15940,31542,0.16100499935905654,Texas
3092,2014,Franklin,male,2512,8675,9105,17780,0.28956772334293945,Texas
3093,2014,Franklin,male,2512,6714,5022,11736,0.37414358057789693,Texas
3094,2014,Franklin,male,2512,10853,11661,22514,0.23145674007186953,Texas
3095,2014,Franklin,male,2512,6787,6492,13279,0.37011934580816264,Texas
3096,2014,Franklin,male,2512,19285,19842,39127,0.1302566761731916,Texas
3097,2014,Franklin,male,2512,11426,11416,22842,0.2198494661298792,Texas
3098,2014,Franklin,male,2512,5117,5128,10245,0.4909126441274184,Texas
3099,2014,Franklin,male,2512,12567,12996,25563,0.1998885971194398,Texas
3100,2014,Franklin,male,2512,24390,25906,50296,0.10299302993029931,Texas
3101,2014,Franklin,male,2512,9981,10341,20322,0.2516781885582607,Texas
3102,2014,Franklin,male,2512,14651,15368,30019,0.17145587331922735,Texas
3103,2014,Franklin,male,2512,34601,36334,70935,0.07259905783069853,Texas
3104,2014,Franklin,male,2512,3706,4051,7757,0.6778197517539126,Texas
3105,2014,Franklin,male,2512,51339,51442,102781,0.04892966360856269,Texas
3106,2014,Franklin,male,2512,1490,1516,3006,1.6859060402684565,Texas
3107,2014,Franklin,male,2512,27816,22876,50692,0.090307736554501,Texas
3108,2014,Franklin,male,2512,32281,32621,64902,0.07781667234596203,Texas
3109,2014,Franklin,male,2512,622353,652980,1275333,0.004036294514527929,Texas
3110,2014,Franklin,male,2512,75503,78248,153751,0.03327020118405891,Texas
3111,2014,Franklin,male,2512,20414,21098,41512,0.12305280689722739,Texas
3112,2014,Franklin,male,2512,5362,5317,10679,0.46848190973517345,Texas
3113,2014,Franklin,male,2512,24357,24668,49025,0.10313256969249086,Texas
3114,2014,Franklin,male,2512,27532,28701,56233,0.09123928519540898,Texas
3115,2014,Franklin,male,2512,47145,43515,90660,0.05328242655636865,Texas
3141,2015,Franklin,male,2544,15602,15940,31542,0.1630560184591719,Texas
3142,2015,Franklin,male,2544,8675,9105,17780,0.2932564841498559,Texas
3143,2015,Franklin,male,2544,6714,5022,11736,0.37890974084003576,Texas
3144,2015,Franklin,male,2544,10853,11661,22514,0.2344052335759698,Texas
3145,2015,Franklin,male,2544,6787,6492,13279,0.37483424193310744,Texas
3146,2015,Franklin,male,2544,19285,19842,39127,0.13191599688877365,Texas
3147,2015,Franklin,male,2544,11426,11416,22842,0.22265009627166113,Texas
3148,2015,Franklin,male,2544,5117,5128,10245,0.49716630838381864,Texas
3149,2015,Franklin,male,2544,12567,12996,25563,0.20243494867510145,Texas
3150,2015,Franklin,male,2544,24390,25906,50296,0.10430504305043051,Texas
3151,2015,Franklin,male,2544,9981,10341,20322,0.2548842801322513,Texas
3152,2015,Franklin,male,2544,14651,15368,30019,0.17364002457170158,Texas
3153,2015,Franklin,male,2544,34601,36334,70935,0.07352388659287304,Texas
3154,2015,Franklin,male,2544,3706,4051,7757,0.6864543982730706,Texas
3155,2015,Franklin,male,2544,51339,51442,102781,0.04955297142523228,Texas
3156,2015,Franklin,male,2544,1490,1516,3006,1.7073825503355704,Texas
3157,2015,Franklin,male,2544,27816,22876,50692,0.091458153580673,Texas
3158,2015,Franklin,male,2544,32281,32621,64902,0.07880796753508255,Texas
3159,2015,Franklin,male,2544,622353,652980,1275333,0.004087712279044208,Texas
3160,2015,Franklin,male,2544,75503,78248,153751,0.03369402540296412,Texas
3161,2015,Franklin,male,2544,20414,21098,41512,0.12462035857744685,Texas
3162,2015,Franklin,male,2544,5362,5317,10679,0.474449832152182,Texas
3163,2015,Franklin,male,2544,24357,24668,49025,0.1044463603892105,Texas
3164,2015,Franklin,male,2544,27532,28701,56233,0.09240156908324858,Texas
3165,2015,Franklin,male,2544,47145,43515,90660,0.05396118358256443,Texas
3191,2016,Franklin,male,2187,15602,15940,31542,0.1401743366235098,Texas
3192,2016,Franklin,male,2187,8675,9105,17780,0.2521037463976945,Texas
3193,2016,Franklin,male,2187,6714,5022,11736,0.3257372654155496,Texas
3194,2016,Franklin,male,2187,10853,11661,22514,0.20151110292085136,Texas
3195,2016,Franklin,male,2187,6787,6492,13279,0.32223368203919256,Texas
3196,2016,Franklin,male,2187,19285,19842,39127,0.11340420015556131,Texas
3197,2016,Franklin,male,2187,11426,11416,22842,0.1914055662524068,Texas
3198,2016,Franklin,male,2187,5117,5128,10245,0.4273988665233535,Texas
3199,2016,Franklin,male,2187,12567,12996,25563,0.17402721413225114,Texas
3200,2016,Franklin,male,2187,24390,25906,50296,0.0896678966789668,Texas
3201,2016,Franklin,male,2187,9981,10341,20322,0.21911632100991885,Texas
3202,2016,Franklin,male,2187,14651,15368,30019,0.14927308716128593,Texas
3203,2016,Franklin,male,2187,34601,36334,70935,0.06320626571486374,Texas
3204,2016,Franklin,male,2187,3706,4051,7757,0.5901241230437129,Texas
3205,2016,Franklin,male,2187,51339,51442,102781,0.04259919359551218,Texas
3206,2016,Franklin,male,2187,1490,1516,3006,1.4677852348993288,Texas
3207,2016,Franklin,male,2187,27816,22876,50692,0.07862381363244177,Texas
3208,2016,Franklin,male,2187,32281,32621,64902,0.06774883058145659,Texas
3209,2016,Franklin,male,2187,622353,652980,1275333,0.0035140828436594665,Texas
3210,2016,Franklin,male,2187,75503,78248,153751,0.02896573646080288,Texas
3211,2016,Franklin,male,2187,20414,21098,41512,0.10713236014499854,Texas
3212,2016,Franklin,male,2187,5362,5317,10679,0.40787019768743005,Texas
3213,2016,Franklin,male,2187,24357,24668,49025,0.08978938292893214,Texas
3214,2016,Franklin,male,2187,27532,28701,56233,0.079434839459538,Texas
3215,2016,Franklin,male,2187,47145,43515,90660,0.04638880050906777,Texas
3217,2009,Freestone,male,4987,10163,9546,19709,0.49070156449867164,Texas
3219,2010,Freestone,male,8896,10163,9546,19709,0.8753320869821903,Texas
3221,2011,Freestone,male,7780,10163,9546,19709,0.7655219915379318,Texas
3223,2012,Freestone,male,5396,10163,9546,19709,0.5309455869329922,Texas
3225,2013,Freestone,male,4027,10163,9546,19709,0.3962412673423202,Texas
3227,2014,Freestone,male,5457,10163,9546,19709,0.5369477516481354,Texas
3229,2015,Freestone,male,5614,10163,9546,19709,0.5523959460789137,Texas
3231,2016,Freestone,male,3608,10163,9546,19709,0.3550132834792876,Texas
3233,2009,Frio,male,11082,11580,7814,19394,0.9569948186528497,Texas
3235,2010,Frio,male,10560,11580,7814,19394,0.9119170984455959,Texas
3237,2011,Frio,male,14570,11580,7814,19394,1.258203799654577,Texas
3239,2012,Frio,male,10225,11580,7814,19394,0.8829879101899827,Texas
3241,2013,Frio,male,9170,11580,7814,19394,0.7918825561312608,Texas
3243,2014,Frio,male,9073,11580,7814,19394,0.7835060449050086,Texas
3245,2015,Frio,male,5092,11580,7814,19394,0.4397236614853195,Texas
3247,2016,Frio,male,6241,11580,7814,19394,0.5389464594127806,Texas
3249,2009,Gaines,male,3008,10320,10001,20321,0.29147286821705426,Texas
3251,2010,Gaines,male,2298,10320,10001,20321,0.22267441860465118,Texas
3253,2011,Gaines,male,3380,10320,10001,20321,0.32751937984496127,Texas
3255,2012,Gaines,male,3029,10320,10001,20321,0.2935077519379845,Texas
3257,2013,Gaines,male,1843,10320,10001,20321,0.17858527131782945,Texas
3259,2014,Gaines,male,1746,10320,10001,20321,0.1691860465116279,Texas
3261,2015,Gaines,male,2554,10320,10001,20321,0.24748062015503877,Texas
3263,2016,Gaines,male,1790,10320,10001,20321,0.17344961240310078,Texas
3265,2009,Galveston,male,12002,161269,165820,327089,0.07442223861994555,Texas
3267,2010,Galveston,male,12010,161269,165820,327089,0.07447184517793252,Texas
3269,2011,Galveston,male,11708,161269,165820,327089,0.07259919761392455,Texas
3271,2012,Galveston,male,11522,161269,165820,327089,0.0714458451407276,Texas
3273,2013,Galveston,male,9287,161269,165820,327089,0.05758701300311901,Texas
3275,2014,Galveston,male,10588,161269,165820,327089,0.06565427949574934,Texas
3277,2015,Galveston,male,9428,161269,165820,327089,0.058461328587639284,Texas
3279,2016,Galveston,male,9933,161269,165820,327089,0.06159274256056651,Texas
3281,2009,Garza,male,3153,4070,2218,6288,0.7746928746928747,Texas
3283,2010,Garza,male,1610,4070,2218,6288,0.3955773955773956,Texas
3285,2011,Garza,male,2233,4070,2218,6288,0.5486486486486486,Texas
3287,2012,Garza,male,3249,4070,2218,6288,0.7982800982800983,Texas
3289,2013,Garza,male,2662,4070,2218,6288,0.654054054054054,Texas
3291,2014,Garza,male,2151,4070,2218,6288,0.5285012285012285,Texas
3293,2015,Garza,male,1612,4070,2218,6288,0.3960687960687961,Texas
3295,2016,Garza,male,2171,4070,2218,6288,0.5334152334152334,Texas
3297,2009,Gillespie,male,3472,12731,13477,26208,0.2727201319613542,Texas
3299,2010,Gillespie,male,4415,12731,13477,26208,0.34679129683449844,Texas
3301,2011,Gillespie,male,3717,12731,13477,26208,0.29196449611185293,Texas
3303,2012,Gillespie,male,4209,12731,13477,26208,0.33061032126305867,Texas
3305,2013,Gillespie,male,3566,12731,13477,26208,0.2801036839211374,Texas
3307,2014,Gillespie,male,2505,12731,13477,26208,0.19676380488571205,Texas
3309,2015,Gillespie,male,1840,12731,13477,26208,0.14452910219150106,Texas
3311,2016,Gillespie,male,1548,12731,13477,26208,0.12159296206111067,Texas
3313,2009,Glasscock,male,365,787,643,1430,0.46378653113087676,Texas
3315,2010,Glasscock,male,223,787,643,1430,0.2833545108005083,Texas
3317,2011,Glasscock,male,271,787,643,1430,0.3443456162642948,Texas
3319,2012,Glasscock,male,750,787,643,1430,0.9529860228716646,Texas
3321,2013,Glasscock,male,636,787,643,1430,0.8081321473951716,Texas
3323,2014,Glasscock,male,545,787,643,1430,0.6925031766200762,Texas
3325,2015,Glasscock,male,770,787,643,1430,0.9783989834815756,Texas
3327,2016,Glasscock,male,309,787,643,1430,0.3926302414231258,Texas
3329,2009,Goliad,male,4825,3734,3797,7531,1.2921799678628816,Texas
3331,2010,Goliad,male,2360,3734,3797,7531,0.6320299946438136,Texas
3333,2011,Goliad,male,2258,3734,3797,7531,0.6047134440278522,Texas
3335,2012,Goliad,male,2174,3734,3797,7531,0.5822174611676486,Texas
3337,2013,Goliad,male,1669,3734,3797,7531,0.4469737546866631,Texas
3339,2014,Goliad,male,572,3734,3797,7531,0.1531869309051955,Texas
3341,2015,Goliad,male,1428,3734,3797,7531,0.3824317086234601,Texas
3343,2016,Goliad,male,755,3734,3797,7531,0.2021960364220675,Texas
3345,2009,Gonzales,male,9497,10448,10219,20667,0.9089777947932619,Texas
3347,2010,Gonzales,male,10449,10448,10219,20667,1.0000957120980092,Texas
3349,2011,Gonzales,male,12322,10448,10219,20667,1.179364471669219,Texas
3351,2012,Gonzales,male,10853,10448,10219,20667,1.0387633996937213,Texas
3353,2013,Gonzales,male,9800,10448,10219,20667,0.9379785604900459,Texas
3355,2014,Gonzales,male,7899,10448,10219,20667,0.7560298621745789,Texas
3357,2015,Gonzales,male,9085,10448,10219,20667,0.8695444104134763,Texas
3359,2016,Gonzales,male,6829,10448,10219,20667,0.6536179173047473,Texas
3362,2009,Gray,male,3596,3025,3012,6037,1.1887603305785124,Texas
3363,2009,Gray,male,3596,11903,10782,22685,0.3021087120893892,Texas
3366,2010,Gray,male,4621,3025,3012,6037,1.527603305785124,Texas
3367,2010,Gray,male,4621,11903,10782,22685,0.38822145677560277,Texas
3370,2011,Gray,male,3173,3025,3012,6037,1.0489256198347108,Texas
3371,2011,Gray,male,3173,11903,10782,22685,0.2665714525749811,Texas
3374,2012,Gray,male,4107,3025,3012,6037,1.357685950413223,Texas
3375,2012,Gray,male,4107,11903,10782,22685,0.3450390657817357,Texas
3378,2013,Gray,male,3979,3025,3012,6037,1.3153719008264462,Texas
3379,2013,Gray,male,3979,11903,10782,22685,0.334285474250189,Texas
3382,2014,Gray,male,4954,3025,3012,6037,1.637685950413223,Texas
3383,2014,Gray,male,4954,11903,10782,22685,0.41619759724439215,Texas
3386,2015,Gray,male,2274,3025,3012,6037,0.7517355371900827,Texas
3387,2015,Gray,male,2274,11903,10782,22685,0.19104427455263379,Texas
3390,2016,Gray,male,2894,3025,3012,6037,0.956694214876033,Texas
3391,2016,Gray,male,2894,11903,10782,22685,0.24313198353356297,Texas
3395,2009,Grayson,male,10312,13073,13105,26178,0.7888013462862388,Texas
3396,2009,Grayson,male,10312,62737,65823,128560,0.16436871383712962,Texas
3397,2009,Grayson,male,10312,7995,7816,15811,1.2898061288305191,Texas
3401,2010,Grayson,male,10549,13073,13105,26178,0.8069303143884342,Texas
3402,2010,Grayson,male,10549,62737,65823,128560,0.16814638889331654,Texas
3403,2010,Grayson,male,10549,7995,7816,15811,1.319449656035022,Texas
3407,2011,Grayson,male,9329,13073,13105,26178,0.7136082001070909,Texas
3408,2011,Grayson,male,9329,62737,65823,128560,0.1487001291104133,Texas
3409,2011,Grayson,male,9329,7995,7816,15811,1.1668542839274547,Texas
3413,2012,Grayson,male,8658,13073,13105,26178,0.6622810372523522,Texas
3414,2012,Grayson,male,8658,62737,65823,128560,0.13800468622981654,Texas
3415,2012,Grayson,male,8658,7995,7816,15811,1.0829268292682928,Texas
3419,2013,Grayson,male,8120,13073,13105,26178,0.6211275147250057,Texas
3420,2013,Grayson,male,8120,62737,65823,128560,0.1294292044567002,Texas
3421,2013,Grayson,male,8120,7995,7816,15811,1.0156347717323326,Texas
3425,2014,Grayson,male,6498,13073,13105,26178,0.49705499885259696,Texas
3426,2014,Grayson,male,6498,62737,65823,128560,0.10357524267975836,Texas
3427,2014,Grayson,male,6498,7995,7816,15811,0.8127579737335835,Texas
3431,2015,Grayson,male,5999,13073,13105,26178,0.4588847242408017,Texas
3432,2015,Grayson,male,5999,62737,65823,128560,0.09562140363740695,Texas
3433,2015,Grayson,male,5999,7995,7816,15811,0.7503439649781113,Texas
3437,2016,Grayson,male,7042,13073,13105,26178,0.5386674825977205,Texas
3438,2016,Grayson,male,7042,62737,65823,128560,0.11224636179606931,Texas
3439,2016,Grayson,male,7042,7995,7816,15811,0.8808005003126954,Texas
3441,2009,Gregg,male,13309,60208,63286,123494,0.22105035875631146,Texas
3443,2010,Gregg,male,12741,60208,63286,123494,0.21161639649216052,Texas
3445,2011,Gregg,male,14622,60208,63286,123494,0.2428580919479139,Texas
3447,2012,Gregg,male,14316,60208,63286,123494,0.23777571086898752,Texas
3449,2013,Gregg,male,11105,60208,63286,123494,0.18444392771724688,Texas
3451,2014,Gregg,male,7824,60208,63286,123494,0.1299495083709806,Texas
3453,2015,Gregg,male,7743,60208,63286,123494,0.1286041722030295,Texas
3455,2016,Gregg,male,6623,60208,63286,123494,0.11000199309061919,Texas
3457,2009,Grimes,male,4284,14892,12738,27630,0.2876712328767123,Texas
3459,2010,Grimes,male,4110,14892,12738,27630,0.27598710717163577,Texas
3461,2011,Grimes,male,4618,14892,12738,27630,0.31009938221864086,Texas
3463,2012,Grimes,male,4046,14892,12738,27630,0.271689497716895,Texas
3465,2013,Grimes,male,4079,14892,12738,27630,0.2739054525919957,Texas
3467,2014,Grimes,male,2006,14892,12738,27630,0.13470319634703196,Texas
3469,2015,Grimes,male,1325,14892,12738,27630,0.08897394574268064,Texas
3471,2016,Grimes,male,2729,14892,12738,27630,0.18325275315605694,Texas
3474,2009,Guadalupe,male,12453,2507,1875,4382,4.967291583566015,Texas
3475,2009,Guadalupe,male,12453,76850,78287,155137,0.16204294079375406,Texas
3478,2010,Guadalupe,male,13781,2507,1875,4382,5.497008376545672,Texas
3479,2010,Guadalupe,male,13781,76850,78287,155137,0.17932335718932987,Texas
3482,2011,Guadalupe,male,12280,2507,1875,4382,4.898284802552852,Texas
3483,2011,Guadalupe,male,12280,76850,78287,155137,0.15979180221210149,Texas
3486,2012,Guadalupe,male,12169,2507,1875,4382,4.8540087754288,Texas
3487,2012,Guadalupe,male,12169,76850,78287,155137,0.15834743005855562,Texas
3490,2013,Guadalupe,male,13595,2507,1875,4382,5.422816114878341,Texas
3491,2013,Guadalupe,male,13595,76850,78287,155137,0.17690305790500976,Texas
3494,2014,Guadalupe,male,11270,2507,1875,4382,4.495412844036697,Texas
3495,2014,Guadalupe,male,11270,76850,78287,155137,0.14664931685100846,Texas
3498,2015,Guadalupe,male,7740,2507,1875,4382,3.0873554048663743,Texas
3499,2015,Guadalupe,male,7740,76850,78287,155137,0.1007156798959011,Texas
3502,2016,Guadalupe,male,6145,2507,1875,4382,2.4511368169126446,Texas
3503,2016,Guadalupe,male,6145,76850,78287,155137,0.07996096291476903,Texas
3506,2009,Hale,male,8317,7019,7868,14887,1.1849266277247472,Texas
3507,2009,Hale,male,8317,17751,16362,34113,0.4685369838318968,Texas
3510,2010,Hale,male,6852,7019,7868,14887,0.9762074369568314,Texas
3511,2010,Hale,male,6852,17751,16362,34113,0.3860064221733987,Texas
3514,2011,Hale,male,6769,7019,7868,14887,0.9643823906539393,Texas
3515,2011,Hale,male,6769,17751,16362,34113,0.38133062926032335,Texas
3518,2012,Hale,male,6210,7019,7868,14887,0.8847414161561477,Texas
3519,2012,Hale,male,6210,17751,16362,34113,0.34983944566503294,Texas
3522,2013,Hale,male,5100,7019,7868,14887,0.7265992306596382,Texas
3523,2013,Hale,male,5100,17751,16362,34113,0.28730775730944735,Texas
3526,2014,Hale,male,3019,7019,7868,14887,0.43011825046302893,Texas
3527,2014,Hale,male,3019,17751,16362,34113,0.17007492535631796,Texas
3530,2015,Hale,male,4290,7019,7868,14887,0.6111981763784015,Texas
3531,2015,Hale,male,4290,17751,16362,34113,0.2416765252661822,Texas
3534,2016,Hale,male,4145,7019,7868,14887,0.5905399629576863,Texas
3535,2016,Hale,male,4145,17751,16362,34113,0.23350797138189397,Texas
3539,2009,Hall,male,1194,97518,98443,195961,0.012243893435058143,Texas
3540,2009,Hall,male,1194,30830,30513,61343,0.03872851119039896,Texas
3541,2009,Hall,male,1194,1546,1528,3074,0.7723156532988357,Texas
3545,2010,Hall,male,1181,97518,98443,195961,0.012110584712565885,Texas
3546,2010,Hall,male,1181,30830,30513,61343,0.03830684398313331,Texas
3547,2010,Hall,male,1181,1546,1528,3074,0.7639068564036222,Texas
3551,2011,Hall,male,950,97518,98443,195961,0.009741791259049611,Texas
3552,2011,Hall,male,950,30830,30513,61343,0.03081414206941291,Texas
3553,2011,Hall,male,950,1546,1528,3074,0.6144890038809832,Texas
3557,2012,Hall,male,693,97518,98443,195961,0.0071063803605488215,Texas
3558,2012,Hall,male,693,30830,30513,61343,0.022478105741161207,Texas
3559,2012,Hall,male,693,1546,1528,3074,0.4482535575679172,Texas
3563,2013,Hall,male,818,97518,98443,195961,0.008388194999897455,Texas
3564,2013,Hall,male,818,30830,30513,61343,0.02653259811871554,Texas
3565,2013,Hall,male,818,1546,1528,3074,0.5291073738680466,Texas
3569,2014,Hall,male,306,97518,98443,195961,0.0031378822371254536,Texas
3570,2014,Hall,male,306,30830,30513,61343,0.009925397340253,Texas
3571,2014,Hall,male,306,1546,1528,3074,0.1979301423027167,Texas
3575,2015,Hall,male,1339,97518,98443,195961,0.013730798416702557,Texas
3576,2015,Hall,male,1339,30830,30513,61343,0.043431722348361984,Texas
3577,2015,Hall,male,1339,1546,1528,3074,0.8661060802069858,Texas
3581,2016,Hall,male,697,97518,98443,195961,0.007147398429007978,Texas
3582,2016,Hall,male,697,30830,30513,61343,0.022607849497242944,Texas
3583,2016,Hall,male,697,1546,1528,3074,0.45084087968952136,Texas
3594,2009,Hamilton,male,2161,8281,5988,14269,0.26095882139838183,Texas
3595,2009,Hamilton,male,2161,4018,4203,8221,0.5378297660527626,Texas
3596,2009,Hamilton,male,2161,154532,161563,316095,0.01398415862086817,Texas
3597,2009,Hamilton,male,2161,7377,7733,15110,0.29293750847227873,Texas
3598,2009,Hamilton,male,2161,1353,1263,2616,1.5971914264597191,Texas
3599,2009,Hamilton,male,2161,4564,4614,9178,0.47348816827344437,Texas
3600,2009,Hamilton,male,2161,2347,2228,4575,0.9207498934810396,Texas
3601,2009,Hamilton,male,2161,391728,420309,812037,0.005516582935097823,Texas
3602,2009,Hamilton,male,2161,172447,185099,357546,0.012531386454968773,Texas
3603,2009,Hamilton,male,2161,4070,4199,8269,0.5309582309582309,Texas
3614,2010,Hamilton,male,2717,8281,5988,14269,0.3281004709576138,Texas
3615,2010,Hamilton,male,2717,4018,4203,8221,0.6762070681931309,Texas
3616,2010,Hamilton,male,2717,154532,161563,316095,0.017582118913881915,Texas
3617,2010,Hamilton,male,2717,7377,7733,15110,0.3683068998237766,Texas
3618,2010,Hamilton,male,2717,1353,1263,2616,2.008130081300813,Texas
3619,2010,Hamilton,male,2717,4564,4614,9178,0.5953111305872042,Texas
3620,2010,Hamilton,male,2717,2347,2228,4575,1.1576480613549212,Texas
3621,2010,Hamilton,male,2717,391728,420309,812037,0.006935935138667647,Texas
3622,2010,Hamilton,male,2717,172447,185099,357546,0.015755565478088922,Texas
3623,2010,Hamilton,male,2717,4070,4199,8269,0.6675675675675675,Texas
3634,2011,Hamilton,male,2031,8281,5988,14269,0.2452602342712233,Texas
3635,2011,Hamilton,male,2031,4018,4203,8221,0.5054753608760577,Texas
3636,2011,Hamilton,male,2031,154532,161563,316095,0.013142908912069992,Texas
3637,2011,Hamilton,male,2031,7377,7733,15110,0.2753151687677918,Texas
3638,2011,Hamilton,male,2031,1353,1263,2616,1.501108647450111,Texas
3639,2011,Hamilton,male,2031,4564,4614,9178,0.44500438212094656,Texas
3640,2011,Hamilton,male,2031,2347,2228,4575,0.8653600340860673,Texas
3641,2011,Hamilton,male,2031,391728,420309,812037,0.005184720009802721,Texas
3642,2011,Hamilton,male,2031,172447,185099,357546,0.01177753164740471,Texas
3643,2011,Hamilton,male,2031,4070,4199,8269,0.49901719901719904,Texas
3654,2012,Hamilton,male,1578,8281,5988,14269,0.19055669605120154,Texas
3655,2012,Hamilton,male,1578,4018,4203,8221,0.39273270283723244,Texas
3656,2012,Hamilton,male,1578,154532,161563,316095,0.010211477234488649,Texas
3657,2012,Hamilton,male,1578,7377,7733,15110,0.21390809272061814,Texas
3658,2012,Hamilton,male,1578,1353,1263,2616,1.1662971175166297,Texas
3659,2012,Hamilton,male,1578,4564,4614,9178,0.34574934268185803,Texas
3660,2012,Hamilton,male,1578,2347,2228,4575,0.6723476778866638,Texas
3661,2012,Hamilton,male,1578,391728,420309,812037,0.004028305354735939,Texas
3662,2012,Hamilton,male,1578,172447,185099,357546,0.009150637587200704,Texas
3663,2012,Hamilton,male,1578,4070,4199,8269,0.3877149877149877,Texas
3674,2013,Hamilton,male,880,8281,5988,14269,0.10626735901461176,Texas
3675,2013,Hamilton,male,880,4018,4203,8221,0.2190144350423096,Texas
3676,2013,Hamilton,male,880,154532,161563,316095,0.005694613413403049,Texas
3677,2013,Hamilton,male,880,7377,7733,15110,0.11928968415344991,Texas
3678,2013,Hamilton,male,880,1353,1263,2616,0.6504065040650406,Texas
3679,2013,Hamilton,male,880,4564,4614,9178,0.19281332164767748,Texas
3680,2013,Hamilton,male,880,2347,2228,4575,0.3749467405198125,Texas
3681,2013,Hamilton,male,880,391728,420309,812037,0.0022464567250745416,Texas
3682,2013,Hamilton,male,880,172447,185099,357546,0.005103017158895197,Texas
3683,2013,Hamilton,male,880,4070,4199,8269,0.21621621621621623,Texas
3694,2014,Hamilton,male,1959,8281,5988,14269,0.23656563217002777,Texas
3695,2014,Hamilton,male,1959,4018,4203,8221,0.48755599800895966,Texas
3696,2014,Hamilton,male,1959,154532,161563,316095,0.012676985996427925,Texas
3697,2014,Hamilton,male,1959,7377,7733,15110,0.26555510370069135,Texas
3698,2014,Hamilton,male,1959,1353,1263,2616,1.4478935698447895,Texas
3699,2014,Hamilton,male,1959,4564,4614,9178,0.42922874671340927,Texas
3700,2014,Hamilton,male,1959,2347,2228,4575,0.8346825734980826,Texas
3701,2014,Hamilton,male,1959,391728,420309,812037,0.005000919005023894,Texas
3702,2014,Hamilton,male,1959,172447,185099,357546,0.011360012061676921,Texas
3703,2014,Hamilton,male,1959,4070,4199,8269,0.4813267813267813,Texas
3714,2015,Hamilton,male,918,8281,5988,14269,0.11085617679024272,Texas
3715,2015,Hamilton,male,918,4018,4203,8221,0.22847187655550025,Texas
3716,2015,Hamilton,male,918,154532,161563,316095,0.005940517174436363,Texas
3717,2015,Hamilton,male,918,7377,7733,15110,0.1244408296055307,Texas
3718,2015,Hamilton,male,918,1353,1263,2616,0.6784922394678492,Texas
3719,2015,Hamilton,male,918,4564,4614,9178,0.2011393514460999,Texas
3720,2015,Hamilton,male,918,2347,2228,4575,0.39113762249680445,Texas
3721,2015,Hamilton,male,918,391728,420309,812037,0.002343462810930033,Texas
3722,2015,Hamilton,male,918,172447,185099,357546,0.0053233747180293075,Texas
3723,2015,Hamilton,male,918,4070,4199,8269,0.22555282555282555,Texas
3734,2016,Hamilton,male,1236,8281,5988,14269,0.14925733607052288,Texas
3735,2016,Hamilton,male,1236,4018,4203,8221,0.30761572921851665,Texas
3736,2016,Hamilton,male,1236,154532,161563,316095,0.007998343385188829,Texas
3737,2016,Hamilton,male,1236,7377,7733,15110,0.16754778365189102,Texas
3738,2016,Hamilton,male,1236,1353,1263,2616,0.9135254988913526,Texas
3739,2016,Hamilton,male,1236,4564,4614,9178,0.2708150744960561,Texas
3740,2016,Hamilton,male,1236,2347,2228,4575,0.5266297400937366,Texas
3741,2016,Hamilton,male,1236,391728,420309,812037,0.003155250582036515,Texas
3742,2016,Hamilton,male,1236,172447,185099,357546,0.0071674195549937085,Texas
3743,2016,Hamilton,male,1236,4070,4199,8269,0.3036855036855037,Texas
3745,2009,Hansford,male,1352,2783,2764,5547,0.48580668343514194,Texas
3747,2010,Hansford,male,730,2783,2764,5547,0.26230686309737694,Texas
3749,2011,Hansford,male,757,2783,2764,5547,0.2720086237872799,Texas
3751,2012,Hansford,male,714,2783,2764,5547,0.2565576715774344,Texas
3753,2013,Hansford,male,553,2783,2764,5547,0.19870643190801293,Texas
3755,2014,Hansford,male,836,2783,2764,5547,0.30039525691699603,Texas
3757,2015,Hansford,male,664,2783,2764,5547,0.2385914480776141,Texas
3759,2016,Hansford,male,42,2783,2764,5547,0.015091627739849083,Texas
3762,2009,Hardeman,male,1715,14088,11474,25562,0.12173480976717774,Texas
3763,2009,Hardeman,male,1715,1938,2014,3952,0.8849329205366357,Texas
3766,2010,Hardeman,male,1857,14088,11474,25562,0.13181431005110733,Texas
3767,2010,Hardeman,male,1857,1938,2014,3952,0.958204334365325,Texas
3770,2011,Hardeman,male,2356,14088,11474,25562,0.16723452583759227,Texas
3771,2011,Hardeman,male,2356,1938,2014,3952,1.2156862745098038,Texas
3774,2012,Hardeman,male,2441,14088,11474,25562,0.1732680295286769,Texas
3775,2012,Hardeman,male,2441,1938,2014,3952,1.259545923632611,Texas
3778,2013,Hardeman,male,2107,14088,11474,25562,0.14955990914253264,Texas
3779,2013,Hardeman,male,2107,1938,2014,3952,1.087203302373581,Texas
3782,2014,Hardeman,male,2154,14088,11474,25562,0.15289608177172062,Texas
3783,2014,Hardeman,male,2154,1938,2014,3952,1.111455108359133,Texas
3786,2015,Hardeman,male,1341,14088,11474,25562,0.09518739352640546,Texas
3787,2015,Hardeman,male,1341,1938,2014,3952,0.6919504643962848,Texas
3790,2016,Hardeman,male,898,14088,11474,25562,0.06374219193639977,Texas
3791,2016,Hardeman,male,898,1938,2014,3952,0.4633642930856553,Texas
3798,2009,Hardin,male,4058,1976,2033,4009,2.0536437246963564,Texas
3799,2009,Hardin,male,4058,8565,8562,17127,0.4737886748394629,Texas
3800,2009,Hardin,male,4058,53723,54372,108095,0.07553561789177819,Texas
3801,2009,Hardin,male,4058,15639,15903,31542,0.2594795063622994,Texas
3802,2009,Hardin,male,4058,12606,13165,25771,0.3219102014913533,Texas
3803,2009,Hardin,male,4058,27342,29037,56379,0.14841635578962767,Texas
3810,2010,Hardin,male,3857,1976,2033,4009,1.9519230769230769,Texas
3811,2010,Hardin,male,3857,8565,8562,17127,0.4503210741389375,Texas
3812,2010,Hardin,male,3857,53723,54372,108095,0.07179420359994788,Texas
3813,2010,Hardin,male,3857,15639,15903,31542,0.24662702218811944,Texas
3814,2010,Hardin,male,3857,12606,13165,25771,0.30596541329525623,Texas
3815,2010,Hardin,male,3857,27342,29037,56379,0.14106502816180236,Texas
3822,2011,Hardin,male,6327,1976,2033,4009,3.201923076923077,Texas
3823,2011,Hardin,male,6327,8565,8562,17127,0.7387040280210158,Texas
3824,2011,Hardin,male,6327,53723,54372,108095,0.1177707871861214,Texas
3825,2011,Hardin,male,6327,15639,15903,31542,0.4045655093036639,Texas
3826,2011,Hardin,male,6327,12606,13165,25771,0.5019038553069967,Texas
3827,2011,Hardin,male,6327,27342,29037,56379,0.2314022383146807,Texas
3834,2012,Hardin,male,6360,1976,2033,4009,3.2186234817813766,Texas
3835,2012,Hardin,male,6360,8565,8562,17127,0.7425569176882661,Texas
3836,2012,Hardin,male,6360,53723,54372,108095,0.11838504923403384,Texas
3837,2012,Hardin,male,6360,15639,15903,31542,0.40667561864569346,Texas
3838,2012,Hardin,male,6360,12606,13165,25771,0.504521656354117,Texas
3839,2012,Hardin,male,6360,27342,29037,56379,0.2326091727013386,Texas
3846,2013,Hardin,male,4991,1976,2033,4009,2.5258097165991904,Texas
3847,2013,Hardin,male,4991,8565,8562,17127,0.5827203736135435,Texas
3848,2013,Hardin,male,4991,53723,54372,108095,0.09290248124639354,Texas
3849,2013,Hardin,male,4991,15639,15903,31542,0.3191380523051346,Texas
3850,2013,Hardin,male,4991,12606,13165,25771,0.3959225765508488,Texas
3851,2013,Hardin,male,4991,27342,29037,56379,0.18253968253968253,Texas
3858,2014,Hardin,male,3646,1976,2033,4009,1.8451417004048583,Texas
3859,2014,Hardin,male,3646,8565,8562,17127,0.4256859311150029,Texas
3860,2014,Hardin,male,3646,53723,54372,108095,0.06786664929359865,Texas
3861,2014,Hardin,male,3646,15639,15903,31542,0.23313511094059722,Texas
3862,2014,Hardin,male,3646,12606,13165,25771,0.28922735205457717,Texas
3863,2014,Hardin,male,3646,27342,29037,56379,0.1333479628410504,Texas
3870,2015,Hardin,male,2431,1976,2033,4009,1.230263157894737,Texas
3871,2015,Hardin,male,2431,8565,8562,17127,0.28382953882078227,Texas
3872,2015,Hardin,male,2431,53723,54372,108095,0.04525063752954973,Texas
3873,2015,Hardin,male,2431,15639,15903,31542,0.15544472152950956,Texas
3874,2015,Hardin,male,2431,12606,13165,25771,0.19284467713787085,Texas
3875,2015,Hardin,male,2431,27342,29037,56379,0.08891083315046448,Texas
3882,2016,Hardin,male,2013,1976,2033,4009,1.0187246963562753,Texas
3883,2016,Hardin,male,2013,8565,8562,17127,0.23502626970227672,Texas
3884,2016,Hardin,male,2013,53723,54372,108095,0.03746998492265882,Texas
3885,2016,Hardin,male,2013,15639,15903,31542,0.12871666986380204,Texas
3886,2016,Hardin,male,2013,12606,13165,25771,0.15968586387434555,Texas
3887,2016,Hardin,male,2013,27342,29037,56379,0.07362299758613122,Texas
3890,2009,Harris,male,43998,16832,16758,33590,2.613949619771863,Texas
3891,2009,Harris,male,43998,2288295,2314228,4602523,0.019227416045571048,Texas
3894,2010,Harris,male,38119,16832,16758,33590,2.2646744296577945,Texas
3895,2010,Harris,male,38119,2288295,2314228,4602523,0.016658254289765962,Texas
3898,2011,Harris,male,41568,16832,16758,33590,2.46958174904943,Texas
3899,2011,Harris,male,41568,2288295,2314228,4602523,0.01816549002641705,Texas
3902,2012,Harris,male,42634,16832,16758,33590,2.5329134980988592,Texas
3903,2012,Harris,male,42634,2288295,2314228,4602523,0.018631339053749627,Texas
3906,2013,Harris,male,35904,16832,16758,33590,2.1330798479087454,Texas
3907,2013,Harris,male,35904,2288295,2314228,4602523,0.015690284687944516,Texas
3910,2014,Harris,male,33185,16832,16758,33590,1.9715423003802282,Texas
3911,2014,Harris,male,33185,2288295,2314228,4602523,0.014502063763631874,Texas
3914,2015,Harris,male,31357,16832,16758,33590,1.86293963878327,Texas
3915,2015,Harris,male,31357,2288295,2314228,4602523,0.013703215713009032,Texas
3918,2016,Harris,male,32571,16832,16758,33590,1.935064163498099,Texas
3919,2016,Harris,male,32571,2288295,2314228,4602523,0.014233741715993786,Texas
3928,2009,Harrison,male,16337,19875,19837,39712,0.8219874213836478,Texas
3929,2009,Harrison,male,16337,6989,7154,14143,2.3375304049220205,Texas
3930,2009,Harrison,male,16337,9146,9522,18668,1.7862453531598512,Texas
3931,2009,Harrison,male,16337,99750,102876,202626,0.16377944862155389,Texas
3932,2009,Harrison,male,16337,4263,4291,8554,3.8322777386816798,Texas
3933,2009,Harrison,male,16337,7566,7741,15307,2.1592651334919375,Texas
3934,2009,Harrison,male,16337,32556,34089,66645,0.5018122619486424,Texas
3935,2009,Harrison,male,16337,33301,34908,68209,0.4905858682922435,Texas
3944,2010,Harrison,male,17577,19875,19837,39712,0.8843773584905661,Texas
3945,2010,Harrison,male,17577,6989,7154,14143,2.5149520675346975,Texas
3946,2010,Harrison,male,17577,9146,9522,18668,1.9218237480865952,Texas
3947,2010,Harrison,male,17577,99750,102876,202626,0.17621052631578948,Texas
3948,2010,Harrison,male,17577,4263,4291,8554,4.123152709359606,Texas
3949,2010,Harrison,male,17577,7566,7741,15307,2.323156225218081,Texas
3950,2010,Harrison,male,17577,32556,34089,66645,0.5399004791743457,Texas
3951,2010,Harrison,male,17577,33301,34908,68209,0.5278219873277079,Texas
3960,2011,Harrison,male,15930,19875,19837,39712,0.8015094339622642,Texas
3961,2011,Harrison,male,15930,6989,7154,14143,2.2792960366289883,Texas
3962,2011,Harrison,male,15930,9146,9522,18668,1.7417450251476054,Texas
3963,2011,Harrison,male,15930,99750,102876,202626,0.15969924812030076,Texas
3964,2011,Harrison,male,15930,4263,4291,8554,3.736805066854328,Texas
3965,2011,Harrison,male,15930,7566,7741,15307,2.105471847739889,Texas
3966,2011,Harrison,male,15930,32556,34089,66645,0.48931072613343163,Texas
3967,2011,Harrison,male,15930,33301,34908,68209,0.47836401309269994,Texas
3976,2012,Harrison,male,19249,19875,19837,39712,0.968503144654088,Texas
3977,2012,Harrison,male,19249,6989,7154,14143,2.7541851480898556,Texas
3978,2012,Harrison,male,19249,9146,9522,18668,2.1046359064071725,Texas
3979,2012,Harrison,male,19249,99750,102876,202626,0.19297243107769424,Texas
3980,2012,Harrison,male,19249,4263,4291,8554,4.515364766596294,Texas
3981,2012,Harrison,male,19249,7566,7741,15307,2.544144858577848,Texas
3982,2012,Harrison,male,19249,32556,34089,66645,0.5912581398206168,Texas
3983,2012,Harrison,male,19249,33301,34908,68209,0.578030689769076,Texas
3992,2013,Harrison,male,14639,19875,19837,39712,0.7365534591194969,Texas
3993,2013,Harrison,male,14639,6989,7154,14143,2.094577192731435,Texas
3994,2013,Harrison,male,14639,9146,9522,18668,1.600590422042423,Texas
3995,2013,Harrison,male,14639,99750,102876,202626,0.14675689223057645,Texas
3996,2013,Harrison,male,14639,4263,4291,8554,3.4339666901243255,Texas
3997,2013,Harrison,male,14639,7566,7741,15307,1.9348400740153318,Texas
3998,2013,Harrison,male,14639,32556,34089,66645,0.4496559773928001,Texas
3999,2013,Harrison,male,14639,33301,34908,68209,0.43959640851626075,Texas
4008,2014,Harrison,male,11279,19875,19837,39712,0.567496855345912,Texas
4009,2014,Harrison,male,11279,6989,7154,14143,1.6138217198454714,Texas
4010,2014,Harrison,male,11279,9146,9522,18668,1.2332167067570523,Texas
4011,2014,Harrison,male,11279,99750,102876,202626,0.11307268170426066,Texas
4012,2014,Harrison,male,11279,4263,4291,8554,2.645789350222848,Texas
4013,2014,Harrison,male,11279,7566,7741,15307,1.4907480835315887,Texas
4014,2014,Harrison,male,11279,32556,34089,66645,0.3464491952328296,Texas
4015,2014,Harrison,male,11279,33301,34908,68209,0.338698537581454,Texas
4024,2015,Harrison,male,9767,19875,19837,39712,0.49142138364779875,Texas
4025,2015,Harrison,male,9767,6989,7154,14143,1.397481757046788,Texas
4026,2015,Harrison,male,9767,9146,9522,18668,1.0678985348786354,Texas
4027,2015,Harrison,male,9767,99750,102876,202626,0.09791478696741855,Texas
4028,2015,Harrison,male,9767,4263,4291,8554,2.2911095472671827,Texas
4029,2015,Harrison,male,9767,7566,7741,15307,1.2909066878139044,Texas
4030,2015,Harrison,male,9767,32556,34089,66645,0.30000614326084285,Texas
4031,2015,Harrison,male,9767,33301,34908,68209,0.29329449566079097,Texas
4040,2016,Harrison,male,10529,19875,19837,39712,0.5297610062893082,Texas
4041,2016,Harrison,male,10529,6989,7154,14143,1.5065102303619975,Texas
4042,2016,Harrison,male,10529,9146,9522,18668,1.1512136453094248,Texas
4043,2016,Harrison,male,10529,99750,102876,202626,0.10555388471177946,Texas
4044,2016,Harrison,male,10529,4263,4291,8554,2.4698569082805535,Texas
4045,2016,Harrison,male,10529,7566,7741,15307,1.3916204070843246,Texas
4046,2016,Harrison,male,10529,32556,34089,66645,0.3234119670721219,Texas
4047,2016,Harrison,male,10529,33301,34908,68209,0.3161766913906489,Texas
4049,2009,Hartley,male,3920,3411,2356,5767,1.149223101729698,Texas
4051,2010,Hartley,male,5350,3411,2356,5767,1.5684549985341543,Texas
4053,2011,Hartley,male,5005,3411,2356,5767,1.4673116388155967,Texas
4055,2012,Hartley,male,5178,3411,2356,5767,1.5180299032541777,Texas
4057,2013,Hartley,male,4440,3411,2356,5767,1.3016710642040457,Texas
4059,2014,Hartley,male,1848,3411,2356,5767,0.5417766051011433,Texas
4061,2015,Hartley,male,1599,3411,2356,5767,0.4687774846086192,Texas
4063,2016,Hartley,male,1992,3411,2356,5767,0.5839929639401935,Texas
4067,2009,Haskell,male,2363,2006,2041,4047,1.1779661016949152,Texas
4068,2009,Haskell,male,2363,6311,6393,12704,0.37442560608461417,Texas
4069,2009,Haskell,male,2363,3071,2738,5809,0.7694562031911429,Texas
4073,2010,Haskell,male,2588,2006,2041,4047,1.2901296111665006,Texas
4074,2010,Haskell,male,2588,6311,6393,12704,0.41007764221201076,Texas
4075,2010,Haskell,male,2588,3071,2738,5809,0.8427222403126018,Texas
4079,2011,Haskell,male,2717,2006,2041,4047,1.3544366899302094,Texas
4080,2011,Haskell,male,2717,6311,6393,12704,0.4305181429250515,Texas
4081,2011,Haskell,male,2717,3071,2738,5809,0.8847281015955715,Texas
4085,2012,Haskell,male,2327,2006,2041,4047,1.1600199401794615,Texas
4086,2012,Haskell,male,2327,6311,6393,12704,0.3687212803042307,Texas
4087,2012,Haskell,male,2327,3071,2738,5809,0.7577336372517095,Texas
4091,2013,Haskell,male,2092,2006,2041,4047,1.0428713858424725,Texas
4092,2013,Haskell,male,2092,6311,6393,12704,0.3314847092378387,Texas
4093,2013,Haskell,male,2092,3071,2738,5809,0.6812113318137415,Texas
4097,2014,Haskell,male,1880,2006,2041,4047,0.9371884346959123,Texas
4098,2014,Haskell,male,1880,6311,6393,12704,0.2978925685311361,Texas
4099,2014,Haskell,male,1880,3071,2738,5809,0.6121784435037447,Texas
4103,2015,Haskell,male,824,2006,2041,4047,0.4107676969092722,Texas
4104,2015,Haskell,male,824,6311,6393,12704,0.13056567897322136,Texas
4105,2015,Haskell,male,824,3071,2738,5809,0.2683165092803647,Texas
4109,2016,Haskell,male,2271,2006,2041,4047,1.1321036889332003,Texas
4110,2016,Haskell,male,2271,6311,6393,12704,0.35984788464585643,Texas
4111,2016,Haskell,male,2271,3071,2738,5809,0.7394985346792575,Texas
4113,2009,Hays,male,12874,101636,102514,204150,0.1266677161635641,Texas
4115,2010,Hays,male,11499,101636,102514,204150,0.11313904522019756,Texas
4117,2011,Hays,male,12045,101636,102514,204150,0.11851115746389075,Texas
4119,2012,Hays,male,10955,101636,102514,204150,0.10778661104333111,Texas
4121,2013,Hays,male,10415,101636,102514,204150,0.10247353300011806,Texas
4123,2014,Hays,male,8504,101636,102514,204150,0.08367114014719194,Texas
4125,2015,Hays,male,8180,101636,102514,204150,0.08048329332126412,Texas
4127,2016,Hays,male,8190,101636,102514,204150,0.0805816836553977,Texas
4129,2009,Hemphill,male,1666,1965,2096,4061,0.8478371501272265,Texas
4131,2010,Hemphill,male,1597,1965,2096,4061,0.8127226463104326,Texas
4133,2011,Hemphill,male,1599,1965,2096,4061,0.8137404580152672,Texas
4135,2012,Hemphill,male,1237,1965,2096,4061,0.6295165394402036,Texas
4137,2013,Hemphill,male,1332,1965,2096,4061,0.6778625954198473,Texas
4139,2014,Hemphill,male,905,1965,2096,4061,0.46055979643765904,Texas
4141,2015,Hemphill,male,561,1965,2096,4061,0.28549618320610687,Texas
4143,2016,Hemphill,male,451,1965,2096,4061,0.22951653944020356,Texas
4149,2009,Henderson,male,8205,3369,3515,6884,2.435440783615316,Texas
4150,2009,Henderson,male,8205,22328,23809,46137,0.36747581512002864,Texas
4151,2009,Henderson,male,8205,54724,58901,113625,0.14993421533513632,Texas
4152,2009,Henderson,male,8205,13446,14413,27859,0.6102186523873271,Texas
4153,2009,Henderson,male,8205,39097,41363,80460,0.20986264930813106,Texas
4159,2010,Henderson,male,7277,3369,3515,6884,2.159988127040665,Texas
4160,2010,Henderson,male,7277,22328,23809,46137,0.3259136510211394,Texas
4161,2010,Henderson,male,7277,54724,58901,113625,0.13297639061472113,Texas
4162,2010,Henderson,male,7277,13446,14413,27859,0.5412018444146958,Texas
4163,2010,Henderson,male,7277,39097,41363,80460,0.18612681279893598,Texas
4169,2011,Henderson,male,10365,3369,3515,6884,3.076580587711487,Texas
4170,2011,Henderson,male,10365,22328,23809,46137,0.46421533500537443,Texas
4171,2011,Henderson,male,10365,54724,58901,113625,0.18940501425334405,Texas
4172,2011,Henderson,male,10365,13446,14413,27859,0.7708612226684516,Texas
4173,2011,Henderson,male,10365,39097,41363,80460,0.26510985497608514,Texas
4179,2012,Henderson,male,7933,3369,3515,6884,2.354704660136539,Texas
4180,2012,Henderson,male,7933,22328,23809,46137,0.35529380150483697,Texas
4181,2012,Henderson,male,7933,54724,58901,113625,0.144963818434325,Texas
4182,2012,Henderson,male,7933,13446,14413,27859,0.5899895879815559,Texas
4183,2012,Henderson,male,7933,39097,41363,80460,0.20290559377957387,Texas
4189,2013,Henderson,male,7581,3369,3515,6884,2.2502226179875335,Texas
4190,2013,Henderson,male,7581,22328,23809,46137,0.33952884270870654,Texas
4191,2013,Henderson,male,7581,54724,58901,113625,0.13853154009209853,Texas
4192,2013,Henderson,male,7581,13446,14413,27859,0.5638107987505578,Texas
4193,2013,Henderson,male,7581,39097,41363,80460,0.19390234544849988,Texas
4199,2014,Henderson,male,5539,3369,3515,6884,1.6441080439299496,Texas
4200,2014,Henderson,male,5539,22328,23809,46137,0.24807416696524542,Texas
4201,2014,Henderson,male,5539,54724,58901,113625,0.10121701629997808,Texas
4202,2014,Henderson,male,5539,13446,14413,27859,0.4119440725866429,Texas
4203,2014,Henderson,male,5539,39097,41363,80460,0.14167327416425812,Texas
4209,2015,Henderson,male,3860,3369,3515,6884,1.1457405758385277,Texas
4210,2015,Henderson,male,3860,22328,23809,46137,0.1728771049802938,Texas
4211,2015,Henderson,male,3860,54724,58901,113625,0.07053577954827864,Texas
4212,2015,Henderson,male,3860,13446,14413,27859,0.2870742228171947,Texas
4213,2015,Henderson,male,3860,39097,41363,80460,0.09872880272143643,Texas
4219,2016,Henderson,male,5911,3369,3515,6884,1.7545265657465123,Texas
4220,2016,Henderson,male,5911,22328,23809,46137,0.2647348620566105,Texas
4221,2016,Henderson,male,5911,54724,58901,113625,0.10801476500255829,Texas
4222,2016,Henderson,male,5911,13446,14413,27859,0.43961029302394766,Texas
4223,2016,Henderson,male,5911,39097,41363,80460,0.15118807069596132,Texas
4226,2009,Hidalgo,male,53962,2149,2222,4371,25.11028385295486,Texas
4227,2009,Hidalgo,male,53962,415443,433946,849389,0.12989026172062113,Texas
4230,2010,Hidalgo,male,58822,2149,2222,4371,27.371800837598883,Texas
4231,2010,Hidalgo,male,58822,415443,433946,849389,0.14158861745173223,Texas
4234,2011,Hidalgo,male,55833,2149,2222,4371,25.98092135877152,Texas
4235,2011,Hidalgo,male,55833,415443,433946,849389,0.13439388797019086,Texas
4238,2012,Hidalgo,male,41870,2149,2222,4371,19.483480688692413,Texas
4239,2012,Hidalgo,male,41870,415443,433946,849389,0.10078398239951088,Texas
4242,2013,Hidalgo,male,47670,2149,2222,4371,22.18241042345277,Texas
4243,2013,Hidalgo,male,47670,415443,433946,849389,0.11474498306626901,Texas
4246,2014,Hidalgo,male,63344,2149,2222,4371,29.47603536528618,Texas
4247,2014,Hidalgo,male,63344,415443,433946,849389,0.15247338383364265,Texas
4250,2015,Hidalgo,male,67488,2149,2222,4371,31.404374127501164,Texas
4251,2015,Hidalgo,male,67488,415443,433946,849389,0.16244827810313328,Texas
4254,2016,Hidalgo,male,58712,2149,2222,4371,27.320614239181015,Texas
4255,2016,Hidalgo,male,58712,415443,433946,849389,0.14132383985287994,Texas
4258,2009,Hill,male,8387,8292,8147,16439,1.011456825856247,Texas
4259,2009,Hill,male,8387,17603,17796,35399,0.4764528773504516,Texas
4262,2010,Hill,male,9613,8292,8147,16439,1.159310178485287,Texas
4263,2010,Hill,male,9613,17603,17796,35399,0.5461000965744476,Texas
4266,2011,Hill,male,9536,8292,8147,16439,1.1500241196333816,Texas
4267,2011,Hill,male,9536,17603,17796,35399,0.5417258421859911,Texas
4270,2012,Hill,male,9578,8292,8147,16439,1.1550892426435118,Texas
4271,2012,Hill,male,9578,17603,17796,35399,0.5441117991251492,Texas
4274,2013,Hill,male,7942,8292,8147,16439,0.9577906415822479,Texas
4275,2013,Hill,male,7942,17603,17796,35399,0.45117309549508605,Texas
4278,2014,Hill,male,8278,8292,8147,16439,0.9983116256632899,Texas
4279,2014,Hill,male,8278,17603,17796,35399,0.47026075100835085,Texas
4282,2015,Hill,male,5200,8292,8147,16439,0.6271104679208876,Texas
4283,2015,Hill,male,5200,17603,17796,35399,0.29540419246719307,Texas
4286,2016,Hill,male,4915,8292,8147,16439,0.5927399903521466,Texas
4287,2016,Hill,male,4915,17603,17796,35399,0.27921377038004885,Texas
4289,2009,Hockley,male,4801,11428,11734,23162,0.4201085054252713,Texas
4291,2010,Hockley,male,4346,11428,11734,23162,0.38029401470073504,Texas
4293,2011,Hockley,male,3837,11428,11734,23162,0.3357542877143857,Texas
4295,2012,Hockley,male,4141,11428,11734,23162,0.36235561778088904,Texas
4297,2013,Hockley,male,4014,11428,11734,23162,0.3512425621281064,Texas
4299,2014,Hockley,male,3033,11428,11734,23162,0.26540077003850193,Texas
4301,2015,Hockley,male,2091,11428,11734,23162,0.18297164858242912,Texas
4303,2016,Hockley,male,1819,11428,11734,23162,0.15917045852292613,Texas
4305,2009,Hood,male,7824,28004,28897,56901,0.27938865876303387,Texas
4307,2010,Hood,male,9210,28004,28897,56901,0.3288815883445222,Texas
4309,2011,Hood,male,8020,28004,28897,56901,0.2863876589058706,Texas
4311,2012,Hood,male,9050,28004,28897,56901,0.32316811884016566,Texas
4313,2013,Hood,male,8821,28004,28897,56901,0.31499071561205544,Texas
4315,2014,Hood,male,6535,28004,28897,56901,0.23335952006856164,Texas
4317,2015,Hood,male,5963,28004,28897,56901,0.21293386659048708,Texas
4319,2016,Hood,male,5739,28004,28897,56901,0.20493500928438793,Texas
4322,2009,Hopkins,male,11018,22219,23445,45664,0.495881902875917,Texas
4323,2009,Hopkins,male,11018,17801,18439,36240,0.6189539913488006,Texas
4326,2010,Hopkins,male,8379,22219,23445,45664,0.37710968090373104,Texas
4327,2010,Hopkins,male,8379,17801,18439,36240,0.4707038930397169,Texas
4330,2011,Hopkins,male,7877,22219,23445,45664,0.3545164048787074,Texas
4331,2011,Hopkins,male,7877,17801,18439,36240,0.4425032301556092,Texas
4334,2012,Hopkins,male,8064,22219,23445,45664,0.36293262523065845,Texas
4335,2012,Hopkins,male,8064,17801,18439,36240,0.4530082579630358,Texas
4338,2013,Hopkins,male,6214,22219,23445,45664,0.27967055223007337,Texas
4339,2013,Hopkins,male,6214,17801,18439,36240,0.34908151227459133,Texas
4342,2014,Hopkins,male,6790,22219,23445,45664,0.30559431117512037,Texas
4343,2014,Hopkins,male,6790,17801,18439,36240,0.3814392449862367,Texas
4346,2015,Hopkins,male,5911,22219,23445,45664,0.26603357486835594,Texas
4347,2015,Hopkins,male,5911,17801,18439,36240,0.33205999662940283,Texas
4350,2016,Hopkins,male,6054,22219,23445,45664,0.27246950807867143,Texas
4351,2016,Hopkins,male,6054,17801,18439,36240,0.34009325318802314,Texas
4357,2009,Houston,male,2795,50029,54323,104352,0.05586759679385956,Texas
4358,2009,Houston,male,2795,73756,77926,151682,0.0378952220836271,Texas
4359,2009,Houston,male,2795,9349,9314,18663,0.298962455877634,Texas
4360,2009,Houston,male,2795,4066,4110,8176,0.6874077717658632,Texas
4361,2009,Houston,male,2795,12432,10523,22955,0.22482303732303732,Texas
4367,2010,Houston,male,3954,50029,54323,104352,0.07903416018709149,Texas
4368,2010,Houston,male,3954,73756,77926,151682,0.05360919789576441,Texas
4369,2010,Houston,male,3954,9349,9314,18663,0.42293293400363674,Texas
4370,2010,Houston,male,3954,4066,4110,8176,0.9724545007378259,Texas
4371,2010,Houston,male,3954,12432,10523,22955,0.31805019305019305,Texas
4377,2011,Houston,male,2648,50029,54323,104352,0.05292930100541686,Texas
4378,2011,Houston,male,2648,73756,77926,151682,0.03590216389175118,Texas
4379,2011,Houston,male,2648,9349,9314,18663,0.2832388490747674,Texas
4380,2011,Houston,male,2648,4066,4110,8176,0.6512543039842598,Texas
4381,2011,Houston,male,2648,12432,10523,22955,0.212998712998713,Texas
4387,2012,Houston,male,2653,50029,54323,104352,0.05302924303903736,Texas
4388,2012,Houston,male,2653,73756,77926,151682,0.035969954986712946,Texas
4389,2012,Houston,male,2653,9349,9314,18663,0.28377366563268797,Texas
4390,2012,Houston,male,2653,4066,4110,8176,0.6524840137727497,Texas
4391,2012,Houston,male,2653,12432,10523,22955,0.21340090090090091,Texas
4397,2013,Houston,male,2263,50029,54323,104352,0.04523376441663835,Texas
4398,2013,Houston,male,2263,73756,77926,151682,0.03068224957969521,Texas
4399,2013,Houston,male,2263,9349,9314,18663,0.2420579741148786,Texas
4400,2013,Houston,male,2263,4066,4110,8176,0.5565666502705362,Texas
4401,2013,Houston,male,2263,12432,10523,22955,0.18203024453024452,Texas
4407,2014,Houston,male,2458,50029,54323,104352,0.04913150372783785,Texas
4408,2014,Houston,male,2458,73756,77926,151682,0.03332610228320408,Texas
4409,2014,Houston,male,2458,9349,9314,18663,0.2629158198737833,Texas
4410,2014,Houston,male,2458,4066,4110,8176,0.6045253320216429,Texas
4411,2014,Houston,male,2458,12432,10523,22955,0.19771557271557272,Texas
4417,2015,Houston,male,3098,50029,54323,104352,0.061924084031261865,Texas
4418,2015,Houston,male,3098,73756,77926,151682,0.042003362438310106,Texas
4419,2015,Houston,male,3098,9349,9314,18663,0.33137233928762433,Texas
4420,2015,Houston,male,3098,4066,4110,8176,0.7619281849483522,Texas
4421,2015,Houston,male,3098,12432,10523,22955,0.2491956241956242,Texas
4427,2016,Houston,male,2735,50029,54323,104352,0.05466829239041356,Texas
4428,2016,Houston,male,2735,73756,77926,151682,0.03708172894408591,Texas
4429,2016,Houston,male,2735,9349,9314,18663,0.2925446571825864,Texas
4430,2016,Houston,male,2735,4066,4110,8176,0.6726512543039843,Texas
4431,2016,Houston,male,2735,12432,10523,22955,0.2199967824967825,Texas
4439,2009,Howard,male,5509,6440,6949,13389,0.8554347826086957,Texas
4440,2009,Howard,male,5509,39852,42535,82387,0.13823647495734218,Texas
4441,2009,Howard,male,5509,4580,4684,9264,1.2028384279475983,Texas
4442,2009,Howard,male,5509,154285,161042,315327,0.03570664679003144,Texas
4443,2009,Howard,male,5509,5042,5071,10113,1.0926219754065847,Texas
4444,2009,Howard,male,5509,3227,3178,6405,1.7071583514099784,Texas
4445,2009,Howard,male,5509,20732,15935,36667,0.2657244838896392,Texas
4453,2010,Howard,male,6418,6440,6949,13389,0.996583850931677,Texas
4454,2010,Howard,male,6418,39852,42535,82387,0.16104586971795645,Texas
4455,2010,Howard,male,6418,4580,4684,9264,1.4013100436681223,Texas
4456,2010,Howard,male,6418,154285,161042,315327,0.04159834073305895,Texas
4457,2010,Howard,male,6418,5042,5071,10113,1.2729075763585878,Texas
4458,2010,Howard,male,6418,3227,3178,6405,1.988844127672761,Texas
4459,2010,Howard,male,6418,20732,15935,36667,0.309569747250627,Texas
4467,2011,Howard,male,5353,6440,6949,13389,0.8312111801242236,Texas
4468,2011,Howard,male,5353,39852,42535,82387,0.13432199136806183,Texas
4469,2011,Howard,male,5353,4580,4684,9264,1.1687772925764193,Texas
4470,2011,Howard,male,5353,154285,161042,315327,0.0346955309978287,Texas
4471,2011,Howard,male,5353,5042,5071,10113,1.0616818722729076,Texas
4472,2011,Howard,male,5353,3227,3178,6405,1.6588162379919429,Texas
4473,2011,Howard,male,5353,20732,15935,36667,0.2581998842369284,Texas
4481,2012,Howard,male,2703,6440,6949,13389,0.41972049689440993,Texas
4482,2012,Howard,male,2703,39852,42535,82387,0.06782595603733815,Texas
4483,2012,Howard,male,2703,4580,4684,9264,0.590174672489083,Texas
4484,2012,Howard,male,2703,154285,161042,315327,0.017519525553359044,Texas
4485,2012,Howard,male,2703,5042,5071,10113,0.53609678698929,Texas
4486,2012,Howard,male,2703,3227,3178,6405,0.837620080570189,Texas
4487,2012,Howard,male,2703,20732,15935,36667,0.13037815936716188,Texas
4495,2013,Howard,male,3639,6440,6949,13389,0.5650621118012422,Texas
4496,2013,Howard,male,3639,39852,42535,82387,0.09131285757302017,Texas
4497,2013,Howard,male,3639,4580,4684,9264,0.7945414847161572,Texas
4498,2013,Howard,male,3639,154285,161042,315327,0.023586220306575492,Texas
4499,2013,Howard,male,3639,5042,5071,10113,0.7217374057913526,Texas
4500,2013,Howard,male,3639,3227,3178,6405,1.127672761078401,Texas
4501,2013,Howard,male,3639,20732,15935,36667,0.1755257572834266,Texas
4509,2014,Howard,male,3914,6440,6949,13389,0.6077639751552795,Texas
4510,2014,Howard,male,3914,39852,42535,82387,0.09821338954130282,Texas
4511,2014,Howard,male,3914,4580,4684,9264,0.854585152838428,Texas
4512,2014,Howard,male,3914,154285,161042,315327,0.02536863596590725,Texas
4513,2014,Howard,male,3914,5042,5071,10113,0.7762792542641809,Texas
4514,2014,Howard,male,3914,3227,3178,6405,1.2128912302448094,Texas
4515,2014,Howard,male,3914,20732,15935,36667,0.18879027590198727,Texas
4523,2015,Howard,male,5328,6440,6949,13389,0.8273291925465839,Texas
4524,2015,Howard,male,5328,39852,42535,82387,0.13369467028003612,Texas
4525,2015,Howard,male,5328,4580,4684,9264,1.1633187772925764,Texas
4526,2015,Howard,male,5328,154285,161042,315327,0.03453349321061672,Texas
4527,2015,Howard,male,5328,5042,5071,10113,1.0567235224117413,Texas
4528,2015,Howard,male,5328,3227,3178,6405,1.6510691044313603,Texas
4529,2015,Howard,male,5328,20732,15935,36667,0.25699401890796836,Texas
4537,2016,Howard,male,6175,6440,6949,13389,0.9588509316770186,Texas
4538,2016,Howard,male,6175,39852,42535,82387,0.1549483087423467,Texas
4539,2016,Howard,male,6175,4580,4684,9264,1.3482532751091703,Texas
4540,2016,Howard,male,6175,154285,161042,315327,0.04002333344135853,Texas
4541,2016,Howard,male,6175,5042,5071,10113,1.2247124157080524,Texas
4542,2016,Howard,male,6175,3227,3178,6405,1.9135419894638983,Texas
4543,2016,Howard,male,6175,20732,15935,36667,0.29784873625313524,Texas
4545,2009,Hudspeth,male,9325,2019,2079,4098,4.618623080733036,Texas
4547,2010,Hudspeth,male,7107,2019,2079,4098,3.5200594353640415,Texas
4549,2011,Hudspeth,male,5655,2019,2079,4098,2.800891530460624,Texas
4551,2012,Hudspeth,male,4818,2019,2079,4098,2.386329866270431,Texas
4553,2013,Hudspeth,male,6221,2019,2079,4098,3.08122833085686,Texas
4555,2014,Hudspeth,male,6081,2019,2079,4098,3.011887072808321,Texas
4557,2015,Hudspeth,male,10065,2019,2079,4098,4.985141158989599,Texas
4559,2016,Hudspeth,male,12148,2019,2079,4098,6.016840019811788,Texas
4561,2009,Hunt,male,17255,45279,46873,92152,0.38108173767088493,Texas
4563,2010,Hunt,male,15915,45279,46873,92152,0.3514874445107003,Texas
4565,2011,Hunt,male,16114,45279,46873,92152,0.3558824178979218,Texas
4567,2012,Hunt,male,14001,45279,46873,92152,0.30921619293712316,Texas
4569,2013,Hunt,male,9207,45279,46873,92152,0.20333929636255219,Texas
4571,2014,Hunt,male,9913,45279,46873,92152,0.2189315135051569,Texas
4573,2015,Hunt,male,7892,45279,46873,92152,0.1742971355374456,Texas
4575,2016,Hunt,male,9824,45279,46873,92152,0.216965922392279,Texas
4578,2009,Hutchinson,male,2218,3605,3710,7315,0.615256588072122,Texas
4579,2009,Hutchinson,male,2218,10797,10774,21571,0.20542743354635548,Texas
4582,2010,Hutchinson,male,1892,3605,3710,7315,0.5248266296809986,Texas
4583,2010,Hutchinson,male,1892,10797,10774,21571,0.17523386125775678,Texas
4586,2011,Hutchinson,male,3306,3605,3710,7315,0.9170596393897364,Texas
4587,2011,Hutchinson,male,3306,10797,10774,21571,0.306196165601556,Texas
4590,2012,Hutchinson,male,2580,3605,3710,7315,0.7156726768377254,Texas
4591,2012,Hutchinson,male,2580,10797,10774,21571,0.23895526535148653,Texas
4594,2013,Hutchinson,male,1492,3605,3710,7315,0.413869625520111,Texas
4595,2013,Hutchinson,male,1492,10797,10774,21571,0.138186533296286,Texas
4598,2014,Hutchinson,male,2146,3605,3710,7315,0.5952843273231623,Texas
4599,2014,Hutchinson,male,2146,10797,10774,21571,0.19875891451329072,Texas
4602,2015,Hutchinson,male,1840,3605,3710,7315,0.5104022191400832,Texas
4603,2015,Hutchinson,male,1840,10797,10774,21571,0.1704177086227656,Texas
4606,2016,Hutchinson,male,1739,3605,3710,7315,0.4823855755894591,Texas
4607,2016,Hutchinson,male,1739,10797,10774,21571,0.1610632583124942,Texas
4609,2009,Irion,male,394,836,688,1524,0.47129186602870815,Texas
4611,2010,Irion,male,825,836,688,1524,0.9868421052631579,Texas
4613,2011,Irion,male,999,836,688,1524,1.194976076555024,Texas
4615,2012,Irion,male,1239,836,688,1524,1.4820574162679425,Texas
4617,2013,Irion,male,965,836,688,1524,1.1543062200956937,Texas
4619,2014,Irion,male,1533,836,688,1524,1.8337320574162679,Texas
4621,2015,Irion,male,1527,836,688,1524,1.826555023923445,Texas
4623,2016,Irion,male,982,836,688,1524,1.174641148325359,Texas
4625,2009,Jack,male,3965,4987,3855,8842,0.7950671746541007,Texas
4627,2010,Jack,male,2641,4987,3855,8842,0.5295768999398436,Texas
4629,2011,Jack,male,3647,4987,3855,8842,0.7313013835973531,Texas
4631,2012,Jack,male,4072,4987,3855,8842,0.8165229596952075,Texas
4633,2013,Jack,male,3378,4987,3855,8842,0.6773611389612993,Texas
4635,2014,Jack,male,2059,4987,3855,8842,0.41287347102466415,Texas
4637,2015,Jack,male,1875,4987,3855,8842,0.37597754160818125,Texas
4639,2016,Jack,male,3639,4987,3855,8842,0.7296972127531582,Texas
4664,2009,Jackson,male,4635,25536,26558,52094,0.18150845864661655,Texas
4665,2009,Jackson,male,4635,8512,8713,17225,0.5445253759398496,Texas
4666,2009,Jackson,male,4635,631,665,1296,7.345483359746434,Texas
4667,2009,Jackson,male,4635,26784,21688,48472,0.17305107526881722,Texas
4668,2009,Jackson,male,4635,32445,33310,65755,0.14285714285714285,Texas
4669,2009,Jackson,male,4635,28989,29562,58551,0.15988823346786712,Texas
4670,2009,Jackson,male,4635,21822,22116,43938,0.2124003299422601,Texas
4671,2009,Jackson,male,4635,9712,9683,19395,0.47724464579901155,Texas
4672,2009,Jackson,male,4635,6642,6676,13318,0.6978319783197832,Texas
4673,2009,Jackson,male,4635,6655,6718,13373,0.6964688204357626,Texas
4674,2009,Jackson,male,4635,8080,7846,15926,0.5736386138613861,Texas
4675,2009,Jackson,male,4635,81205,77708,158913,0.057077766147404715,Texas
4676,2009,Jackson,male,4635,5069,4978,10047,0.914381534819491,Texas
4677,2009,Jackson,male,4635,70065,71949,142014,0.06615285806037251,Texas
4678,2009,Jackson,male,4635,334604,357399,692003,0.013852195431016963,Texas
4679,2009,Jackson,male,4635,20838,21418,42256,0.22243017564065648,Texas
4680,2009,Jackson,male,4635,15885,16639,32524,0.29178470254957506,Texas
4681,2009,Jackson,male,4635,12579,12805,25384,0.3684712616265204,Texas
4682,2009,Jackson,male,4635,104458,109809,214267,0.044371900668211145,Texas
4683,2009,Jackson,male,4635,1611,1676,3287,2.877094972067039,Texas
4684,2009,Jackson,male,4635,5826,5789,11615,0.7955715756951597,Texas
4685,2009,Jackson,male,4635,7226,7594,14820,0.6414337115970108,Texas
4686,2009,Jackson,male,4635,14417,14601,29018,0.321495456752445,Texas
4687,2009,Jackson,male,4635,10955,9551,20506,0.42309447740757644,Texas
4712,2010,Jackson,male,4588,25536,26558,52094,0.17966791979949875,Texas
4713,2010,Jackson,male,4588,8512,8713,17225,0.5390037593984962,Texas
4714,2010,Jackson,male,4588,631,665,1296,7.270998415213946,Texas
4715,2010,Jackson,male,4588,26784,21688,48472,0.1712962962962963,Texas
4716,2010,Jackson,male,4588,32445,33310,65755,0.14140853752504237,Texas
4717,2010,Jackson,male,4588,28989,29562,58551,0.15826692883507537,Texas
4718,2010,Jackson,male,4588,21822,22116,43938,0.2102465401888003,Texas
4719,2010,Jackson,male,4588,9712,9683,19395,0.4724052718286656,Texas
4720,2010,Jackson,male,4588,6642,6676,13318,0.6907557964468534,Texas
4721,2010,Jackson,male,4588,6655,6718,13373,0.6894064613072878,Texas
4722,2010,Jackson,male,4588,8080,7846,15926,0.5678217821782178,Texas
4723,2010,Jackson,male,4588,81205,77708,158913,0.05649898405270611,Texas
4724,2010,Jackson,male,4588,5069,4978,10047,0.9051094890510949,Texas
4725,2010,Jackson,male,4588,70065,71949,142014,0.06548205237993292,Texas
4726,2010,Jackson,male,4588,334604,357399,692003,0.01371173088187828,Texas
4727,2010,Jackson,male,4588,20838,21418,42256,0.22017468087148478,Texas
4728,2010,Jackson,male,4588,15885,16639,32524,0.2888259364180044,Texas
4729,2010,Jackson,male,4588,12579,12805,25384,0.36473487558629464,Texas
4730,2010,Jackson,male,4588,104458,109809,214267,0.04392195906488732,Texas
4731,2010,Jackson,male,4588,1611,1676,3287,2.8479205462445685,Texas
4732,2010,Jackson,male,4588,5826,5789,11615,0.7875042911088225,Texas
4733,2010,Jackson,male,4588,7226,7594,14820,0.6349294215333517,Texas
4734,2010,Jackson,male,4588,14417,14601,29018,0.31823541652216136,Texas
4735,2010,Jackson,male,4588,10955,9551,20506,0.4188041989958923,Texas
4760,2011,Jackson,male,3493,25536,26558,52094,0.1367872807017544,Texas
4761,2011,Jackson,male,3493,8512,8713,17225,0.41036184210526316,Texas
4762,2011,Jackson,male,3493,631,665,1296,5.535657686212361,Texas
4763,2011,Jackson,male,3493,26784,21688,48472,0.1304136798088411,Texas
4764,2011,Jackson,male,3493,32445,33310,65755,0.10765911542610572,Texas
4765,2011,Jackson,male,3493,28989,29562,58551,0.12049398047535272,Texas
4766,2011,Jackson,male,3493,21822,22116,43938,0.16006782146457704,Texas
4767,2011,Jackson,male,3493,9712,9683,19395,0.35965815485996705,Texas
4768,2011,Jackson,male,3493,6642,6676,13318,0.5258958145137007,Texas
4769,2011,Jackson,male,3493,6655,6718,13373,0.5248685199098422,Texas
4770,2011,Jackson,male,3493,8080,7846,15926,0.4323019801980198,Texas
4771,2011,Jackson,male,3493,81205,77708,158913,0.043014592697494,Texas
4772,2011,Jackson,male,3493,5069,4978,10047,0.689090550404419,Texas
4773,2011,Jackson,male,3493,70065,71949,142014,0.04985370727181902,Texas
4774,2011,Jackson,male,3493,334604,357399,692003,0.010439205747689806,Texas
4775,2011,Jackson,male,3493,20838,21418,42256,0.16762645167482484,Texas
4776,2011,Jackson,male,3493,15885,16639,32524,0.21989298079949637,Texas
4777,2011,Jackson,male,3493,12579,12805,25384,0.2776850306065665,Texas
4778,2011,Jackson,male,3493,104458,109809,214267,0.03343927703000249,Texas
4779,2011,Jackson,male,3493,1611,1676,3287,2.1682184978274366,Texas
4780,2011,Jackson,male,3493,5826,5789,11615,0.5995537246824579,Texas
4781,2011,Jackson,male,3493,7226,7594,14820,0.4833933019651259,Texas
4782,2011,Jackson,male,3493,14417,14601,29018,0.2422834154123604,Texas
4783,2011,Jackson,male,3493,10955,9551,20506,0.31884984025559104,Texas
4808,2012,Jackson,male,2307,25536,26558,52094,0.09034304511278196,Texas
4809,2012,Jackson,male,2307,8512,8713,17225,0.2710291353383459,Texas
4810,2012,Jackson,male,2307,631,665,1296,3.6561014263074485,Texas
4811,2012,Jackson,male,2307,26784,21688,48472,0.08613351254480286,Texas
4812,2012,Jackson,male,2307,32445,33310,65755,0.07110494683310217,Texas
4813,2012,Jackson,male,2307,28989,29562,58551,0.07958191037979924,Texas
4814,2012,Jackson,male,2307,21822,22116,43938,0.10571899917514435,Texas
4815,2012,Jackson,male,2307,9712,9683,19395,0.23754118616144976,Texas
4816,2012,Jackson,male,2307,6642,6676,13318,0.34733514001806687,Texas
4817,2012,Jackson,male,2307,6655,6718,13373,0.346656649135988,Texas
4818,2012,Jackson,male,2307,8080,7846,15926,0.285519801980198,Texas
4819,2012,Jackson,male,2307,81205,77708,158913,0.02840958069084416,Texas
4820,2012,Jackson,male,2307,5069,4978,10047,0.4551193529295719,Texas
4821,2012,Jackson,male,2307,70065,71949,142014,0.0329265681866838,Texas
4822,2012,Jackson,male,2307,334604,357399,692003,0.006894717337509414,Texas
4823,2012,Jackson,male,2307,20838,21418,42256,0.1107112006910452,Texas
4824,2012,Jackson,male,2307,15885,16639,32524,0.14523135033050047,Texas
4825,2012,Jackson,male,2307,12579,12805,25384,0.1834009062723587,Texas
4826,2012,Jackson,male,2307,104458,109809,214267,0.02208543146527791,Texas
4827,2012,Jackson,male,2307,1611,1676,3287,1.4320297951582868,Texas
4828,2012,Jackson,male,2307,5826,5789,11615,0.3959835221421215,Texas
4829,2012,Jackson,male,2307,7226,7594,14820,0.3192637697204539,Texas
4830,2012,Jackson,male,2307,14417,14601,29018,0.16001942151626553,Texas
4831,2012,Jackson,male,2307,10955,9551,20506,0.2105887722501141,Texas
4856,2013,Jackson,male,2481,25536,26558,52094,0.09715695488721804,Texas
4857,2013,Jackson,male,2481,8512,8713,17225,0.2914708646616541,Texas
4858,2013,Jackson,male,2481,631,665,1296,3.931854199683043,Texas
4859,2013,Jackson,male,2481,26784,21688,48472,0.09262992831541218,Texas
4860,2013,Jackson,male,2481,32445,33310,65755,0.0764678687008784,Texas
4861,2013,Jackson,male,2481,28989,29562,58551,0.08558418710545379,Texas
4862,2013,Jackson,male,2481,21822,22116,43938,0.11369260379433599,Texas
4863,2013,Jackson,male,2481,9712,9683,19395,0.25545716639209226,Texas
4864,2013,Jackson,male,2481,6642,6676,13318,0.3735320686540199,Texas
4865,2013,Jackson,male,2481,6655,6718,13373,0.3728024042073629,Texas
4866,2013,Jackson,male,2481,8080,7846,15926,0.30705445544554455,Texas
4867,2013,Jackson,male,2481,81205,77708,158913,0.030552305892494306,Texas
4868,2013,Jackson,male,2481,5069,4978,10047,0.4894456500295916,Texas
4869,2013,Jackson,male,2481,70065,71949,142014,0.035409976450438876,Texas
4870,2013,Jackson,male,2481,334604,357399,692003,0.007414735030065391,Texas
4871,2013,Jackson,male,2481,20838,21418,42256,0.1190613302620213,Texas
4872,2013,Jackson,male,2481,15885,16639,32524,0.15618508026440037,Texas
4873,2013,Jackson,male,2481,12579,12805,25384,0.19723348437872645,Texas
4874,2013,Jackson,male,2481,104458,109809,214267,0.023751172720136323,Texas
4875,2013,Jackson,male,2481,1611,1676,3287,1.5400372439478585,Texas
4876,2013,Jackson,male,2481,5826,5789,11615,0.4258496395468589,Texas
4877,2013,Jackson,male,2481,7226,7594,14820,0.3433434818710213,Texas
4878,2013,Jackson,male,2481,14417,14601,29018,0.1720885066241243,Texas
4879,2013,Jackson,male,2481,10955,9551,20506,0.22647193062528526,Texas
4904,2014,Jackson,male,1435,25536,26558,52094,0.05619517543859649,Texas
4905,2014,Jackson,male,1435,8512,8713,17225,0.16858552631578946,Texas
4906,2014,Jackson,male,1435,631,665,1296,2.2741679873217118,Texas
4907,2014,Jackson,male,1435,26784,21688,48472,0.053576762246117085,Texas
4908,2014,Jackson,male,1435,32445,33310,65755,0.04422869471413161,Texas
4909,2014,Jackson,male,1435,28989,29562,58551,0.049501535065024665,Texas
4910,2014,Jackson,male,1435,21822,22116,43938,0.06575932545137934,Texas
4911,2014,Jackson,male,1435,9712,9683,19395,0.14775535420098848,Texas
4912,2014,Jackson,male,1435,6642,6676,13318,0.21604938271604937,Texas
4913,2014,Jackson,male,1435,6655,6718,13373,0.21562734785875282,Texas
4914,2014,Jackson,male,1435,8080,7846,15926,0.1775990099009901,Texas
4915,2014,Jackson,male,1435,81205,77708,158913,0.017671325657287112,Texas
4916,2014,Jackson,male,1435,5069,4978,10047,0.2830933122903926,Texas
4917,2014,Jackson,male,1435,70065,71949,142014,0.020480981945336475,Texas
4918,2014,Jackson,male,1435,334604,357399,692003,0.0042886516598725655,Texas
4919,2014,Jackson,male,1435,20838,21418,42256,0.06886457433534889,Texas
4920,2014,Jackson,male,1435,15885,16639,32524,0.09033679571923198,Texas
4921,2014,Jackson,male,1435,12579,12805,25384,0.11407902058987202,Texas
4922,2014,Jackson,male,1435,104458,109809,214267,0.01373757873978058,Texas
4923,2014,Jackson,male,1435,1611,1676,3287,0.8907510862818125,Texas
4924,2014,Jackson,male,1435,5826,5789,11615,0.24630964641263303,Texas
4925,2014,Jackson,male,1435,7226,7594,14820,0.19858843066703571,Texas
4926,2014,Jackson,male,1435,14417,14601,29018,0.09953527086078935,Texas
4927,2014,Jackson,male,1435,10955,9551,20506,0.13099041533546327,Texas
4952,2015,Jackson,male,2522,25536,26558,52094,0.0987625313283208,Texas
4953,2015,Jackson,male,2522,8512,8713,17225,0.2962875939849624,Texas
4954,2015,Jackson,male,2522,631,665,1296,3.9968304278922346,Texas
4955,2015,Jackson,male,2522,26784,21688,48472,0.09416069295101553,Texas
4956,2015,Jackson,male,2522,32445,33310,65755,0.07773154569271074,Texas
4957,2015,Jackson,male,2522,28989,29562,58551,0.08699851667874021,Texas
4958,2015,Jackson,male,2522,21822,22116,43938,0.1155714416643754,Texas
4959,2015,Jackson,male,2522,9712,9683,19395,0.2596787479406919,Texas
4960,2015,Jackson,male,2522,6642,6676,13318,0.3797049081601927,Texas
4961,2015,Jackson,male,2522,6655,6718,13373,0.37896318557475583,Texas
4962,2015,Jackson,male,2522,8080,7846,15926,0.31212871287128713,Texas
4963,2015,Jackson,male,2522,81205,77708,158913,0.031057200911273935,Texas
4964,2015,Jackson,male,2522,5069,4978,10047,0.49753403038074573,Texas
4965,2015,Jackson,male,2522,70065,71949,142014,0.035995147363162776,Texas
4966,2015,Jackson,male,2522,334604,357399,692003,0.007537267934633178,Texas
4967,2015,Jackson,male,2522,20838,21418,42256,0.12102888952874556,Texas
4968,2015,Jackson,male,2522,15885,16639,32524,0.15876613157066416,Texas
4969,2015,Jackson,male,2522,12579,12805,25384,0.2004928849670085,Texas
4970,2015,Jackson,male,2522,104458,109809,214267,0.02414367496984434,Texas
4971,2015,Jackson,male,2522,1611,1676,3287,1.5654872749844817,Texas
4972,2015,Jackson,male,2522,5826,5789,11615,0.4328870580157913,Texas
4973,2015,Jackson,male,2522,7226,7594,14820,0.34901743703293664,Texas
4974,2015,Jackson,male,2522,14417,14601,29018,0.17493237150586113,Texas
4975,2015,Jackson,male,2522,10955,9551,20506,0.2302145139205842,Texas
5000,2016,Jackson,male,2800,25536,26558,52094,0.10964912280701754,Texas
5001,2016,Jackson,male,2800,8512,8713,17225,0.32894736842105265,Texas
5002,2016,Jackson,male,2800,631,665,1296,4.437400950871632,Texas
5003,2016,Jackson,male,2800,26784,21688,48472,0.10454002389486261,Texas
5004,2016,Jackson,male,2800,32445,33310,65755,0.08629989212513485,Texas
5005,2016,Jackson,male,2800,28989,29562,58551,0.09658836110248716,Texas
5006,2016,Jackson,male,2800,21822,22116,43938,0.12831087892952067,Texas
5007,2016,Jackson,male,2800,9712,9683,19395,0.2883031301482702,Texas
5008,2016,Jackson,male,2800,6642,6676,13318,0.4215597711532671,Texas
5009,2016,Jackson,male,2800,6655,6718,13373,0.42073628850488354,Texas
5010,2016,Jackson,male,2800,8080,7846,15926,0.3465346534653465,Texas
5011,2016,Jackson,male,2800,81205,77708,158913,0.0344806354288529,Texas
5012,2016,Jackson,male,2800,5069,4978,10047,0.5523771947129611,Texas
5013,2016,Jackson,male,2800,70065,71949,142014,0.03996289160065653,Texas
5014,2016,Jackson,male,2800,334604,357399,692003,0.008368100799751348,Texas
5015,2016,Jackson,male,2800,20838,21418,42256,0.13436990114214417,Texas
5016,2016,Jackson,male,2800,15885,16639,32524,0.1762669184765502,Texas
5017,2016,Jackson,male,2800,12579,12805,25384,0.22259321090706732,Texas
5018,2016,Jackson,male,2800,104458,109809,214267,0.026805031687376746,Texas
5019,2016,Jackson,male,2800,1611,1676,3287,1.7380509000620732,Texas
5020,2016,Jackson,male,2800,5826,5789,11615,0.4806041881222108,Texas
5021,2016,Jackson,male,2800,7226,7594,14820,0.38748962081372823,Texas
5022,2016,Jackson,male,2800,14417,14601,29018,0.19421516265519873,Texas
5023,2016,Jackson,male,2800,10955,9551,20506,0.25559105431309903,Texas
5032,2009,Jasper,male,7959,6682,7102,13784,1.1911104459742592,Texas
5033,2009,Jasper,male,7959,4809,4789,9598,1.6550218340611353,Texas
5034,2009,Jasper,male,7959,16699,16750,33449,0.4766153661895922,Texas
5035,2009,Jasper,male,7959,18669,18222,36891,0.4263217097862767,Texas
5036,2009,Jasper,male,7959,8048,8481,16529,0.9889413518886679,Texas
5037,2009,Jasper,male,7959,58223,61015,119238,0.13669855555364718,Texas
5038,2009,Jasper,male,7959,14070,13830,27900,0.5656716417910448,Texas
5039,2009,Jasper,male,7959,17501,18003,35504,0.4547740129135478,Texas
5048,2010,Jasper,male,10764,6682,7102,13784,1.6108949416342413,Texas
5049,2010,Jasper,male,10764,4809,4789,9598,2.2383031815346226,Texas
5050,2010,Jasper,male,10764,16699,16750,33449,0.6445894963770286,Texas
5051,2010,Jasper,male,10764,18669,18222,36891,0.5765707857946328,Texas
5052,2010,Jasper,male,10764,8048,8481,16529,1.3374751491053678,Texas
5053,2010,Jasper,male,10764,58223,61015,119238,0.1848753928859729,Texas
5054,2010,Jasper,male,10764,14070,13830,27900,0.7650319829424307,Texas
5055,2010,Jasper,male,10764,17501,18003,35504,0.6150505685389406,Texas
5064,2011,Jasper,male,11117,6682,7102,13784,1.663723436096977,Texas
5065,2011,Jasper,male,11117,4809,4789,9598,2.311707215637347,Texas
5066,2011,Jasper,male,11117,16699,16750,33449,0.6657284867357327,Texas
5067,2011,Jasper,male,11117,18669,18222,36891,0.5954791365365044,Texas
5068,2011,Jasper,male,11117,8048,8481,16529,1.3813369781312128,Texas
5069,2011,Jasper,male,11117,58223,61015,119238,0.19093828899232262,Texas
5070,2011,Jasper,male,11117,14070,13830,27900,0.7901208244491826,Texas
5071,2011,Jasper,male,11117,17501,18003,35504,0.6352208445231701,Texas
5080,2012,Jasper,male,11805,6682,7102,13784,1.7666866207722238,Texas
5081,2012,Jasper,male,11805,4809,4789,9598,2.454772301933874,Texas
5082,2012,Jasper,male,11805,16699,16750,33449,0.7069285585963231,Texas
5083,2012,Jasper,male,11805,18669,18222,36891,0.632331672826611,Texas
5084,2012,Jasper,male,11805,8048,8481,16529,1.466824055666004,Texas
5085,2012,Jasper,male,11805,58223,61015,119238,0.20275492502962747,Texas
5086,2012,Jasper,male,11805,14070,13830,27900,0.8390191897654584,Texas
5087,2012,Jasper,male,11805,17501,18003,35504,0.6745328838352094,Texas
5096,2013,Jasper,male,14661,6682,7102,13784,2.194103561807842,Texas
5097,2013,Jasper,male,14661,4809,4789,9598,3.04865876481597,Texas
5098,2013,Jasper,male,14661,16699,16750,33449,0.8779567638780765,Texas
5099,2013,Jasper,male,14661,18669,18222,36891,0.7853125502169371,Texas
5100,2013,Jasper,male,14661,8048,8481,16529,1.8216948310139165,Texas
5101,2013,Jasper,male,14661,58223,61015,119238,0.2518077048589046,Texas
5102,2013,Jasper,male,14661,14070,13830,27900,1.0420042643923242,Texas
5103,2013,Jasper,male,14661,17501,18003,35504,0.8377235586537912,Texas
5112,2014,Jasper,male,12340,6682,7102,13784,1.8467524693205628,Texas
5113,2014,Jasper,male,12340,4809,4789,9598,2.5660220420045747,Texas
5114,2014,Jasper,male,12340,16699,16750,33449,0.7389664051739625,Texas
5115,2014,Jasper,male,12340,18669,18222,36891,0.6609888049708073,Texas
5116,2014,Jasper,male,12340,8048,8481,16529,1.533300198807157,Texas
5117,2014,Jasper,male,12340,58223,61015,119238,0.21194373357607818,Texas
5118,2014,Jasper,male,12340,14070,13830,27900,0.8770433546552949,Texas
5119,2014,Jasper,male,12340,17501,18003,35504,0.7051025655676818,Texas
5128,2015,Jasper,male,11003,6682,7102,13784,1.6466626758455551,Texas
5129,2015,Jasper,male,11003,4809,4789,9598,2.288001663547515,Texas
5130,2015,Jasper,male,11003,16699,16750,33449,0.6589017306425534,Texas
5131,2015,Jasper,male,11003,18669,18222,36891,0.5893727569768065,Texas
5132,2015,Jasper,male,11003,8048,8481,16529,1.367171968190855,Texas
5133,2015,Jasper,male,11003,58223,61015,119238,0.18898029988149012,Texas
5134,2015,Jasper,male,11003,14070,13830,27900,0.7820184790334044,Texas
5135,2015,Jasper,male,11003,17501,18003,35504,0.6287069310325124,Texas
5144,2016,Jasper,male,9735,6682,7102,13784,1.4568991319964082,Texas
5145,2016,Jasper,male,9735,4809,4789,9598,2.024329382407985,Texas
5146,2016,Jasper,male,9735,16699,16750,33449,0.5829690400622792,Texas
5147,2016,Jasper,male,9735,18669,18222,36891,0.5214526755584123,Texas
5148,2016,Jasper,male,9735,8048,8481,16529,1.2096172962226641,Texas
5149,2016,Jasper,male,9735,58223,61015,119238,0.16720196485924807,Texas
5150,2016,Jasper,male,9735,14070,13830,27900,0.6918976545842217,Texas
5151,2016,Jasper,male,9735,17501,18003,35504,0.5562539283469516,Texas
5154,2009,Jeff Davis,male,3072,7408,7583,14991,0.4146868250539957,Texas
5155,2009,Jeff Davis,male,3072,1114,1120,2234,2.7576301615798924,Texas
5158,2010,Jeff Davis,male,2556,7408,7583,14991,0.34503239740820735,Texas
5159,2010,Jeff Davis,male,2556,1114,1120,2234,2.29443447037702,Texas
5162,2011,Jeff Davis,male,2338,7408,7583,14991,0.3156047516198704,Texas
5163,2011,Jeff Davis,male,2338,1114,1120,2234,2.098743267504488,Texas
5166,2012,Jeff Davis,male,1128,7408,7583,14991,0.15226781857451405,Texas
5167,2012,Jeff Davis,male,1128,1114,1120,2234,1.0125673249551166,Texas
5170,2013,Jeff Davis,male,1235,7408,7583,14991,0.16671166306695465,Texas
5171,2013,Jeff Davis,male,1235,1114,1120,2234,1.1086175942549372,Texas
5174,2014,Jeff Davis,male,1380,7408,7583,14991,0.18628509719222464,Texas
5175,2014,Jeff Davis,male,1380,1114,1120,2234,1.2387791741472172,Texas
5178,2015,Jeff Davis,male,1190,7408,7583,14991,0.16063714902807774,Texas
5179,2015,Jeff Davis,male,1190,1114,1120,2234,1.0682226211849193,Texas
5182,2016,Jeff Davis,male,1866,7408,7583,14991,0.25188984881209503,Texas
5183,2016,Jeff Davis,male,1866,1114,1120,2234,1.675044883303411,Texas
5210,2009,Jefferson,male,10907,312348,347544,659892,0.034919384788761255,Texas
5211,2009,Jefferson,male,10907,34906,35518,70424,0.3124677705838538,Texas
5212,2009,Jefferson,male,10907,283919,286508,570427,0.038415886221070096,Texas
5213,2009,Jefferson,male,10907,7507,6598,14105,1.4529106167576928,Texas
5214,2009,Jefferson,male,10907,7605,8167,15772,1.4341880341880342,Texas
5215,2009,Jefferson,male,10907,14295,13674,27969,0.7629940538649878,Texas
5216,2009,Jefferson,male,10907,19567,18602,38169,0.5574181019062707,Texas
5217,2009,Jefferson,male,10907,15333,16904,32237,0.7113415509032806,Texas
5218,2009,Jefferson,male,10907,9112,8965,18077,1.1969929762949956,Texas
5219,2009,Jefferson,male,10907,9581,9307,18888,1.1383989145183175,Texas
5220,2009,Jefferson,male,10907,370844,396310,767154,0.029411288843826516,Texas
5221,2009,Jefferson,male,10907,211175,224125,435300,0.05164910619154729,Texas
5222,2009,Jefferson,male,10907,3642,3704,7346,2.9947830862163647,Texas
5223,2009,Jefferson,male,10907,110887,112415,223302,0.09836139493358104,Texas
5224,2009,Jefferson,male,10907,5979,5799,11778,1.8242180966716843,Texas
5225,2009,Jefferson,male,10907,3486,3702,7188,3.1288009179575447,Texas
5226,2009,Jefferson,male,10907,59931,54517,114448,0.18199262485191303,Texas
5227,2009,Jefferson,male,10907,32489,34397,66886,0.33571362615038935,Texas
5228,2009,Jefferson,male,10907,3104,3119,6223,3.513853092783505,Texas
5229,2009,Jefferson,male,10907,12010,11133,23143,0.9081598667776852,Texas
5230,2009,Jefferson,male,10907,21887,22197,44084,0.4983323434001919,Texas
5231,2009,Jefferson,male,10907,26099,27148,53247,0.41790873213533086,Texas
5232,2009,Jefferson,male,10907,130660,124550,255210,0.0834761977651921,Texas
5233,2009,Jefferson,male,10907,15354,15502,30856,0.7103686335808258,Texas
5234,2009,Jefferson,male,10907,27743,28436,56179,0.393144216559132,Texas
5235,2009,Jefferson,male,10907,42343,42309,84652,0.25758685024679406,Texas
5262,2010,Jefferson,male,12880,312348,347544,659892,0.04123605721823095,Texas
5263,2010,Jefferson,male,12880,34906,35518,70424,0.36899100441184896,Texas
5264,2010,Jefferson,male,12880,283919,286508,570427,0.045365051299842564,Texas
5265,2010,Jefferson,male,12880,7507,6598,14105,1.7157319834820834,Texas
5266,2010,Jefferson,male,12880,7605,8167,15772,1.6936226166995398,Texas
5267,2010,Jefferson,male,12880,14295,13674,27969,0.9010143406785589,Texas
5268,2010,Jefferson,male,12880,19567,18602,38169,0.658251137118618,Texas
5269,2010,Jefferson,male,12880,15333,16904,32237,0.8400182612665493,Texas
5270,2010,Jefferson,male,12880,9112,8965,18077,1.4135206321334504,Texas
5271,2010,Jefferson,male,12880,9581,9307,18888,1.3443273144765682,Texas
5272,2010,Jefferson,male,12880,370844,396310,767154,0.03473158524878386,Texas
5273,2010,Jefferson,male,12880,211175,224125,435300,0.0609920681898899,Texas
5274,2010,Jefferson,male,12880,3642,3704,7346,3.5365183964854476,Texas
5275,2010,Jefferson,male,12880,110887,112415,223302,0.1161542831891926,Texas
5276,2010,Jefferson,male,12880,5979,5799,11778,2.1542063890282654,Texas
5277,2010,Jefferson,male,12880,3486,3702,7188,3.6947791164658637,Texas
5278,2010,Jefferson,male,12880,59931,54517,114448,0.21491381755685704,Texas
5279,2010,Jefferson,male,12880,32489,34397,66886,0.39644187263381453,Texas
5280,2010,Jefferson,male,12880,3104,3119,6223,4.149484536082475,Texas
5281,2010,Jefferson,male,12880,12010,11133,23143,1.0724396336386344,Texas
5282,2010,Jefferson,male,12880,21887,22197,44084,0.5884771782336546,Texas
5283,2010,Jefferson,male,12880,26099,27148,53247,0.4935054982949538,Texas
5284,2010,Jefferson,male,12880,130660,124550,255210,0.09857645798255013,Texas
5285,2010,Jefferson,male,12880,15354,15502,30856,0.838869350006513,Texas
5286,2010,Jefferson,male,12880,27743,28436,56179,0.4642612550913744,Texas
5287,2010,Jefferson,male,12880,42343,42309,84652,0.3041825095057034,Texas
5314,2011,Jefferson,male,18470,312348,347544,659892,0.05913276217552217,Texas
5315,2011,Jefferson,male,18470,34906,35518,70424,0.529135392196184,Texas
5316,2011,Jefferson,male,18470,283919,286508,570427,0.0650537653344792,Texas
5317,2011,Jefferson,male,18470,7507,6598,14105,2.460370321033702,Texas
5318,2011,Jefferson,male,18470,7605,8167,15772,2.428665351742275,Texas
5319,2011,Jefferson,male,18470,14295,13674,27969,1.292060160895418,Texas
5320,2011,Jefferson,male,18470,19567,18602,38169,0.9439362191444779,Texas
5321,2011,Jefferson,male,18470,15333,16904,32237,1.20459140416096,Texas
5322,2011,Jefferson,male,18470,9112,8965,18077,2.0269973661106233,Texas
5323,2011,Jefferson,male,18470,9581,9307,18888,1.927773718818495,Texas
5324,2011,Jefferson,male,18470,370844,396310,767154,0.04980530897088803,Texas
5325,2011,Jefferson,male,18470,211175,224125,435300,0.08746300461702379,Texas
5326,2011,Jefferson,male,18470,3642,3704,7346,5.071389346512905,Texas
5327,2011,Jefferson,male,18470,110887,112415,223302,0.16656596354847727,Texas
5328,2011,Jefferson,male,18470,5979,5799,11778,3.08914534203044,Texas
5329,2011,Jefferson,male,18470,3486,3702,7188,5.29833620195066,Texas
5330,2011,Jefferson,male,18470,59931,54517,114448,0.30818774924496506,Texas
5331,2011,Jefferson,male,18470,32489,34397,66886,0.5685001077287697,Texas
5332,2011,Jefferson,male,18470,3104,3119,6223,5.950386597938144,Texas
5333,2011,Jefferson,male,18470,12010,11133,23143,1.5378850957535388,Texas
5334,2011,Jefferson,male,18470,21887,22197,44084,0.8438799287248138,Texas
5335,2011,Jefferson,male,18470,26099,27148,53247,0.707689949806506,Texas
5336,2011,Jefferson,male,18470,130660,124550,255210,0.14135925302311342,Texas
5337,2011,Jefferson,male,18470,15354,15502,30856,1.2029438582779732,Texas
5338,2011,Jefferson,male,18470,27743,28436,56179,0.665753523411311,Texas
5339,2011,Jefferson,male,18470,42343,42309,84652,0.4361996079635359,Texas
5366,2012,Jefferson,male,19053,312348,347544,659892,0.060999270044949865,Texas
5367,2012,Jefferson,male,19053,34906,35518,70424,0.5458373918524037,Texas
5368,2012,Jefferson,male,19053,283919,286508,570427,0.06710716788943326,Texas
5369,2012,Jefferson,male,19053,7507,6598,14105,2.5380311709071535,Texas
5370,2012,Jefferson,male,19053,7605,8167,15772,2.5053254437869823,Texas
5371,2012,Jefferson,male,19053,14295,13674,27969,1.3328436516264428,Texas
5372,2012,Jefferson,male,19053,19567,18602,38169,0.9737312822609495,Texas
5373,2012,Jefferson,male,19053,15333,16904,32237,1.2426139698689103,Texas
5374,2012,Jefferson,male,19053,9112,8965,18077,2.090978928884987,Texas
5375,2012,Jefferson,male,19053,9581,9307,18888,1.988623316981526,Texas
5376,2012,Jefferson,male,19053,370844,396310,767154,0.051377398582692455,Texas
5377,2012,Jefferson,male,19053,211175,224125,435300,0.09022374807624009,Texas
5378,2012,Jefferson,male,19053,3642,3704,7346,5.231466227347611,Texas
5379,2012,Jefferson,male,19053,110887,112415,223302,0.1718235681369322,Texas
5380,2012,Jefferson,male,19053,5979,5799,11778,3.1866532865027595,Texas
5381,2012,Jefferson,male,19053,3486,3702,7188,5.465576592082616,Texas
5382,2012,Jefferson,male,19053,59931,54517,114448,0.3179156029433849,Texas
5383,2012,Jefferson,male,19053,32489,34397,66886,0.5864446428021792,Texas
5384,2012,Jefferson,male,19053,3104,3119,6223,6.138208762886598,Texas
5385,2012,Jefferson,male,19053,12010,11133,23143,1.586427976686095,Texas
5386,2012,Jefferson,male,19053,21887,22197,44084,0.8705167450998309,Texas
5387,2012,Jefferson,male,19053,26099,27148,53247,0.7300279704203226,Texas
5388,2012,Jefferson,male,19053,130660,124550,255210,0.14582121536813103,Texas
5389,2012,Jefferson,male,19053,15354,15502,30856,1.2409144196951933,Texas
5390,2012,Jefferson,male,19053,27743,28436,56179,0.6867678333273258,Texas
5391,2012,Jefferson,male,19053,42343,42309,84652,0.44996811751647264,Texas
5418,2013,Jefferson,male,15980,312348,347544,659892,0.05116088465429585,Texas
5419,2013,Jefferson,male,15980,34906,35518,70424,0.45780095112588093,Texas
5420,2013,Jefferson,male,15980,283919,286508,570427,0.056283658367351254,Texas
5421,2013,Jefferson,male,15980,7507,6598,14105,2.128679898761156,Texas
5422,2013,Jefferson,male,15980,7605,8167,15772,2.1012491781722553,Texas
5423,2013,Jefferson,male,15980,14295,13674,27969,1.1178733823015041,Texas
5424,2013,Jefferson,male,15980,19567,18602,38169,0.8166811468288445,Texas
5425,2013,Jefferson,male,15980,15333,16904,32237,1.0421965694906412,Texas
5426,2013,Jefferson,male,15980,9112,8965,18077,1.7537313432835822,Texas
5427,2013,Jefferson,male,15980,9581,9307,18888,1.6678843544515187,Texas
5428,2013,Jefferson,male,15980,370844,396310,767154,0.043090895363009786,Texas
5429,2013,Jefferson,male,15980,211175,224125,435300,0.07567183615484788,Texas
5430,2013,Jefferson,male,15980,3642,3704,7346,4.3876990664470075,Texas
5431,2013,Jefferson,male,15980,110887,112415,223302,0.1441106712238585,Texas
5432,2013,Jefferson,male,15980,5979,5799,11778,2.6726877404248204,Texas
5433,2013,Jefferson,male,15980,3486,3702,7188,4.584050487664945,Texas
5434,2013,Jefferson,male,15980,59931,54517,114448,0.2666399692980261,Texas
5435,2013,Jefferson,male,15980,32489,34397,66886,0.49185878297269847,Texas
5436,2013,Jefferson,male,15980,3104,3119,6223,5.14819587628866,Texas
5437,2013,Jefferson,male,15980,12010,11133,23143,1.3305578684429642,Texas
5438,2013,Jefferson,male,15980,21887,22197,44084,0.7301137661625623,Texas
5439,2013,Jefferson,male,15980,26099,27148,53247,0.6122839955553853,Texas
5440,2013,Jefferson,male,15980,130660,124550,255210,0.1223021582733813,Texas
5441,2013,Jefferson,male,15980,15354,15502,30856,1.04077113455777,Texas
5442,2013,Jefferson,male,15980,27743,28436,56179,0.5760011534441121,Texas
5443,2013,Jefferson,male,15980,42343,42309,84652,0.3773941383463619,Texas
5470,2014,Jefferson,male,10766,312348,347544,659892,0.03446796521828217,Texas
5471,2014,Jefferson,male,10766,34906,35518,70424,0.30842835042686073,Texas
5472,2014,Jefferson,male,10766,283919,286508,570427,0.037919265706064055,Texas
5473,2014,Jefferson,male,10766,7507,6598,14105,1.4341281470627414,Texas
5474,2014,Jefferson,male,10766,7605,8167,15772,1.415647600262985,Texas
5475,2014,Jefferson,male,10766,14295,13674,27969,0.7531304651976215,Texas
5476,2014,Jefferson,male,10766,19567,18602,38169,0.5502120917871928,Texas
5477,2014,Jefferson,male,10766,15333,16904,32237,0.7021456988195396,Texas
5478,2014,Jefferson,male,10766,9112,8965,18077,1.1815188762071993,Texas
5479,2014,Jefferson,male,10766,9581,9307,18888,1.1236822878613923,Texas
5480,2014,Jefferson,male,10766,370844,396310,767154,0.029031075061211723,Texas
5481,2014,Jefferson,male,10766,211175,224125,435300,0.050981413519592754,Texas
5482,2014,Jefferson,male,10766,3642,3704,7346,2.956068094453597,Texas
5483,2014,Jefferson,male,10766,110887,112415,223302,0.09708983018748817,Texas
5484,2014,Jefferson,male,10766,5979,5799,11778,1.8006355577855828,Texas
5485,2014,Jefferson,male,10766,3486,3702,7188,3.0883534136546187,Texas
5486,2014,Jefferson,male,10766,59931,54517,114448,0.17963991924045986,Texas
5487,2014,Jefferson,male,10766,32489,34397,66886,0.33137369571239494,Texas
5488,2014,Jefferson,male,10766,3104,3119,6223,3.4684278350515463,Texas
5489,2014,Jefferson,male,10766,12010,11133,23143,0.8964196502914238,Texas
5490,2014,Jefferson,male,10766,21887,22197,44084,0.49189016311052225,Texas
5491,2014,Jefferson,male,10766,26099,27148,53247,0.4125062262921951,Texas
5492,2014,Jefferson,male,10766,130660,124550,255210,0.08239706107454461,Texas
5493,2014,Jefferson,male,10766,15354,15502,30856,0.7011853588641397,Texas
5494,2014,Jefferson,male,10766,27743,28436,56179,0.38806185344050753,Texas
5495,2014,Jefferson,male,10766,42343,42309,84652,0.2542569019672673,Texas
5522,2015,Jefferson,male,9344,312348,347544,659892,0.029915350826642078,Texas
5523,2015,Jefferson,male,9344,34906,35518,70424,0.267690368418037,Texas
5524,2015,Jefferson,male,9344,283919,286508,570427,0.03291079498025845,Texas
5525,2015,Jefferson,male,9344,7507,6598,14105,1.2447049420540828,Texas
5526,2015,Jefferson,male,9344,7605,8167,15772,1.2286653517422748,Texas
5527,2015,Jefferson,male,9344,14295,13674,27969,0.65365512416929,Texas
5528,2015,Jefferson,male,9344,19567,18602,38169,0.4775387131394695,Texas
5529,2015,Jefferson,male,9344,15333,16904,32237,0.6094045522728755,Texas
5530,2015,Jefferson,male,9344,9112,8965,18077,1.025460930640913,Texas
5531,2015,Jefferson,male,9344,9581,9307,18888,0.9752635424277215,Texas
5532,2015,Jefferson,male,9344,370844,396310,767154,0.025196578615266797,Texas
5533,2015,Jefferson,male,9344,211175,224125,435300,0.0442476618917959,Texas
5534,2015,Jefferson,male,9344,3642,3704,7346,2.5656232839099395,Texas
5535,2015,Jefferson,male,9344,110887,112415,223302,0.08426596445029624,Texas
5536,2015,Jefferson,male,9344,5979,5799,11778,1.5628031443385182,Texas
5537,2015,Jefferson,male,9344,3486,3702,7188,2.6804360298336203,Texas
5538,2015,Jefferson,male,9344,59931,54517,114448,0.1559126328611236,Texas
5539,2015,Jefferson,male,9344,32489,34397,66886,0.287605035550494,Texas
5540,2015,Jefferson,male,9344,3104,3119,6223,3.0103092783505154,Texas
5541,2015,Jefferson,male,9344,12010,11133,23143,0.7780183180682765,Texas
5542,2015,Jefferson,male,9344,21887,22197,44084,0.42692008955087496,Texas
5543,2015,Jefferson,male,9344,26099,27148,53247,0.3580213801295069,Texas
5544,2015,Jefferson,male,9344,130660,124550,255210,0.07151385274758916,Texas
5545,2015,Jefferson,male,9344,15354,15502,30856,0.6085710564022404,Texas
5546,2015,Jefferson,male,9344,27743,28436,56179,0.33680568071225175,Texas
5547,2015,Jefferson,male,9344,42343,42309,84652,0.22067401931842334,Texas
5574,2016,Jefferson,male,11146,312348,347544,659892,0.03568455696850948,Texas
5575,2016,Jefferson,male,11146,34906,35518,70424,0.3193147309918066,Texas
5576,2016,Jefferson,male,11146,283919,286508,570427,0.039257675604661896,Texas
5577,2016,Jefferson,male,11146,7507,6598,14105,1.48474756893566,Texas
5578,2016,Jefferson,male,11146,7605,8167,15772,1.4656147271531887,Texas
5579,2016,Jefferson,male,11146,14295,13674,27969,0.7797131864288213,Texas
5580,2016,Jefferson,male,11146,19567,18602,38169,0.5696325445903818,Texas
5581,2016,Jefferson,male,11146,15333,16904,32237,0.7269288462792669,Texas
5582,2016,Jefferson,male,11146,9112,8965,18077,1.2232221246707637,Texas
5583,2016,Jefferson,male,11146,9581,9307,18888,1.1633441185679991,Texas
5584,2016,Jefferson,male,11146,370844,396310,767154,0.030055764688116837,Texas
5585,2016,Jefferson,male,11146,211175,224125,435300,0.05278086894755535,Texas
5586,2016,Jefferson,male,11146,3642,3704,7346,3.0604063701263042,Texas
5587,2016,Jefferson,male,11146,110887,112415,223302,0.10051674226915688,Texas
5588,2016,Jefferson,male,11146,5979,5799,11778,1.8641913363438702,Texas
5589,2016,Jefferson,male,11146,3486,3702,7188,3.1973608720596673,Texas
5590,2016,Jefferson,male,11146,59931,54517,114448,0.18598054429260316,Texas
5591,2016,Jefferson,male,11146,32489,34397,66886,0.34306996214103236,Texas
5592,2016,Jefferson,male,11146,3104,3119,6223,3.5908505154639174,Texas
5593,2016,Jefferson,male,11146,12010,11133,23143,0.928059950041632,Texas
5594,2016,Jefferson,male,11146,21887,22197,44084,0.5092520674372916,Texas
5595,2016,Jefferson,male,11146,26099,27148,53247,0.42706617111766737,Texas
5596,2016,Jefferson,male,11146,130660,124550,255210,0.08530537272309811,Texas
5597,2016,Jefferson,male,11146,15354,15502,30856,0.7259346098736486,Texas
5598,2016,Jefferson,male,11146,27743,28436,56179,0.4017590022708431,Texas
5599,2016,Jefferson,male,11146,42343,42309,84652,0.26323123066386417,Texas
5601,2009,Jim Hogg,male,4706,2550,2732,5282,1.8454901960784313,Texas
5603,2010,Jim Hogg,male,5774,2550,2732,5282,2.264313725490196,Texas
5605,2011,Jim Hogg,male,5967,2550,2732,5282,2.34,Texas
5607,2012,Jim Hogg,male,3212,2550,2732,5282,1.2596078431372548,Texas
5609,2013,Jim Hogg,male,2490,2550,2732,5282,0.9764705882352941,Texas
5611,2014,Jim Hogg,male,2394,2550,2732,5282,0.9388235294117647,Texas
5613,2015,Jim Hogg,male,2108,2550,2732,5282,0.8266666666666667,Texas
5615,2016,Jim Hogg,male,3212,2550,2732,5282,1.2596078431372548,Texas
5617,2009,Jim Wells,male,7923,20178,21014,41192,0.3926553672316384,Texas
5619,2010,Jim Wells,male,7697,20178,21014,41192,0.3814550500545148,Texas
5621,2011,Jim Wells,male,10296,20178,21014,41192,0.5102586975914363,Texas
5623,2012,Jim Wells,male,9877,20178,21014,41192,0.4894935077807513,Texas
5625,2013,Jim Wells,male,7622,20178,21014,41192,0.3777381306373278,Texas
5627,2014,Jim Wells,male,6509,20178,21014,41192,0.32257904648627217,Texas
5629,2015,Jim Wells,male,4920,20178,21014,41192,0.2438299137674695,Texas
5631,2016,Jim Wells,male,5999,20178,21014,41192,0.2973039944494003,Texas
5644,2009,Johnson,male,10388,12976,13315,26291,0.8005548705302096,Texas
5645,2009,Johnson,male,10388,5318,4412,9730,1.9533659270402406,Texas
5646,2009,Johnson,male,10388,7015,5587,12602,1.4808267997148967,Texas
5647,2009,Johnson,male,10388,74349,77215,151564,0.13971943133061643,Texas
5648,2009,Johnson,male,10388,72765,74236,147001,0.14276094276094276,Texas
5649,2009,Johnson,male,10388,286987,298515,585502,0.0361967615257834,Texas
5650,2009,Johnson,male,10388,11200,11643,22843,0.9275,Texas
5651,2009,Johnson,male,10388,27715,25974,53689,0.3748150820855133,Texas
5652,2009,Johnson,male,10388,3097,2100,5197,3.354213755247013,Texas
5653,2009,Johnson,male,10388,9682,8107,17789,1.072918818425945,Texas
5654,2009,Johnson,male,10388,81568,81907,163475,0.1273538642604943,Texas
5655,2009,Johnson,male,10388,4477,4038,8515,2.3203037748492292,Texas
5668,2010,Johnson,male,13196,12976,13315,26291,1.0169543773119605,Texas
5669,2010,Johnson,male,13196,5318,4412,9730,2.481383978939451,Texas
5670,2010,Johnson,male,13196,7015,5587,12602,1.881111903064861,Texas
5671,2010,Johnson,male,13196,74349,77215,151564,0.17748725604917348,Texas
5672,2010,Johnson,male,13196,72765,74236,147001,0.18135092420806706,Texas
5673,2010,Johnson,male,13196,286987,298515,585502,0.04598117684773178,Texas
5674,2010,Johnson,male,13196,11200,11643,22843,1.1782142857142857,Texas
5675,2010,Johnson,male,13196,27715,25974,53689,0.47613205845210177,Texas
5676,2010,Johnson,male,13196,3097,2100,5197,4.260897642880207,Texas
5677,2010,Johnson,male,13196,9682,8107,17789,1.3629415410039247,Texas
5678,2010,Johnson,male,13196,81568,81907,163475,0.16177912907022363,Texas
5679,2010,Johnson,male,13196,4477,4038,8515,2.9475094929640386,Texas
5692,2011,Johnson,male,12190,12976,13315,26291,0.9394266337854501,Texas
5693,2011,Johnson,male,12190,5318,4412,9730,2.2922151184655886,Texas
5694,2011,Johnson,male,12190,7015,5587,12602,1.7377049180327868,Texas
5695,2011,Johnson,male,12190,74349,77215,151564,0.16395647554102946,Texas
5696,2011,Johnson,male,12190,72765,74236,147001,0.16752559609702466,Texas
5697,2011,Johnson,male,12190,286987,298515,585502,0.04247579158637848,Texas
5698,2011,Johnson,male,12190,11200,11643,22843,1.0883928571428572,Texas
5699,2011,Johnson,male,12190,27715,25974,53689,0.43983402489626555,Texas
5700,2011,Johnson,male,12190,3097,2100,5197,3.9360671617694543,Texas
5701,2011,Johnson,male,12190,9682,8107,17789,1.2590373889692212,Texas
5702,2011,Johnson,male,12190,81568,81907,163475,0.14944586112200864,Texas
5703,2011,Johnson,male,12190,4477,4038,8515,2.7228054500781775,Texas
5716,2012,Johnson,male,13000,12976,13315,26291,1.001849568434032,Texas
5717,2012,Johnson,male,13000,5318,4412,9730,2.444528018051899,Texas
5718,2012,Johnson,male,13000,7015,5587,12602,1.8531717747683536,Texas
5719,2012,Johnson,male,13000,74349,77215,151564,0.17485104036369017,Texas
5720,2012,Johnson,male,13000,72765,74236,147001,0.17865732151446437,Texas
5721,2012,Johnson,male,13000,286987,298515,585502,0.04529821908309436,Texas
5722,2012,Johnson,male,13000,11200,11643,22843,1.1607142857142858,Texas
5723,2012,Johnson,male,13000,27715,25974,53689,0.46906007577124303,Texas
5724,2012,Johnson,male,13000,3097,2100,5197,4.197610590894414,Texas
5725,2012,Johnson,male,13000,9682,8107,17789,1.3426977897128693,Texas
5726,2012,Johnson,male,13000,81568,81907,163475,0.159376225970969,Texas
5727,2012,Johnson,male,13000,4477,4038,8515,2.903730176457449,Texas
5740,2013,Johnson,male,12113,12976,13315,26291,0.9334926017262639,Texas
5741,2013,Johnson,male,12113,5318,4412,9730,2.27773599097405,Texas
5742,2013,Johnson,male,12113,7015,5587,12602,1.7267284390591588,Texas
5743,2013,Johnson,male,12113,74349,77215,151564,0.16292081937887531,Texas
5744,2013,Johnson,male,12113,72765,74236,147001,0.1664673950388236,Texas
5745,2013,Johnson,male,12113,286987,298515,585502,0.04220748675027092,Texas
5746,2013,Johnson,male,12113,11200,11643,22843,1.0815178571428572,Texas
5747,2013,Johnson,male,12113,27715,25974,53689,0.4370557459859282,Texas
5748,2013,Johnson,male,12113,3097,2100,5197,3.9112043913464642,Texas
5749,2013,Johnson,male,12113,9682,8107,17789,1.2510844866763065,Texas
5750,2013,Johnson,male,12113,81568,81907,163475,0.14850186347587288,Texas
5751,2013,Johnson,male,12113,4477,4038,8515,2.70560643287916,Texas
5764,2014,Johnson,male,5329,12976,13315,26291,0.41068125770653513,Texas
5765,2014,Johnson,male,5329,5318,4412,9730,1.0020684467845054,Texas
5766,2014,Johnson,male,5329,7015,5587,12602,0.7596578759800428,Texas
5767,2014,Johnson,male,5329,74349,77215,151564,0.071675476469085,Texas
5768,2014,Johnson,male,5329,72765,74236,147001,0.07323575895004467,Texas
5769,2014,Johnson,male,5329,286987,298515,585502,0.01856878534567768,Texas
5770,2014,Johnson,male,5329,11200,11643,22843,0.47580357142857144,Texas
5771,2014,Johnson,male,5329,27715,25974,53689,0.19227854952191953,Texas
5772,2014,Johnson,male,5329,3097,2100,5197,1.7206974491443332,Texas
5773,2014,Johnson,male,5329,9682,8107,17789,0.5504028093369139,Texas
5774,2014,Johnson,male,5329,81568,81907,163475,0.06533199293840722,Texas
5775,2014,Johnson,male,5329,4477,4038,8515,1.1903060084878267,Texas
5788,2015,Johnson,male,7993,12976,13315,26291,0.6159833538840938,Texas
5789,2015,Johnson,male,7993,5318,4412,9730,1.5030086498683715,Texas
5790,2015,Johnson,male,7993,7015,5587,12602,1.139415538132573,Texas
5791,2015,Johnson,male,7993,74349,77215,151564,0.1075064896636135,Texas
5792,2015,Johnson,male,7993,72765,74236,147001,0.10984676698962413,Texas
5793,2015,Johnson,male,7993,286987,298515,585502,0.027851435779321015,Texas
5794,2015,Johnson,male,7993,11200,11643,22843,0.7136607142857143,Texas
5795,2015,Johnson,male,7993,27715,25974,53689,0.28839978351073425,Texas
5796,2015,Johnson,male,7993,3097,2100,5197,2.5808847271553117,Texas
5797,2015,Johnson,male,7993,9682,8107,17789,0.8255525717826895,Texas
5798,2015,Johnson,male,7993,81568,81907,163475,0.09799185955276579,Texas
5799,2015,Johnson,male,7993,4477,4038,8515,1.7853473308018764,Texas
5812,2016,Johnson,male,7494,12976,13315,26291,0.5775277435265105,Texas
5813,2016,Johnson,male,7494,5318,4412,9730,1.4091763820985332,Texas
5814,2016,Johnson,male,7494,7015,5587,12602,1.0682822523164648,Texas
5815,2016,Johnson,male,7494,74349,77215,151564,0.10079489972965339,Texas
5816,2016,Johnson,male,7494,72765,74236,147001,0.10298907441764585,Texas
5817,2016,Johnson,male,7494,286987,298515,585502,0.026112681062208393,Texas
5818,2016,Johnson,male,7494,11200,11643,22843,0.6691071428571429,Texas
5819,2016,Johnson,male,7494,27715,25974,53689,0.27039509290997654,Texas
5820,2016,Johnson,male,7494,3097,2100,5197,2.4197610590894416,Texas
5821,2016,Johnson,male,7494,9682,8107,17789,0.7740136335467879,Texas
5822,2016,Johnson,male,7494,81568,81907,163475,0.0918742644174186,Texas
5823,2016,Johnson,male,7494,4477,4038,8515,1.6738887647978558,Texas
5830,2009,Jones,male,1827,13874,14674,28548,0.13168516649848638,Texas
5831,2009,Jones,male,1827,10585,9983,20568,0.1726027397260274,Texas
5832,2009,Jones,male,1827,33352,35102,68454,0.05477932357879588,Texas
5833,2009,Jones,male,1827,4828,4867,9695,0.3784175642087821,Texas
5834,2009,Jones,male,1827,364,371,735,5.019230769230769,Texas
5835,2009,Jones,male,1827,12507,7384,19891,0.14607819621012233,Texas
5842,2010,Jones,male,2032,13874,14674,28548,0.14646100619864494,Texas
5843,2010,Jones,male,2032,10585,9983,20568,0.19196976854038733,Texas
5844,2010,Jones,male,2032,33352,35102,68454,0.06092588150635644,Texas
5845,2010,Jones,male,2032,4828,4867,9695,0.4208782104391052,Texas
5846,2010,Jones,male,2032,364,371,735,5.582417582417582,Texas
5847,2010,Jones,male,2032,12507,7384,19891,0.16246901735028385,Texas
5854,2011,Jones,male,2333,13874,14674,28548,0.16815626351448754,Texas
5855,2011,Jones,male,2333,10585,9983,20568,0.2204062352385451,Texas
5856,2011,Jones,male,2333,33352,35102,68454,0.06995082753657951,Texas
5857,2011,Jones,male,2333,4828,4867,9695,0.4832228666114333,Texas
5858,2011,Jones,male,2333,364,371,735,6.40934065934066,Texas
5859,2011,Jones,male,2333,12507,7384,19891,0.1865355400975454,Texas
5866,2012,Jones,male,3604,13874,14674,28548,0.2597664696554707,Texas
5867,2012,Jones,male,3604,10585,9983,20568,0.34048181388757676,Texas
5868,2012,Jones,male,3604,33352,35102,68454,0.10805948668745502,Texas
5869,2012,Jones,male,3604,4828,4867,9695,0.7464788732394366,Texas
5870,2012,Jones,male,3604,364,371,735,9.901098901098901,Texas
5871,2012,Jones,male,3604,12507,7384,19891,0.2881586311665467,Texas
5878,2013,Jones,male,2458,13874,14674,28548,0.17716592186824276,Texas
5879,2013,Jones,male,2458,10585,9983,20568,0.2322153991497402,Texas
5880,2013,Jones,male,2458,33352,35102,68454,0.07369872871192132,Texas
5881,2013,Jones,male,2458,4828,4867,9695,0.5091135045567523,Texas
5882,2013,Jones,male,2458,364,371,735,6.752747252747253,Texas
5883,2013,Jones,male,2458,12507,7384,19891,0.1965299432317902,Texas
5890,2014,Jones,male,1706,13874,14674,28548,0.12296381721205132,Texas
5891,2014,Jones,male,1706,10585,9983,20568,0.16117146905999055,Texas
5892,2014,Jones,male,1706,33352,35102,68454,0.051151355241065004,Texas
5893,2014,Jones,male,1706,4828,4867,9695,0.35335542667771336,Texas
5894,2014,Jones,male,1706,364,371,735,4.686813186813187,Texas
5895,2014,Jones,male,1706,12507,7384,19891,0.13640361397617334,Texas
5902,2015,Jones,male,1617,13874,14674,28548,0.1165489404641776,Texas
5903,2015,Jones,male,1617,10585,9983,20568,0.15276334435521965,Texas
5904,2015,Jones,male,1617,33352,35102,68454,0.04848284960422163,Texas
5905,2015,Jones,male,1617,4828,4867,9695,0.3349212924606462,Texas
5906,2015,Jones,male,1617,364,371,735,4.4423076923076925,Texas
5907,2015,Jones,male,1617,12507,7384,19891,0.12928759894459102,Texas
5914,2016,Jones,male,1979,13874,14674,28548,0.14264091105665272,Texas
5915,2016,Jones,male,1979,10585,9983,20568,0.1869626830420406,Texas
5916,2016,Jones,male,1979,33352,35102,68454,0.05933677140801152,Texas
5917,2016,Jones,male,1979,4828,4867,9695,0.40990057995029,Texas
5918,2016,Jones,male,1979,364,371,735,5.436813186813187,Texas
5919,2016,Jones,male,1979,12507,7384,19891,0.15823139042136403,Texas
5921,2009,Karnes,male,3009,9133,6254,15387,0.32946457899923354,Texas
5923,2010,Karnes,male,3168,9133,6254,15387,0.34687397350268256,Texas
5925,2011,Karnes,male,4580,9133,6254,15387,0.5014781561370852,Texas
5927,2012,Karnes,male,4398,9133,6254,15387,0.4815504215482317,Texas
5929,2013,Karnes,male,4246,9133,6254,15387,0.4649074783751232,Texas
5931,2014,Karnes,male,3963,9133,6254,15387,0.43392094601992776,Texas
5933,2015,Karnes,male,3247,9133,6254,15387,0.35552392423081136,Texas
5935,2016,Karnes,male,2549,9133,6254,15387,0.279097777291142,Texas
5937,2009,Kaufman,male,11849,58360,60550,118910,0.20303289924605894,Texas
5939,2010,Kaufman,male,13646,58360,60550,118910,0.2338245373543523,Texas
5941,2011,Kaufman,male,15343,58360,60550,118910,0.26290267306374226,Texas
5943,2012,Kaufman,male,13309,58360,60550,118910,0.22805003427004797,Texas
5945,2013,Kaufman,male,10816,58360,60550,118910,0.18533241946538725,Texas
5947,2014,Kaufman,male,7224,58360,60550,118910,0.12378341329677861,Texas
5949,2015,Kaufman,male,5095,58360,60550,118910,0.08730294722412611,Texas
5951,2016,Kaufman,male,8335,58360,60550,118910,0.14282042494859493,Texas
5954,2009,Kendall,male,2640,61761,62865,124626,0.04274542186816923,Texas
5955,2009,Kendall,male,2640,20415,21567,41982,0.1293166789125643,Texas
5958,2010,Kendall,male,3150,61761,62865,124626,0.05100306018361102,Texas
5959,2010,Kendall,male,3150,20415,21567,41982,0.15429831006612785,Texas
5962,2011,Kendall,male,3235,61761,62865,124626,0.05237933323618465,Texas
5963,2011,Kendall,male,3235,20415,21567,41982,0.15846191525838843,Texas
5966,2012,Kendall,male,3020,61761,62865,124626,0.04889817198555723,Texas
5967,2012,Kendall,male,3020,20415,21567,41982,0.147930443301494,Texas
5970,2013,Kendall,male,2048,61761,62865,124626,0.033160084843185826,Texas
5971,2013,Kendall,male,2048,20415,21567,41982,0.1003183933382317,Texas
5974,2014,Kendall,male,2154,61761,62865,124626,0.034876378296983535,Texas
5975,2014,Kendall,male,2154,20415,21567,41982,0.10551065393093313,Texas
5978,2015,Kendall,male,1437,61761,62865,124626,0.023267110312333025,Texas
5979,2015,Kendall,male,1437,20415,21567,41982,0.0703894195444526,Texas
5982,2016,Kendall,male,1745,61761,62865,124626,0.02825407619695277,Texas
5983,2016,Kendall,male,1745,20415,21567,41982,0.0854763654175851,Texas
5985,2009,Kenedy,male,2352,286,309,595,8.223776223776223,Texas
5987,2010,Kenedy,male,1582,286,309,595,5.531468531468532,Texas
5989,2011,Kenedy,male,670,286,309,595,2.3426573426573425,Texas
5991,2012,Kenedy,male,801,286,309,595,2.800699300699301,Texas
5993,2013,Kenedy,male,766,286,309,595,2.6783216783216783,Texas
5995,2014,Kenedy,male,527,286,309,595,1.8426573426573427,Texas
5997,2015,Kenedy,male,511,286,309,595,1.7867132867132867,Texas
5999,2016,Kenedy,male,746,286,309,595,2.6083916083916083,Texas
6005,2009,Kent,male,184,84271,90551,174822,0.0021834320228785705,Texas
6006,2009,Kent,male,184,9344,10249,19593,0.019691780821917807,Texas
6007,2009,Kent,male,184,316734,326406,643140,0.0005809291077055194,Texas
6008,2009,Kent,male,184,79219,84642,163861,0.002322675115818175,Texas
6009,2009,Kent,male,184,327,422,749,0.5626911314984709,Texas
6015,2010,Kent,male,141,84271,90551,174822,0.0016731734523145567,Texas
6016,2010,Kent,male,141,9344,10249,19593,0.015089897260273972,Texas
6017,2010,Kent,male,141,316734,326406,643140,0.00044516850101346874,Texas
6018,2010,Kent,male,141,79219,84642,163861,0.0017798760398389276,Texas
6019,2010,Kent,male,141,327,422,749,0.43119266055045874,Texas
6025,2011,Kent,male,159,84271,90551,174822,0.0018867700632483298,Texas
6026,2011,Kent,male,159,9344,10249,19593,0.01701626712328767,Texas
6027,2011,Kent,male,159,316734,326406,643140,0.0005019985224194435,Texas
6028,2011,Kent,male,159,79219,84642,163861,0.0020070942576907056,Texas
6029,2011,Kent,male,159,327,422,749,0.48623853211009177,Texas
6035,2012,Kent,male,320,84271,90551,174822,0.003797273083267079,Texas
6036,2012,Kent,male,320,9344,10249,19593,0.03424657534246575,Texas
6037,2012,Kent,male,320,316734,326406,643140,0.001010311491661773,Texas
6038,2012,Kent,male,320,79219,84642,163861,0.0040394349840316085,Texas
6039,2012,Kent,male,320,327,422,749,0.9785932721712538,Texas
6045,2013,Kent,male,119,84271,90551,174822,0.001412110927839945,Texas
6046,2013,Kent,male,119,9344,10249,19593,0.012735445205479453,Texas
6047,2013,Kent,male,119,316734,326406,643140,0.0003757095859617218,Texas
6048,2013,Kent,male,119,79219,84642,163861,0.0015021648846867545,Texas
6049,2013,Kent,male,119,327,422,749,0.363914373088685,Texas
6055,2014,Kent,male,62,84271,90551,174822,0.0007357216598829965,Texas
6056,2014,Kent,male,62,9344,10249,19593,0.006635273972602739,Texas
6057,2014,Kent,male,62,316734,326406,643140,0.0001957478515094685,Texas
6058,2014,Kent,male,62,79219,84642,163861,0.0007826405281561241,Texas
6059,2014,Kent,male,62,327,422,749,0.18960244648318042,Texas
6065,2015,Kent,male,19,84271,90551,174822,0.0002254630893189828,Texas
6066,2015,Kent,male,19,9344,10249,19593,0.002033390410958904,Texas
6067,2015,Kent,male,19,316734,326406,643140,5.998724481741777e-05,Texas
6068,2015,Kent,male,19,79219,84642,163861,0.00023984145217687675,Texas
6069,2015,Kent,male,19,327,422,749,0.0581039755351682,Texas
6075,2016,Kent,male,54,84271,90551,174822,0.0006407898328013196,Texas
6076,2016,Kent,male,54,9344,10249,19593,0.005779109589041096,Texas
6077,2016,Kent,male,54,316734,326406,643140,0.0001704900642179242,Texas
6078,2016,Kent,male,54,79219,84642,163861,0.0006816546535553339,Texas
6079,2016,Kent,male,54,327,422,749,0.1651376146788991,Texas
6081,2009,Kerr,male,4443,24886,26479,51365,0.17853411556698545,Texas
6083,2010,Kerr,male,6536,24886,26479,51365,0.2626376275817729,Texas
6085,2011,Kerr,male,6615,24886,26479,51365,0.2658121031905489,Texas
6087,2012,Kerr,male,5637,24886,26479,51365,0.22651289881861286,Texas
6089,2013,Kerr,male,4523,24886,26479,51365,0.1817487744113156,Texas
6091,2014,Kerr,male,3336,24886,26479,51365,0.13405127380856707,Texas
6093,2015,Kerr,male,3563,24886,26479,51365,0.14317286827935385,Texas
6095,2016,Kerr,male,2774,24886,26479,51365,0.1114682954271478,Texas
6097,2009,Kimble,male,2821,2154,2254,4408,1.3096564531104922,Texas
6099,2010,Kimble,male,699,2154,2254,4408,0.3245125348189415,Texas
6101,2011,Kimble,male,2945,2154,2254,4408,1.3672237697307335,Texas
6103,2012,Kimble,male,2636,2154,2254,4408,1.2237697307335191,Texas
6105,2013,Kimble,male,1726,2154,2254,4408,0.8012999071494893,Texas
6107,2014,Kimble,male,2427,2154,2254,4408,1.126740947075209,Texas
6109,2015,Kimble,male,3167,2154,2254,4408,1.4702878365831011,Texas
6111,2016,Kimble,male,5302,2154,2254,4408,2.4614670380687094,Texas
6114,2009,King,male,493,118,110,228,4.177966101694915,Texas
6115,2009,King,male,493,1082940,1080317,2163257,0.0004552422110181543,Texas
6118,2010,King,male,386,118,110,228,3.2711864406779663,Texas
6119,2010,King,male,386,1082940,1080317,2163257,0.0003564371063955528,Texas
6122,2011,King,male,321,118,110,228,2.7203389830508473,Texas
6123,2011,King,male,321,1082940,1080317,2163257,0.0002964153138678043,Texas
6126,2012,King,male,723,118,110,228,6.127118644067797,Texas
6127,2012,King,male,723,1082940,1080317,2163257,0.0006676270153471107,Texas
6130,2013,King,male,266,118,110,228,2.2542372881355934,Texas
6131,2013,King,male,266,1082940,1080317,2163257,0.0002456276432674017,Texas
6134,2014,King,male,346,118,110,228,2.9322033898305087,Texas
6135,2014,King,male,346,1082940,1080317,2163257,0.00031950061868616915,Texas
6138,2015,King,male,188,118,110,228,1.5932203389830508,Texas
6139,2015,King,male,188,1082940,1080317,2163257,0.00017360149223410345,Texas
6142,2016,King,male,166,118,110,228,1.4067796610169492,Texas
6143,2016,King,male,166,1082940,1080317,2163257,0.00015328642399394242,Texas
6145,2009,Kinney,male,2791,2290,1385,3675,1.2187772925764193,Texas
6147,2010,Kinney,male,2393,2290,1385,3675,1.0449781659388646,Texas
6149,2011,Kinney,male,2108,2290,1385,3675,0.9205240174672489,Texas
6151,2012,Kinney,male,2205,2290,1385,3675,0.962882096069869,Texas
6153,2013,Kinney,male,2399,2290,1385,3675,1.0475982532751091,Texas
6155,2014,Kinney,male,2663,2290,1385,3675,1.162882096069869,Texas
6157,2015,Kinney,male,4435,2290,1385,3675,1.9366812227074235,Texas
6159,2016,Kinney,male,2971,2290,1385,3675,1.2973799126637555,Texas
6161,2009,Kleberg,male,6264,16052,15373,31425,0.3902317468228258,Texas
6163,2010,Kleberg,male,7664,16052,15373,31425,0.47744829304759534,Texas
6165,2011,Kleberg,male,8025,16052,15373,31425,0.4999377024669823,Texas
6167,2012,Kleberg,male,8018,16052,15373,31425,0.49950161973585844,Texas
6169,2013,Kleberg,male,5729,16052,15373,31425,0.35690256665836034,Texas
6171,2014,Kleberg,male,3819,16052,15373,31425,0.23791427859456765,Texas
6173,2015,Kleberg,male,4833,16052,15373,31425,0.30108397707450785,Texas
6175,2016,Kleberg,male,6002,16052,15373,31425,0.37390979317219036,Texas
6185,2009,Knox,male,1739,25743,25256,50999,0.06755234432661306,Texas
6186,2009,Knox,male,1739,18949,18460,37409,0.09177265291044383,Texas
6187,2009,Knox,male,1739,15330,16137,31467,0.11343770384866275,Texas
6188,2009,Knox,male,1739,19701,20122,39823,0.08826963098319882,Texas
6189,2009,Knox,male,1739,1989,1962,3951,0.8743086978381096,Texas
6190,2009,Knox,male,1739,4150,4310,8460,0.41903614457831323,Texas
6191,2009,Knox,male,1739,29959,31256,61215,0.05804599619479956,Texas
6192,2009,Knox,male,1739,221667,234518,456185,0.00784510098481055,Texas
6193,2009,Knox,male,1739,1853,1880,3733,0.9384781435509983,Texas
6203,2010,Knox,male,2110,25743,25256,50999,0.08196402905644253,Texas
6204,2010,Knox,male,2110,18949,18460,37409,0.11135152250778405,Texas
6205,2010,Knox,male,2110,15330,16137,31467,0.13763861709067188,Texas
6206,2010,Knox,male,2110,19701,20122,39823,0.10710116237754429,Texas
6207,2010,Knox,male,2110,1989,1962,3951,1.060834590246355,Texas
6208,2010,Knox,male,2110,4150,4310,8460,0.5084337349397591,Texas
6209,2010,Knox,male,2110,29959,31256,61215,0.07042958710237324,Texas
6210,2010,Knox,male,2110,221667,234518,456185,0.009518782678522289,Texas
6211,2010,Knox,male,2110,1853,1880,3733,1.1386940097139773,Texas
6221,2011,Knox,male,1781,25743,25256,50999,0.06918385580546167,Texas
6222,2011,Knox,male,1781,18949,18460,37409,0.0939891287139163,Texas
6223,2011,Knox,male,1781,15330,16137,31467,0.11617742987606001,Texas
6224,2011,Knox,male,1781,19701,20122,39823,0.09040150246180396,Texas
6225,2011,Knox,male,1781,1989,1962,3951,0.8954248366013072,Texas
6226,2011,Knox,male,1781,4150,4310,8460,0.4291566265060241,Texas
6227,2011,Knox,male,1781,29959,31256,61215,0.059447912146600355,Texas
6228,2011,Knox,male,1781,221667,234518,456185,0.00803457438409867,Texas
6229,2011,Knox,male,1781,1853,1880,3733,0.9611440906637885,Texas
6239,2012,Knox,male,772,25743,25256,50999,0.029988734801693666,Texas
6240,2012,Knox,male,772,18949,18460,37409,0.0407409361971608,Texas
6241,2012,Knox,male,772,15330,16137,31467,0.05035877364644488,Texas
6242,2012,Knox,male,772,19701,20122,39823,0.03918582813055175,Texas
6243,2012,Knox,male,772,1989,1962,3951,0.38813474107591756,Texas
6244,2012,Knox,male,772,4150,4310,8460,0.18602409638554218,Texas
6245,2012,Knox,male,772,29959,31256,61215,0.025768550352147937,Texas
6246,2012,Knox,male,772,221667,234518,456185,0.003482701529772136,Texas
6247,2012,Knox,male,772,1853,1880,3733,0.41662169454937936,Texas
6257,2013,Knox,male,1170,25743,25256,50999,0.04544924833935439,Texas
6258,2013,Knox,male,1170,18949,18460,37409,0.06174468309673334,Texas
6259,2013,Knox,male,1170,15330,16137,31467,0.07632093933463796,Texas
6260,2013,Knox,male,1170,19701,20122,39823,0.05938784833257195,Texas
6261,2013,Knox,male,1170,1989,1962,3951,0.5882352941176471,Texas
6262,2013,Knox,male,1170,4150,4310,8460,0.2819277108433735,Texas
6263,2013,Knox,male,1170,29959,31256,61215,0.03905337294302213,Texas
6264,2013,Knox,male,1170,221667,234518,456185,0.005278187551597667,Texas
6265,2013,Knox,male,1170,1853,1880,3733,0.6314085267134377,Texas
6275,2014,Knox,male,881,25743,25256,50999,0.034222895544419846,Texas
6276,2014,Knox,male,881,18949,18460,37409,0.04649321863950604,Texas
6277,2014,Knox,male,881,15330,16137,31467,0.05746901500326158,Texas
6278,2014,Knox,male,881,19701,20122,39823,0.04471854220597939,Texas
6279,2014,Knox,male,881,1989,1962,3951,0.44293614881850174,Texas
6280,2014,Knox,male,881,4150,4310,8460,0.21228915662650602,Texas
6281,2014,Knox,male,881,29959,31256,61215,0.029406856036583332,Texas
6282,2014,Knox,male,881,221667,234518,456185,0.0039744301136389265,Texas
6283,2014,Knox,male,881,1853,1880,3733,0.4754452239611441,Texas
6293,2015,Knox,male,278,25743,25256,50999,0.010799052169521811,Texas
6294,2015,Knox,male,278,18949,18460,37409,0.014670958889651168,Texas
6295,2015,Knox,male,278,15330,16137,31467,0.018134377038486627,Texas
6296,2015,Knox,male,278,19701,20122,39823,0.014110958834576925,Texas
6297,2015,Knox,male,278,1989,1962,3951,0.13976872800402212,Texas
6298,2015,Knox,male,278,4150,4310,8460,0.06698795180722891,Texas
6299,2015,Knox,male,278,29959,31256,61215,0.009279348442871925,Texas
6300,2015,Knox,male,278,221667,234518,456185,0.0012541334524308987,Texas
6301,2015,Knox,male,278,1853,1880,3733,0.15002698327037237,Texas
6311,2016,Knox,male,698,25743,25256,50999,0.027114166958008,Texas
6312,2016,Knox,male,698,18949,18460,37409,0.036835716924375955,Texas
6313,2016,Knox,male,698,15330,16137,31467,0.04553163731245923,Texas
6314,2016,Knox,male,698,19701,20122,39823,0.0354296736206284,Texas
6315,2016,Knox,male,698,1989,1962,3951,0.35093011563599796,Texas
6316,2016,Knox,male,698,4150,4310,8460,0.16819277108433736,Texas
6317,2016,Knox,male,698,29959,31256,61215,0.02329850796087987,Texas
6318,2016,Knox,male,698,221667,234518,456185,0.0031488674453121123,Texas
6319,2016,Knox,male,698,1853,1880,3733,0.3766864543982731,Texas
6321,2009,La Salle,male,8196,4408,3001,7409,1.8593466424682397,Texas
6323,2010,La Salle,male,11371,4408,3001,7409,2.579627949183303,Texas
6325,2011,La Salle,male,8279,4408,3001,7409,1.8781760435571688,Texas
6327,2012,La Salle,male,6750,4408,3001,7409,1.531306715063521,Texas
6329,2013,La Salle,male,5546,4408,3001,7409,1.2581669691470054,Texas
6331,2014,La Salle,male,4581,4408,3001,7409,1.0392468239564427,Texas
6333,2015,La Salle,male,5822,4408,3001,7409,1.3207803992740472,Texas
6335,2016,La Salle,male,7141,4408,3001,7409,1.6200090744101634,Texas
6340,2009,Lamar,male,3906,6800,7133,13933,0.5744117647058824,Texas
6341,2009,Lamar,male,3906,8959,9554,18513,0.4359861591695502,Texas
6342,2009,Lamar,male,3906,29243,31980,61223,0.13357042711076156,Texas
6343,2009,Lamar,male,3906,23917,25615,49532,0.1633147970063135,Texas
6348,2010,Lamar,male,3108,6800,7133,13933,0.45705882352941174,Texas
6349,2010,Lamar,male,3108,8959,9554,18513,0.3469137180488894,Texas
6350,2010,Lamar,male,3108,29243,31980,61223,0.1062818452279178,Texas
6351,2010,Lamar,male,3108,23917,25615,49532,0.12994940837061505,Texas
6356,2011,Lamar,male,4652,6800,7133,13933,0.6841176470588235,Texas
6357,2011,Lamar,male,4652,8959,9554,18513,0.5192543810693158,Texas
6358,2011,Lamar,male,4652,29243,31980,61223,0.15908080566289368,Texas
6359,2011,Lamar,male,4652,23917,25615,49532,0.19450599991637746,Texas
6364,2012,Lamar,male,4948,6800,7133,13933,0.7276470588235294,Texas
6365,2012,Lamar,male,4948,8959,9554,18513,0.5522937827882576,Texas
6366,2012,Lamar,male,4948,29243,31980,61223,0.16920288616079063,Texas
6367,2012,Lamar,male,4948,23917,25615,49532,0.20688213404691225,Texas
6372,2013,Lamar,male,6255,6800,7133,13933,0.9198529411764705,Texas
6373,2013,Lamar,male,6255,8959,9554,18513,0.6981806005134502,Texas
6374,2013,Lamar,male,6255,29243,31980,61223,0.2138973429538693,Texas
6375,2013,Lamar,male,6255,23917,25615,49532,0.26152945603545596,Texas
6380,2014,Lamar,male,4570,6800,7133,13933,0.6720588235294118,Texas
6381,2014,Lamar,male,4570,8959,9554,18513,0.5101015738363657,Texas
6382,2014,Lamar,male,4570,29243,31980,61223,0.15627671579523306,Texas
6383,2014,Lamar,male,4570,23917,25615,49532,0.1910774762721077,Texas
6388,2015,Lamar,male,3631,6800,7133,13933,0.5339705882352941,Texas
6389,2015,Lamar,male,3631,8959,9554,18513,0.40529076905904676,Texas
6390,2015,Lamar,male,3631,29243,31980,61223,0.12416646718872892,Texas
6391,2015,Lamar,male,3631,23917,25615,49532,0.15181669941882342,Texas
6396,2016,Lamar,male,3477,6800,7133,13933,0.5113235294117647,Texas
6397,2016,Lamar,male,3477,8959,9554,18513,0.3881013505971649,Texas
6398,2016,Lamar,male,3477,29243,31980,61223,0.11890024963239065,Texas
6399,2016,Lamar,male,3477,23917,25615,49532,0.145377764769829,Texas
6401,2009,Lamb,male,3713,6710,6552,13262,0.5533532041728763,Texas
6403,2010,Lamb,male,4920,6710,6552,13262,0.7332339791356185,Texas
6405,2011,Lamb,male,4331,6710,6552,13262,0.6454545454545455,Texas
6407,2012,Lamb,male,4405,6710,6552,13262,0.6564828614008942,Texas
6409,2013,Lamb,male,3245,6710,6552,13262,0.48360655737704916,Texas
6411,2014,Lamb,male,2406,6710,6552,13262,0.3585692995529061,Texas
6413,2015,Lamb,male,2545,6710,6552,13262,0.37928464977645304,Texas
6415,2016,Lamb,male,2150,6710,6552,13262,0.3204172876304024,Texas
6417,2009,Lampasas,male,3951,10187,10453,20640,0.387847256307058,Texas
6419,2010,Lampasas,male,4311,10187,10453,20640,0.42318641405713164,Texas
6421,2011,Lampasas,male,4710,10187,10453,20640,0.4623539805634632,Texas
6423,2012,Lampasas,male,4239,10187,10453,20640,0.4161185825071169,Texas
6425,2013,Lampasas,male,3728,10187,10453,20640,0.3659566113674291,Texas
6427,2014,Lampasas,male,2459,10187,10453,20640,0.24138608029841954,Texas
6429,2015,Lampasas,male,2512,10187,10453,20640,0.24658878963384706,Texas
6431,2016,Lampasas,male,2248,10187,10453,20640,0.22067340728379306,Texas
6433,2009,Lavaca,male,4182,9684,10257,19941,0.4318463444857497,Texas
6435,2010,Lavaca,male,2823,9684,10257,19941,0.29151177199504336,Texas
6437,2011,Lavaca,male,2741,9684,10257,19941,0.28304419661296987,Texas
6439,2012,Lavaca,male,2760,9684,10257,19941,0.2850061957868649,Texas
6441,2013,Lavaca,male,2102,9684,10257,19941,0.21705906650144569,Texas
6443,2014,Lavaca,male,1890,9684,10257,19941,0.19516728624535315,Texas
6445,2015,Lavaca,male,1146,9684,10257,19941,0.11833952912019827,Texas
6447,2016,Lavaca,male,906,9684,10257,19941,0.09355638166047088,Texas
6460,2009,Lee,male,3422,78372,80915,159287,0.04366355330985556,Texas
6461,2009,Lee,male,3422,5309,4089,9398,0.6445658316067056,Texas
6462,2009,Lee,male,3422,351918,366761,718679,0.009723856125574708,Texas
6463,2009,Lee,male,3422,14674,14674,29348,0.233201581027668,Texas
6464,2009,Lee,male,3422,18326,16201,34527,0.1867292371494052,Texas
6465,2009,Lee,male,3422,17371,17170,34541,0.19699499165275458,Texas
6466,2009,Lee,male,3422,3501,3250,6751,0.9774350185661239,Texas
6467,2009,Lee,male,3422,40526,44389,84915,0.08443961901001826,Texas
6468,2009,Lee,male,3422,29225,30900,60125,0.11709153122326775,Texas
6469,2009,Lee,male,3422,9164,8442,17606,0.37341772151898733,Texas
6470,2009,Lee,male,3422,8558,8394,16952,0.39985978032250524,Texas
6471,2009,Lee,male,3422,12608,11526,24134,0.2714149746192893,Texas
6484,2010,Lee,male,4085,78372,80915,159287,0.0521232072679018,Texas
6485,2010,Lee,male,4085,5309,4089,9398,0.7694481069881334,Texas
6486,2010,Lee,male,4085,351918,366761,718679,0.01160781773026671,Texas
6487,2010,Lee,male,4085,14674,14674,29348,0.2783835355049748,Texas
6488,2010,Lee,male,4085,18326,16201,34527,0.22290734475608426,Texas
6489,2010,Lee,male,4085,17371,17170,34541,0.2351620516953543,Texas
6490,2010,Lee,male,4085,3501,3250,6751,1.1668094830048557,Texas
6491,2010,Lee,male,4085,40526,44389,84915,0.1007994867492474,Texas
6492,2010,Lee,male,4085,29225,30900,60125,0.1397775876817793,Texas
6493,2010,Lee,male,4085,9164,8442,17606,0.44576604103011785,Texas
6494,2010,Lee,male,4085,8558,8394,16952,0.4773311521383501,Texas
6495,2010,Lee,male,4085,12608,11526,24134,0.3240006345177665,Texas
6508,2011,Lee,male,3447,78372,80915,159287,0.04398254478640331,Texas
6509,2011,Lee,male,3447,5309,4089,9398,0.649274816349595,Texas
6510,2011,Lee,male,3447,351918,366761,718679,0.00979489540176973,Texas
6511,2011,Lee,male,3447,14674,14674,29348,0.23490527463540956,Texas
6512,2011,Lee,male,3447,18326,16201,34527,0.18809341918585615,Texas
6513,2011,Lee,male,3447,17371,17170,34541,0.1984341718956882,Texas
6514,2011,Lee,male,3447,3501,3250,6751,0.9845758354755784,Texas
6515,2011,Lee,male,3447,40526,44389,84915,0.08505650693382026,Texas
6516,2011,Lee,male,3447,29225,30900,60125,0.1179469632164243,Texas
6517,2011,Lee,male,3447,9164,8442,17606,0.3761457878655609,Texas
6518,2011,Lee,male,3447,8558,8394,16952,0.4027810236036457,Texas
6519,2011,Lee,male,3447,12608,11526,24134,0.27339784263959394,Texas
6532,2012,Lee,male,3569,78372,80915,159287,0.04553922319195631,Texas
6533,2012,Lee,male,3569,5309,4089,9398,0.6722546618948955,Texas
6534,2012,Lee,male,3569,351918,366761,718679,0.010141567069601442,Texas
6535,2012,Lee,male,3569,14674,14674,29348,0.2432192994411885,Texas
6536,2012,Lee,male,3569,18326,16201,34527,0.19475062752373676,Texas
6537,2012,Lee,male,3569,17371,17170,34541,0.2054573714812043,Texas
6538,2012,Lee,male,3569,3501,3250,6751,1.0194230219937161,Texas
6539,2012,Lee,male,3569,40526,44389,84915,0.08806692000197404,Texas
6540,2012,Lee,male,3569,29225,30900,60125,0.12212147134302823,Texas
6541,2012,Lee,male,3569,9164,8442,17606,0.3894587516368398,Texas
6542,2012,Lee,male,3569,8558,8394,16952,0.4170366908156111,Texas
6543,2012,Lee,male,3569,12608,11526,24134,0.2830742385786802,Texas
6556,2013,Lee,male,4028,78372,80915,159287,0.05139590670137294,Texas
6557,2013,Lee,male,4028,5309,4089,9398,0.7587116217743455,Texas
6558,2013,Lee,male,4028,351918,366761,718679,0.011445848180542059,Texas
6559,2013,Lee,male,4028,14674,14674,29348,0.274499114079324,Texas
6560,2013,Lee,male,4028,18326,16201,34527,0.2197970097129761,Texas
6561,2013,Lee,male,4028,17371,17170,34541,0.23188072074146565,Texas
6562,2013,Lee,male,4028,3501,3250,6751,1.1505284204512995,Texas
6563,2013,Lee,male,4028,40526,44389,84915,0.09939298228297883,Texas
6564,2013,Lee,male,4028,29225,30900,60125,0.1378272027373824,Texas
6565,2013,Lee,male,4028,9164,8442,17606,0.43954604975993017,Texas
6566,2013,Lee,male,4028,8558,8394,16952,0.47067071745734984,Texas
6567,2013,Lee,male,4028,12608,11526,24134,0.3194796954314721,Texas
6580,2014,Lee,male,3448,78372,80915,159287,0.04399530444546522,Texas
6581,2014,Lee,male,3448,5309,4089,9398,0.6494631757393106,Texas
6582,2014,Lee,male,3448,351918,366761,718679,0.009797736972817531,Texas
6583,2014,Lee,male,3448,14674,14674,29348,0.23497342237971924,Texas
6584,2014,Lee,male,3448,18326,16201,34527,0.1881479864673142,Texas
6585,2014,Lee,male,3448,17371,17170,34541,0.19849173910540557,Texas
6586,2014,Lee,male,3448,3501,3250,6751,0.9848614681519566,Texas
6587,2014,Lee,male,3448,40526,44389,84915,0.08508118245077234,Texas
6588,2014,Lee,male,3448,29225,30900,60125,0.11798118049615056,Texas
6589,2014,Lee,male,3448,9164,8442,17606,0.37625491051942384,Texas
6590,2014,Lee,male,3448,8558,8394,16952,0.40289787333489135,Texas
6591,2014,Lee,male,3448,12608,11526,24134,0.27347715736040606,Texas
6604,2015,Lee,male,2204,78372,80915,159287,0.028122288572449344,Texas
6605,2015,Lee,male,2204,5309,4089,9398,0.4151440949331324,Texas
6606,2015,Lee,male,2204,351918,366761,718679,0.006262822589353202,Texas
6607,2015,Lee,male,2204,14674,14674,29348,0.15019762845849802,Texas
6608,2015,Lee,male,2204,18326,16201,34527,0.12026628833351523,Texas
6609,2015,Lee,male,2204,17371,17170,34541,0.12687813021702837,Texas
6610,2015,Lee,male,2204,3501,3250,6751,0.6295344187375036,Texas
6611,2015,Lee,male,2204,40526,44389,84915,0.05438483936238464,Texas
6612,2015,Lee,male,2204,29225,30900,60125,0.07541488451668092,Texas
6613,2015,Lee,male,2204,9164,8442,17606,0.24050632911392406,Texas
6614,2015,Lee,male,2204,8558,8394,16952,0.25753680766534237,Texas
6615,2015,Lee,male,2204,12608,11526,24134,0.17480964467005075,Texas
6628,2016,Lee,male,2089,78372,80915,159287,0.02665492778032971,Texas
6629,2016,Lee,male,2089,5309,4089,9398,0.393482765115841,Texas
6630,2016,Lee,male,2089,351918,366761,718679,0.0059360419188560975,Texas
6631,2016,Lee,male,2089,14674,14674,29348,0.14236063786288675,Texas
6632,2016,Lee,male,2089,18326,16201,34527,0.11399105096584088,Texas
6633,2016,Lee,male,2089,17371,17170,34541,0.1202579010995337,Texas
6634,2016,Lee,male,2089,3501,3250,6751,0.5966866609540131,Texas
6635,2016,Lee,male,2089,40526,44389,84915,0.051547154912895424,Texas
6636,2016,Lee,male,2089,29225,30900,60125,0.07147989734816082,Texas
6637,2016,Lee,male,2089,9164,8442,17606,0.22795722391968573,Texas
6638,2016,Lee,male,2089,8558,8394,16952,0.24409908857209628,Texas
6639,2016,Lee,male,2089,12608,11526,24134,0.16568845177664976,Texas
6642,2009,Leon,male,4780,136894,151208,288102,0.034917527429982324,Texas
6643,2009,Leon,male,4780,8602,8496,17098,0.5556847244826785,Texas
6646,2010,Leon,male,6562,136894,151208,288102,0.04793489853463263,Texas
6647,2010,Leon,male,6562,8602,8496,17098,0.7628458498023716,Texas
6650,2011,Leon,male,6779,136894,151208,288102,0.049520066620889154,Texas
6651,2011,Leon,male,6779,8602,8496,17098,0.7880725412694722,Texas
6654,2012,Leon,male,7503,136894,151208,288102,0.054808830189781874,Texas
6655,2012,Leon,male,7503,8602,8496,17098,0.8722390141827482,Texas
6658,2013,Leon,male,6368,136894,151208,288102,0.046517743655675195,Texas
6659,2013,Leon,male,6368,8602,8496,17098,0.7402929551267147,Texas
6662,2014,Leon,male,5729,136894,151208,288102,0.041849898461583414,Texas
6663,2014,Leon,male,5729,8602,8496,17098,0.66600790513834,Texas
6666,2015,Leon,male,4619,136894,151208,288102,0.033741434978888776,Texas
6667,2015,Leon,male,4619,8602,8496,17098,0.5369681469425714,Texas
6670,2016,Leon,male,4718,136894,151208,288102,0.03446462226248046,Texas
6671,2016,Leon,male,4718,8602,8496,17098,0.5484770983492211,Texas
6676,2009,Liberty,male,8110,5110,3255,8365,1.5870841487279843,Texas
6677,2009,Liberty,male,8110,31550,30558,62108,0.25705229793977813,Texas
6678,2009,Liberty,male,8110,1146,1134,2280,7.076788830715532,Texas
6679,2009,Liberty,male,8110,40439,41423,81862,0.2005489749993818,Texas
6684,2010,Liberty,male,11096,5110,3255,8365,2.1714285714285713,Texas
6685,2010,Liberty,male,11096,31550,30558,62108,0.3516957210776545,Texas
6686,2010,Liberty,male,11096,1146,1134,2280,9.68237347294939,Texas
6687,2010,Liberty,male,11096,40439,41423,81862,0.27438858527658944,Texas
6692,2011,Liberty,male,11316,5110,3255,8365,2.214481409001957,Texas
6693,2011,Liberty,male,11316,31550,30558,62108,0.3586687797147385,Texas
6694,2011,Liberty,male,11316,1146,1134,2280,9.87434554973822,Texas
6695,2011,Liberty,male,11316,40439,41423,81862,0.2798288780632558,Texas
6700,2012,Liberty,male,10841,5110,3255,8365,2.1215264187866927,Texas
6701,2012,Liberty,male,10841,31550,30558,62108,0.3436133122028526,Texas
6702,2012,Liberty,male,10841,1146,1134,2280,9.459860383944154,Texas
6703,2012,Liberty,male,10841,40439,41423,81862,0.26808279136477164,Texas
6708,2013,Liberty,male,8227,5110,3255,8365,1.6099804305283758,Texas
6709,2013,Liberty,male,8227,31550,30558,62108,0.2607606973058637,Texas
6710,2013,Liberty,male,8227,1146,1134,2280,7.178883071553229,Texas
6711,2013,Liberty,male,8227,40439,41423,81862,0.20344222161774525,Texas
6716,2014,Liberty,male,6958,5110,3255,8365,1.3616438356164384,Texas
6717,2014,Liberty,male,6958,31550,30558,62108,0.22053882725832014,Texas
6718,2014,Liberty,male,6958,1146,1134,2280,6.071553228621291,Texas
6719,2014,Liberty,male,6958,40439,41423,81862,0.1720616236801108,Texas
6724,2015,Liberty,male,6436,5110,3255,8365,1.259491193737769,Texas
6725,2015,Liberty,male,6436,31550,30558,62108,0.20399366085578446,Texas
6726,2015,Liberty,male,6436,1146,1134,2280,5.616055846422339,Texas
6727,2015,Liberty,male,6436,40439,41423,81862,0.15915329261356612,Texas
6732,2016,Liberty,male,5828,5110,3255,8365,1.1405088062622308,Texas
6733,2016,Liberty,male,5828,31550,30558,62108,0.18472266244057053,Texas
6734,2016,Liberty,male,5828,1146,1134,2280,5.0855148342059335,Texas
6735,2016,Liberty,male,5828,40439,41423,81862,0.14411830163950642,Texas
6738,2009,Limestone,male,5011,46427,46625,93052,0.1079328838822237,Texas
6739,2009,Limestone,male,5011,12056,11459,23515,0.4156436629064366,Texas
6742,2010,Limestone,male,5269,46427,46625,93052,0.11348999504598617,Texas
6743,2010,Limestone,male,5269,12056,11459,23515,0.43704379562043794,Texas
6746,2011,Limestone,male,4193,46427,46625,93052,0.09031382600641868,Texas
6747,2011,Limestone,male,4193,12056,11459,23515,0.3477936297279363,Texas
6750,2012,Limestone,male,2803,46427,46625,93052,0.06037435113188446,Texas
6751,2012,Limestone,male,2803,12056,11459,23515,0.2324983410749834,Texas
6754,2013,Limestone,male,2670,46427,46625,93052,0.057509638787774355,Texas
6755,2013,Limestone,male,2670,12056,11459,23515,0.2214664897146649,Texas
6758,2014,Limestone,male,2337,46427,46625,93052,0.050337088332220475,Texas
6759,2014,Limestone,male,2337,12056,11459,23515,0.19384538818845387,Texas
6762,2015,Limestone,male,2042,46427,46625,93052,0.04398302711784091,Texas
6763,2015,Limestone,male,2042,12056,11459,23515,0.16937624419376243,Texas
6766,2016,Limestone,male,1975,46427,46625,93052,0.042539901350507246,Texas
6767,2016,Limestone,male,1975,12056,11459,23515,0.16381884538818844,Texas
6769,2009,Lipscomb,male,194,1840,1629,3469,0.10543478260869565,Texas
6771,2010,Lipscomb,male,186,1840,1629,3469,0.10108695652173913,Texas
6773,2011,Lipscomb,male,203,1840,1629,3469,0.11032608695652174,Texas
6775,2012,Lipscomb,male,238,1840,1629,3469,0.12934782608695652,Texas
6777,2013,Lipscomb,male,235,1840,1629,3469,0.12771739130434784,Texas
6779,2014,Lipscomb,male,111,1840,1629,3469,0.06032608695652174,Texas
6781,2015,Lipscomb,male,99,1840,1629,3469,0.05380434782608696,Texas
6783,2016,Lipscomb,male,39,1840,1629,3469,0.021195652173913043,Texas
6785,2009,Live Oak,male,9739,6634,5489,12123,1.4680434127223394,Texas
6787,2010,Live Oak,male,8154,6634,5489,12123,1.2291227012360566,Texas
6789,2011,Live Oak,male,7562,6634,5489,12123,1.139885438649382,Texas
6791,2012,Live Oak,male,6137,6634,5489,12123,0.9250829062405789,Texas
6793,2013,Live Oak,male,5666,6634,5489,12123,0.8540850165812481,Texas
6795,2014,Live Oak,male,6850,6634,5489,12123,1.0325595417545976,Texas
6797,2015,Live Oak,male,4163,6634,5489,12123,0.6275248718721737,Texas
6799,2016,Live Oak,male,5152,6634,5489,12123,0.7766053662948448,Texas
6801,2009,Llano,male,3058,10138,10502,20640,0.30163740382718485,Texas
6803,2010,Llano,male,2864,10138,10502,20640,0.2825014795817716,Texas
6805,2011,Llano,male,1706,10138,10502,20640,0.16827776681791282,Texas
6807,2012,Llano,male,1863,10138,10502,20640,0.18376405602682974,Texas
6809,2013,Llano,male,2495,10138,10502,20640,0.2461037680015782,Texas
6811,2014,Llano,male,2334,10138,10502,20640,0.23022292365358057,Texas
6813,2015,Llano,male,3535,10138,10502,20640,0.34868810416255674,Texas
6815,2016,Llano,male,2609,10138,10502,20640,0.2573485894653778,Texas
6817,2009,Loving,male,10,58,44,102,0.1724137931034483,Texas
6818,2010,Loving,male,14,58,44,102,0.2413793103448276,Texas
6819,2011,Loving,male,7,58,44,102,0.1206896551724138,Texas
6821,2012,Loving,male,28,58,44,102,0.4827586206896552,Texas
6822,2013,Loving,male,15,58,44,102,0.25862068965517243,Texas
6824,2014,Loving,male,24,58,44,102,0.41379310344827586,Texas
6826,2015,Loving,male,6,58,44,102,0.10344827586206896,Texas
6828,2016,Loving,male,19,58,44,102,0.3275862068965517,Texas
6830,2009,Lubbock,male,10908,148631,152823,301454,0.07338980428039911,Texas
6832,2010,Lubbock,male,13105,148631,152823,301454,0.08817137743808492,Texas
6834,2011,Lubbock,male,13394,148631,152823,301454,0.09011579011108047,Texas
6836,2012,Lubbock,male,13228,148631,152823,301454,0.08899893023662628,Texas
6838,2013,Lubbock,male,7771,148631,152823,301454,0.05228384388182815,Texas
6840,2014,Lubbock,male,7900,148631,152823,301454,0.053151765109566644,Texas
6842,2015,Lubbock,male,7084,148631,152823,301454,0.04766165873875571,Texas
6844,2016,Lubbock,male,7925,148631,152823,301454,0.05331996689788806,Texas
6846,2009,Lynn,male,3090,2977,2831,5808,1.0379576755122606,Texas
6848,2010,Lynn,male,1698,2977,2831,5808,0.5703728585824656,Texas
6850,2011,Lynn,male,2470,2977,2831,5808,0.8296943231441049,Texas
6852,2012,Lynn,male,2353,2977,2831,5808,0.7903930131004366,Texas
6854,2013,Lynn,male,1904,2977,2831,5808,0.6395700369499496,Texas
6856,2014,Lynn,male,779,2977,2831,5808,0.26167282499160227,Texas
6858,2015,Lynn,male,897,2977,2831,5808,0.30131004366812225,Texas
6860,2016,Lynn,male,436,2977,2831,5808,0.14645616392341282,Texas
6881,2009,Madison,male,4324,174665,182895,357560,0.024755961411845533,Texas
6882,2009,Madison,male,4324,8038,8038,16076,0.5379447623787011,Texas
6883,2009,Madison,male,4324,9829,8645,18474,0.43992267779021266,Texas
6884,2009,Madison,male,4324,14508,14392,28900,0.2980424593327819,Texas
6885,2009,Madison,male,4324,19529,19176,38705,0.2214143069281581,Texas
6886,2009,Madison,male,4324,129718,135952,265670,0.03333384726869054,Texas
6887,2009,Madison,male,4324,64707,64798,129505,0.06682430030754015,Texas
6888,2009,Madison,male,4324,8028,7862,15890,0.5386148480318884,Texas
6889,2009,Madison,male,4324,43737,45963,89700,0.09886366234538263,Texas
6890,2009,Madison,male,4324,5708,5764,11472,0.7575332866152769,Texas
6891,2009,Madison,male,4324,49524,53974,103498,0.08731120264922058,Texas
6892,2009,Madison,male,4324,6049,6156,12205,0.714828897338403,Texas
6893,2009,Madison,male,4324,4261,3957,8218,1.014785261675663,Texas
6894,2009,Madison,male,4324,17490,17674,35164,0.24722698684962835,Texas
6895,2009,Madison,male,4324,35252,36107,71359,0.12265970725065245,Texas
6896,2009,Madison,male,4324,10502,10903,21405,0.4117310988383165,Texas
6897,2009,Madison,male,4324,24041,19947,43988,0.17985940684663698,Texas
6898,2009,Madison,male,4324,46137,51545,97682,0.09372087478596354,Texas
6899,2009,Madison,male,4324,8127,6001,14128,0.5320536483327181,Texas
6900,2009,Madison,male,4324,6350,6789,13139,0.6809448818897638,Texas
6921,2010,Madison,male,4124,174665,182895,357560,0.023610912317865627,Texas
6922,2010,Madison,male,4124,8038,8038,16076,0.5130629509828315,Texas
6923,2010,Madison,male,4124,9829,8645,18474,0.4195747278461695,Texas
6924,2010,Madison,male,4124,14508,14392,28900,0.28425696167631653,Texas
6925,2010,Madison,male,4124,19529,19176,38705,0.21117312714424702,Texas
6926,2010,Madison,male,4124,129718,135952,265670,0.03179204119705823,Texas
6927,2010,Madison,male,4124,64707,64798,129505,0.06373344460413866,Texas
6928,2010,Madison,male,4124,8028,7862,15890,0.513702042850025,Texas
6929,2010,Madison,male,4124,43737,45963,89700,0.09429087500285799,Texas
6930,2010,Madison,male,4124,5708,5764,11472,0.7224947442186405,Texas
6931,2010,Madison,male,4124,49524,53974,103498,0.08327275664324368,Texas
6932,2010,Madison,male,4124,6049,6156,12205,0.6817655810877831,Texas
6933,2010,Madison,male,4124,4261,3957,8218,0.9678479230227646,Texas
6934,2010,Madison,male,4124,17490,17674,35164,0.23579188107489996,Texas
6935,2010,Madison,male,4124,35252,36107,71359,0.11698627028253716,Texas
6936,2010,Madison,male,4124,10502,10903,21405,0.3926871072176728,Texas
6937,2010,Madison,male,4124,24041,19947,43988,0.1715402853458675,Texas
6938,2010,Madison,male,4124,46137,51545,97682,0.08938595920844442,Texas
6939,2010,Madison,male,4124,8127,6001,14128,0.5074443213978098,Texas
6940,2010,Madison,male,4124,6350,6789,13139,0.6494488188976378,Texas
6961,2011,Madison,male,5238,174665,182895,357560,0.029988835771333697,Texas
6962,2011,Madison,male,5238,8038,8038,16076,0.6516546404578253,Texas
6963,2011,Madison,male,5238,9829,8645,18474,0.5329128090344898,Texas
6964,2011,Madison,male,5238,14508,14392,28900,0.3610421836228288,Texas
6965,2011,Madison,male,5238,19529,19176,38705,0.2682164985406319,Texas
6966,2011,Madison,male,5238,129718,135952,265670,0.0403799010160502,Texas
6967,2011,Madison,male,5238,64707,64798,129505,0.08094951087208493,Texas
6968,2011,Madison,male,5238,8028,7862,15890,0.6524663677130045,Texas
6969,2011,Madison,male,5238,43737,45963,89700,0.11976130050072022,Texas
6970,2011,Madison,male,5238,5708,5764,11472,0.9176594253679047,Texas
6971,2011,Madison,male,5238,49524,53974,103498,0.10576690089653501,Texas
6972,2011,Madison,male,5238,6049,6156,12205,0.8659282526037362,Texas
6973,2011,Madison,male,5238,4261,3957,8218,1.2292888993194087,Texas
6974,2011,Madison,male,5238,17490,17674,35164,0.29948542024013725,Texas
6975,2011,Madison,male,5238,35252,36107,71359,0.14858731419493929,Texas
6976,2011,Madison,male,5238,10502,10903,21405,0.4987621405446582,Texas
6977,2011,Madison,male,5238,24041,19947,43988,0.2178777921051537,Texas
6978,2011,Madison,male,5238,46137,51545,97682,0.11353143897522595,Texas
6979,2011,Madison,male,5238,8127,6001,14128,0.6445182724252492,Texas
6980,2011,Madison,male,5238,6350,6789,13139,0.8248818897637795,Texas
7001,2012,Madison,male,4186,174665,182895,357560,0.0239658775369994,Texas
7002,2012,Madison,male,4186,8038,8038,16076,0.5207763125155511,Texas
7003,2012,Madison,male,4186,9829,8645,18474,0.42588259232882286,Texas
7004,2012,Madison,male,4186,14508,14392,28900,0.2885304659498208,Texas
7005,2012,Madison,male,4186,19529,19176,38705,0.21434789287725947,Texas
7006,2012,Madison,male,4186,129718,135952,265670,0.03227000107926425,Texas
7007,2012,Madison,male,4186,64707,64798,129505,0.06469160987219312,Texas
7008,2012,Madison,male,4186,8028,7862,15890,0.5214250124564026,Texas
7009,2012,Madison,male,4186,43737,45963,89700,0.09570843907904063,Texas
7010,2012,Madison,male,4186,5708,5764,11472,0.7333566923615977,Texas
7011,2012,Madison,male,4186,49524,53974,103498,0.08452467490509652,Texas
7012,2012,Madison,male,4186,6049,6156,12205,0.6920152091254753,Texas
7013,2012,Madison,male,4186,4261,3957,8218,0.9823984980051631,Texas
7014,2012,Madison,male,4186,17490,17674,35164,0.23933676386506575,Texas
7015,2012,Madison,male,4186,35252,36107,71359,0.1187450357426529,Texas
7016,2012,Madison,male,4186,10502,10903,21405,0.3985907446200724,Texas
7017,2012,Madison,male,4186,24041,19947,43988,0.17411921301110603,Texas
7018,2012,Madison,male,4186,46137,51545,97682,0.09072978303747535,Texas
7019,2012,Madison,male,4186,8127,6001,14128,0.5150732127476314,Texas
7020,2012,Madison,male,4186,6350,6789,13139,0.6592125984251969,Texas
7041,2013,Madison,male,2423,174665,182895,357560,0.013872269773566542,Texas
7042,2013,Madison,male,2423,8038,8038,16076,0.3014431450609604,Texas
7043,2013,Madison,male,2423,9829,8645,18474,0.24651541357208262,Texas
7044,2013,Madison,male,2423,14508,14392,28900,0.1670113041080783,Texas
7045,2013,Madison,male,2423,19529,19176,38705,0.12407189308208305,Texas
7046,2013,Madison,male,2423,129718,135952,265670,0.018678980557825436,Texas
7047,2013,Madison,male,2423,64707,64798,129505,0.03744571684670901,Texas
7048,2013,Madison,male,2423,8028,7862,15890,0.30181863477827603,Texas
7049,2013,Madison,male,2423,43737,45963,89700,0.05539931865468596,Texas
7050,2013,Madison,male,2423,5708,5764,11472,0.4244919411352488,Texas
7051,2013,Madison,male,2423,49524,53974,103498,0.04892577336241014,Texas
7052,2013,Madison,male,2423,6049,6156,12205,0.4005620763762605,Texas
7053,2013,Madison,male,2423,4261,3957,8218,0.5686458577798639,Texas
7054,2013,Madison,male,2423,17490,17674,35164,0.13853630646083476,Texas
7055,2013,Madison,male,2423,35252,36107,71359,0.06873368886871667,Texas
7056,2013,Madison,male,2423,10502,10903,21405,0.23071795848409826,Texas
7057,2013,Madison,male,2423,24041,19947,43988,0.10078615698182272,Texas
7058,2013,Madison,male,2423,46137,51545,97682,0.05251750222164423,Texas
7059,2013,Madison,male,2423,8127,6001,14128,0.29814199581641443,Texas
7060,2013,Madison,male,2423,6350,6789,13139,0.3815748031496063,Texas
7081,2014,Madison,male,1911,174665,182895,357560,0.010940944092977986,Texas
7082,2014,Madison,male,1911,8038,8038,16076,0.2377457078875342,Texas
7083,2014,Madison,male,1911,9829,8645,18474,0.19442466171533218,Texas
7084,2014,Madison,male,1911,14508,14392,28900,0.13172043010752688,Texas
7085,2014,Madison,male,1911,19529,19176,38705,0.09785447283527063,Texas
7086,2014,Madison,male,1911,129718,135952,265670,0.014731957014446724,Texas
7087,2014,Madison,male,1911,64707,64798,129505,0.029533126246001205,Texas
7088,2014,Madison,male,1911,8028,7862,15890,0.23804185351270554,Texas
7089,2014,Madison,male,1911,43737,45963,89700,0.0436929830578229,Texas
7090,2014,Madison,male,1911,5708,5764,11472,0.33479327259985986,Texas
7091,2014,Madison,male,1911,49524,53974,103498,0.038587351587109284,Texas
7092,2014,Madison,male,1911,6049,6156,12205,0.3159199867746735,Texas
7093,2014,Madison,male,1911,4261,3957,8218,0.448486270828444,Texas
7094,2014,Madison,male,1911,17490,17674,35164,0.10926243567753002,Texas
7095,2014,Madison,male,1911,35252,36107,71359,0.05420969023034154,Texas
7096,2014,Madison,male,1911,10502,10903,21405,0.18196533993525044,Texas
7097,2014,Madison,male,1911,24041,19947,43988,0.07948920593985276,Texas
7098,2014,Madison,male,1911,46137,51545,97682,0.04142011834319527,Texas
7099,2014,Madison,male,1911,8127,6001,14128,0.2351421188630491,Texas
7100,2014,Madison,male,1911,6350,6789,13139,0.30094488188976376,Texas
7121,2015,Madison,male,2334,174665,182895,357560,0.013362722926745485,Texas
7122,2015,Madison,male,2334,8038,8038,16076,0.2903707389897985,Texas
7123,2015,Madison,male,2334,9829,8645,18474,0.2374605758469834,Texas
7124,2015,Madison,male,2334,14508,14392,28900,0.1608767576509512,Texas
7125,2015,Madison,male,2334,19529,19176,38705,0.11951456807824261,Texas
7126,2015,Madison,male,2334,129718,135952,265670,0.01799287685594906,Texas
7127,2015,Madison,male,2334,64707,64798,129505,0.03607028605869535,Texas
7128,2015,Madison,male,2334,8028,7862,15890,0.2907324364723468,Texas
7129,2015,Madison,male,2334,43737,45963,89700,0.053364428287262504,Texas
7130,2015,Madison,male,2334,5708,5764,11472,0.40889978976874564,Texas
7131,2015,Madison,male,2334,49524,53974,103498,0.04712866488975043,Texas
7132,2015,Madison,male,2334,6049,6156,12205,0.38584890064473465,Texas
7133,2015,Madison,male,2334,4261,3957,8218,0.5477587420793241,Texas
7134,2015,Madison,male,2334,17490,17674,35164,0.13344768439108062,Texas
7135,2015,Madison,male,2334,35252,36107,71359,0.06620900941790536,Texas
7136,2015,Madison,male,2334,10502,10903,21405,0.22224338221291182,Texas
7137,2015,Madison,male,2334,24041,19947,43988,0.09708414791398029,Texas
7138,2015,Madison,male,2334,46137,51545,97682,0.05058846478964822,Texas
7139,2015,Madison,male,2334,8127,6001,14128,0.2871908453303802,Texas
7140,2015,Madison,male,2334,6350,6789,13139,0.3675590551181102,Texas
7161,2016,Madison,male,2750,174665,182895,357560,0.015744425042223686,Texas
7162,2016,Madison,male,2750,8038,8038,16076,0.3421249066932073,Texas
7163,2016,Madison,male,2750,9829,8645,18474,0.27978431173059315,Texas
7164,2016,Madison,male,2750,14508,14392,28900,0.18955059277639924,Texas
7165,2016,Madison,male,2750,19529,19176,38705,0.14081622202877772,Texas
7166,2016,Madison,male,2750,129718,135952,265670,0.021199833484944263,Texas
7167,2016,Madison,male,2750,64707,64798,129505,0.04249926592177044,Texas
7168,2016,Madison,male,2750,8028,7862,15890,0.34255107125062284,Texas
7169,2016,Madison,male,2750,43737,45963,89700,0.06287582595971375,Texas
7170,2016,Madison,male,2750,5708,5764,11472,0.4817799579537491,Texas
7171,2016,Madison,male,2750,49524,53974,103498,0.05552863258218237,Texas
7172,2016,Madison,male,2750,6049,6156,12205,0.45462059844602415,Texas
7173,2016,Madison,male,2750,4261,3957,8218,0.6453884064773527,Texas
7174,2016,Madison,male,2750,17490,17674,35164,0.15723270440251572,Texas
7175,2016,Madison,male,2750,35252,36107,71359,0.07800975831158516,Texas
7176,2016,Madison,male,2750,10502,10903,21405,0.2618548847838507,Texas
7177,2016,Madison,male,2750,24041,19947,43988,0.11438792063558088,Texas
7178,2016,Madison,male,2750,46137,51545,97682,0.05960508919088801,Texas
7179,2016,Madison,male,2750,8127,6001,14128,0.33837824535498956,Texas
7180,2016,Madison,male,2750,6350,6789,13139,0.4330708661417323,Texas
7198,2009,Marion,male,3524,14898,15067,29965,0.23654181769365015,Texas
7199,2009,Marion,male,3524,7990,8448,16438,0.44105131414267834,Texas
7200,2009,Marion,male,3524,167211,181160,348371,0.021075168499680046,Texas
7201,2009,Marion,male,3524,4203,4281,8484,0.8384487270996906,Texas
7202,2009,Marion,male,3524,18726,19358,38084,0.18818754672647656,Texas
7203,2009,Marion,male,3524,455007,489516,944523,0.007744935792196604,Texas
7204,2009,Marion,male,3524,16374,16833,33207,0.2152192500305362,Texas
7205,2009,Marion,male,3524,5971,6061,12032,0.5901858985094623,Texas
7206,2009,Marion,male,3524,9751,9481,19232,0.3613988308891396,Texas
7207,2009,Marion,male,3524,12230,12972,25202,0.28814390842191334,Texas
7208,2009,Marion,male,3524,13745,14927,28672,0.25638413968715895,Texas
7209,2009,Marion,male,3524,34700,30644,65344,0.10155619596541787,Texas
7210,2009,Marion,male,3524,167333,168220,335553,0.02105980290797392,Texas
7211,2009,Marion,male,3524,14655,16907,31562,0.24046400545888774,Texas
7212,2009,Marion,male,3524,13832,14585,28417,0.25477154424522847,Texas
7213,2009,Marion,male,3524,4915,5168,10083,0.7169888097660224,Texas
7214,2009,Marion,male,3524,27819,28678,56497,0.12667601279700924,Texas
7232,2010,Marion,male,4424,14898,15067,29965,0.2969526110887367,Texas
7233,2010,Marion,male,4424,7990,8448,16438,0.5536921151439299,Texas
7234,2010,Marion,male,4424,167211,181160,348371,0.026457589512651678,Texas
7235,2010,Marion,male,4424,4203,4281,8484,1.0525814894123244,Texas
7236,2010,Marion,male,4424,18726,19358,38084,0.23624906547046887,Texas
7237,2010,Marion,male,4424,455007,489516,944523,0.009722927339579392,Texas
7238,2010,Marion,male,4424,16374,16833,33207,0.2701844387443508,Texas
7239,2010,Marion,male,4424,5971,6061,12032,0.7409144196951934,Texas
7240,2010,Marion,male,4424,9751,9481,19232,0.45369705671213206,Texas
7241,2010,Marion,male,4424,12230,12972,25202,0.3617334423548651,Texas
7242,2010,Marion,male,4424,13745,14927,28672,0.321862495452892,Texas
7243,2010,Marion,male,4424,34700,30644,65344,0.12749279538904898,Texas
7244,2010,Marion,male,4424,167333,168220,335553,0.026438299677887803,Texas
7245,2010,Marion,male,4424,14655,16907,31562,0.3018764926646196,Texas
7246,2010,Marion,male,4424,13832,14585,28417,0.31983805668016196,Texas
7247,2010,Marion,male,4424,4915,5168,10083,0.9001017293997965,Texas
7248,2010,Marion,male,4424,27819,28678,56497,0.15902800244437254,Texas
7266,2011,Marion,male,4123,14898,15067,29965,0.2767485568532689,Texas
7267,2011,Marion,male,4123,7990,8448,16438,0.5160200250312891,Texas
7268,2011,Marion,male,4123,167211,181160,348371,0.024657468707202278,Texas
7269,2011,Marion,male,4123,4203,4281,8484,0.9809659766833214,Texas
7270,2011,Marion,male,4123,18726,19358,38084,0.2201751575349781,Texas
7271,2011,Marion,male,4123,455007,489516,944523,0.009061399055399148,Texas
7272,2011,Marion,male,4123,16374,16833,33207,0.25180163674117506,Texas
7273,2011,Marion,male,4123,5971,6061,12032,0.690504103165299,Texas
7274,2011,Marion,male,4123,9751,9481,19232,0.42282842785355346,Texas
7275,2011,Marion,male,4123,12230,12972,25202,0.3371218315617334,Texas
7276,2011,Marion,male,4123,13745,14927,28672,0.2999636231356857,Texas
7277,2011,Marion,male,4123,34700,30644,65344,0.11881844380403458,Texas
7278,2011,Marion,male,4123,167333,168220,335553,0.024639491313727717,Texas
7279,2011,Marion,male,4123,14655,16907,31562,0.28133742749914703,Texas
7280,2011,Marion,male,4123,13832,14585,28417,0.2980769230769231,Texas
7281,2011,Marion,male,4123,4915,5168,10083,0.8388606307222788,Texas
7282,2011,Marion,male,4123,27819,28678,56497,0.1482080592400877,Texas
7300,2012,Marion,male,3473,14898,15067,29965,0.23311853940126193,Texas
7301,2012,Marion,male,3473,7990,8448,16438,0.4346683354192741,Texas
7302,2012,Marion,male,3473,167211,181160,348371,0.020770164642278318,Texas
7303,2012,Marion,male,3473,4203,4281,8484,0.8263145372353081,Texas
7304,2012,Marion,male,3473,18726,19358,38084,0.185464060664317,Texas
7305,2012,Marion,male,3473,455007,489516,944523,0.0076328496045115785,Texas
7306,2012,Marion,male,3473,16374,16833,33207,0.21210455600342007,Texas
7307,2012,Marion,male,3473,5971,6061,12032,0.581644615642271,Texas
7308,2012,Marion,male,3473,9751,9481,19232,0.35616859809250334,Texas
7309,2012,Marion,male,3473,12230,12972,25202,0.28397383483237937,Texas
7310,2012,Marion,male,3473,13745,14927,28672,0.2526736995271008,Texas
7311,2012,Marion,male,3473,34700,30644,65344,0.1000864553314121,Texas
7312,2012,Marion,male,3473,167333,168220,335553,0.020755021424345467,Texas
7313,2012,Marion,male,3473,14655,16907,31562,0.2369839645172296,Texas
7314,2012,Marion,male,3473,13832,14585,28417,0.25108444187391554,Texas
7315,2012,Marion,male,3473,4915,5168,10083,0.7066124109867752,Texas
7316,2012,Marion,male,3473,27819,28678,56497,0.12484273338365864,Texas
7334,2013,Marion,male,2769,14898,15067,29965,0.18586387434554974,Texas
7335,2013,Marion,male,2769,7990,8448,16438,0.346558197747184,Texas
7336,2013,Marion,male,2769,167211,181160,348371,0.016559915316576062,Texas
7337,2013,Marion,male,2769,4203,4281,8484,0.6588151320485368,Texas
7338,2013,Marion,male,2769,18726,19358,38084,0.14786927266901634,Texas
7339,2013,Marion,male,2769,455007,489516,944523,0.006085620660781043,Texas
7340,2013,Marion,male,2769,16374,16833,33207,0.16910956394283622,Texas
7341,2013,Marion,male,2769,5971,6061,12032,0.46374141684809916,Texas
7342,2013,Marion,male,2769,9751,9481,19232,0.2839708747820736,Texas
7343,2013,Marion,male,2769,12230,12972,25202,0.22641046606704823,Texas
7344,2013,Marion,male,2769,13745,14927,28672,0.20145507457257184,Texas
7345,2013,Marion,male,2769,34700,30644,65344,0.07979827089337176,Texas
7346,2013,Marion,male,2769,167333,168220,335553,0.016547841728768383,Texas
7347,2013,Marion,male,2769,14655,16907,31562,0.18894575230296828,Texas
7348,2013,Marion,male,2769,13832,14585,28417,0.20018796992481203,Texas
7349,2013,Marion,male,2769,4915,5168,10083,0.5633774160732452,Texas
7350,2013,Marion,male,2769,27819,28678,56497,0.09953628814838779,Texas
7368,2014,Marion,male,2093,14898,15067,29965,0.14048865619546247,Texas
7369,2014,Marion,male,2093,7990,8448,16438,0.26195244055068834,Texas
7370,2014,Marion,male,2093,167211,181160,348371,0.012517119089055145,Texas
7371,2014,Marion,male,2093,4203,4281,8484,0.4979776350226029,Texas
7372,2014,Marion,male,2093,18726,19358,38084,0.11176973192352878,Texas
7373,2014,Marion,male,2093,455007,489516,944523,0.004599929231857971,Texas
7374,2014,Marion,male,2093,16374,16833,33207,0.12782459997557102,Texas
7375,2014,Marion,male,2093,5971,6061,12032,0.3505275498241501,Texas
7376,2014,Marion,male,2093,9751,9481,19232,0.21464465183058148,Texas
7377,2014,Marion,male,2093,12230,12972,25202,0.17113654946852003,Texas
7378,2014,Marion,male,2093,13745,14927,28672,0.15227355401964351,Texas
7379,2014,Marion,male,2093,34700,30644,65344,0.060317002881844384,Texas
7380,2014,Marion,male,2093,167333,168220,335553,0.012507993043810844,Texas
7381,2014,Marion,male,2093,14655,16907,31562,0.14281815080177415,Texas
7382,2014,Marion,male,2093,13832,14585,28417,0.1513157894736842,Texas
7383,2014,Marion,male,2093,4915,5168,10083,0.42583926754832147,Texas
7384,2014,Marion,male,2093,27819,28678,56497,0.07523634925770158,Texas
7402,2015,Marion,male,1921,14898,15067,29965,0.1289434823466237,Texas
7403,2015,Marion,male,1921,7990,8448,16438,0.2404255319148936,Texas
7404,2015,Marion,male,1921,167211,181160,348371,0.011488478628798345,Texas
7405,2015,Marion,male,1921,4203,4281,8484,0.457054484891744,Texas
7406,2015,Marion,male,1921,18726,19358,38084,0.10258464167467692,Texas
7407,2015,Marion,male,1921,455007,489516,944523,0.004221913069469261,Texas
7408,2015,Marion,male,1921,16374,16833,33207,0.11732014168804202,Texas
7409,2015,Marion,male,1921,5971,6061,12032,0.3217216546642104,Texas
7410,2015,Marion,male,1921,9751,9481,19232,0.19700543533996512,Texas
7411,2015,Marion,male,1921,12230,12972,25202,0.1570727718724448,Texas
7412,2015,Marion,male,1921,13745,14927,28672,0.13975991269552565,Texas
7413,2015,Marion,male,1921,34700,30644,65344,0.05536023054755043,Texas
7414,2015,Marion,male,1921,167333,168220,335553,0.01148010255000508,Texas
7415,2015,Marion,male,1921,14655,16907,31562,0.13108154213578982,Texas
7416,2015,Marion,male,1921,13832,14585,28417,0.13888085598611916,Texas
7417,2015,Marion,male,1921,4915,5168,10083,0.3908443540183113,Texas
7418,2015,Marion,male,1921,27819,28678,56497,0.06905352456953881,Texas
7436,2016,Marion,male,1935,14898,15067,29965,0.12988320579943616,Texas
7437,2016,Marion,male,1935,7990,8448,16438,0.24217772215269087,Texas
7438,2016,Marion,male,1935,167211,181160,348371,0.011572205177889015,Texas
7439,2016,Marion,male,1935,4203,4281,8484,0.4603854389721627,Texas
7440,2016,Marion,male,1935,18726,19358,38084,0.10333226529958346,Texas
7441,2016,Marion,male,1935,455007,489516,944523,0.004252681826872993,Texas
7442,2016,Marion,male,1935,16374,16833,33207,0.11817515573470136,Texas
7443,2016,Marion,male,1935,5971,6061,12032,0.3240663205493217,Texas
7444,2016,Marion,male,1935,9751,9481,19232,0.1984411855194339,Texas
7445,2016,Marion,male,1935,12230,12972,25202,0.15821749795584628,Texas
7446,2016,Marion,male,1935,13745,14927,28672,0.14077846489632595,Texas
7447,2016,Marion,male,1935,34700,30644,65344,0.055763688760806916,Texas
7448,2016,Marion,male,1935,167333,168220,335553,0.011563768055314852,Texas
7449,2016,Marion,male,1935,14655,16907,31562,0.13203684749232344,Texas
7450,2016,Marion,male,1935,13832,14585,28417,0.139893001735107,Texas
7451,2016,Marion,male,1935,4915,5168,10083,0.3936927772126144,Texas
7452,2016,Marion,male,1935,27819,28678,56497,0.06955677774183112,Texas
7459,2009,Martin,male,2293,78002,79579,157581,0.02939668213635548,Texas
7460,2009,Martin,male,2293,5155,5055,10210,0.44481086323957325,Texas
7461,2009,Martin,male,2293,6583,5336,11919,0.34832143399665805,Texas
7462,2009,Martin,male,2293,10068,9896,19964,0.227751291219706,Texas
7463,2009,Martin,male,2293,10805,12249,23054,0.2122165664044424,Texas
7464,2009,Martin,male,2293,2934,2680,5614,0.7815269256987049,Texas
7471,2010,Martin,male,3336,78002,79579,157581,0.0427681341504064,Texas
7472,2010,Martin,male,3336,5155,5055,10210,0.6471387002909796,Texas
7473,2010,Martin,male,3336,6583,5336,11919,0.5067598359410603,Texas
7474,2010,Martin,male,3336,10068,9896,19964,0.33134684147794996,Texas
7475,2010,Martin,male,3336,10805,12249,23054,0.3087459509486349,Texas
7476,2010,Martin,male,3336,2934,2680,5614,1.1370143149284253,Texas
7483,2011,Martin,male,3831,78002,79579,157581,0.049114125278839,Texas
7484,2011,Martin,male,3831,5155,5055,10210,0.7431619786614937,Texas
7485,2011,Martin,male,3831,6583,5336,11919,0.5819535166337536,Texas
7486,2011,Martin,male,3831,10068,9896,19964,0.3805125148986889,Texas
7487,2011,Martin,male,3831,10805,12249,23054,0.35455807496529385,Texas
7488,2011,Martin,male,3831,2934,2680,5614,1.3057259713701432,Texas
7495,2012,Martin,male,4523,78002,79579,157581,0.057985692674546806,Texas
7496,2012,Martin,male,4523,5155,5055,10210,0.8774005819592628,Texas
7497,2012,Martin,male,4523,6583,5336,11919,0.6870727631778825,Texas
7498,2012,Martin,male,4523,10068,9896,19964,0.4492451330949543,Texas
7499,2012,Martin,male,4523,10805,12249,23054,0.41860249884312817,Texas
7500,2012,Martin,male,4523,2934,2680,5614,1.5415814587593728,Texas
7507,2013,Martin,male,2875,78002,79579,157581,0.036858029281300476,Texas
7508,2013,Martin,male,2875,5155,5055,10210,0.5577109602327837,Texas
7509,2013,Martin,male,2875,6583,5336,11919,0.4367309737201884,Texas
7510,2013,Martin,male,2875,10068,9896,19964,0.28555820421136274,Texas
7511,2013,Martin,male,2875,10805,12249,23054,0.2660805182785747,Texas
7512,2013,Martin,male,2875,2934,2680,5614,0.979890933878664,Texas
7519,2014,Martin,male,1350,78002,79579,157581,0.017307248532088922,Texas
7520,2014,Martin,male,1350,5155,5055,10210,0.2618816682832202,Texas
7521,2014,Martin,male,1350,6583,5336,11919,0.20507367461643627,Texas
7522,2014,Martin,male,1350,10068,9896,19964,0.13408820023837903,Texas
7523,2014,Martin,male,1350,10805,12249,23054,0.12494215640906987,Texas
7524,2014,Martin,male,1350,2934,2680,5614,0.4601226993865031,Texas
7531,2015,Martin,male,1606,78002,79579,157581,0.020589215661136893,Texas
7532,2015,Martin,male,1606,5155,5055,10210,0.31154219204655675,Texas
7533,2015,Martin,male,1606,6583,5336,11919,0.24396171958073826,Texas
7534,2015,Martin,male,1606,10068,9896,19964,0.15951529598728645,Texas
7535,2015,Martin,male,1606,10805,12249,23054,0.14863489125404905,Texas
7536,2015,Martin,male,1606,2934,2680,5614,0.547375596455351,Texas
7543,2016,Martin,male,1148,78002,79579,157581,0.014717571344324505,Texas
7544,2016,Martin,male,1148,5155,5055,10210,0.22269641125121242,Texas
7545,2016,Martin,male,1148,6583,5336,11919,0.17438857663679175,Texas
7546,2016,Martin,male,1148,10068,9896,19964,0.11402463249900675,Texas
7547,2016,Martin,male,1148,10805,12249,23054,0.10624710782045349,Texas
7548,2016,Martin,male,1148,2934,2680,5614,0.3912747102931152,Texas
7555,2009,Mason,male,1034,6838,6940,13778,0.15121380520620065,Texas
7556,2009,Mason,male,1034,8485,8668,17153,0.12186210960518562,Texas
7557,2009,Mason,male,1034,14310,14574,28884,0.07225716282320056,Texas
7558,2009,Mason,male,1034,2146,2015,4161,0.48182665424044735,Texas
7559,2009,Mason,male,1034,32413,30214,62627,0.03190078055101348,Texas
7560,2009,Mason,male,1034,13026,13913,26939,0.07937970213419315,Texas
7567,2010,Mason,male,1252,6838,6940,13778,0.1830944720678561,Texas
7568,2010,Mason,male,1252,8485,8668,17153,0.14755450795521508,Texas
7569,2010,Mason,male,1252,14310,14574,28884,0.08749126484975542,Texas
7570,2010,Mason,male,1252,2146,2015,4161,0.5834109972041006,Texas
7571,2010,Mason,male,1252,32413,30214,62627,0.03862647703082097,Texas
7572,2010,Mason,male,1252,13026,13913,26939,0.09611546138492247,Texas
7579,2011,Mason,male,1142,6838,6940,13778,0.16700789704591987,Texas
7580,2011,Mason,male,1142,8485,8668,17153,0.13459045374189746,Texas
7581,2011,Mason,male,1142,14310,14574,28884,0.07980433263452132,Texas
7582,2011,Mason,male,1142,2146,2015,4161,0.53215284249767,Texas
7583,2011,Mason,male,1142,32413,30214,62627,0.03523277697220251,Texas
7584,2011,Mason,male,1142,13026,13913,26939,0.08767081222171043,Texas
7591,2012,Mason,male,1477,6838,6940,13778,0.21599883006727114,Texas
7592,2012,Mason,male,1477,8485,8668,17153,0.17407189157336475,Texas
7593,2012,Mason,male,1477,14310,14574,28884,0.10321453529000699,Texas
7594,2012,Mason,male,1477,2146,2015,4161,0.6882572227399814,Texas
7595,2012,Mason,male,1477,32413,30214,62627,0.045568136241631446,Texas
7596,2012,Mason,male,1477,13026,13913,26939,0.11338860740058344,Texas
7603,2013,Mason,male,1674,6838,6940,13778,0.24480842351564785,Texas
7604,2013,Mason,male,1674,8485,8668,17153,0.1972893341190336,Texas
7605,2013,Mason,male,1674,14310,14574,28884,0.1169811320754717,Texas
7606,2013,Mason,male,1674,2146,2015,4161,0.7800559179869525,Texas
7607,2013,Mason,male,1674,32413,30214,62627,0.05164594452842995,Texas
7608,2013,Mason,male,1674,13026,13913,26939,0.12851220635651772,Texas
7615,2014,Mason,male,1377,6838,6940,13778,0.20137467095642,Texas
7616,2014,Mason,male,1377,8485,8668,17153,0.16228638774307602,Texas
7617,2014,Mason,male,1377,14310,14574,28884,0.09622641509433963,Texas
7618,2014,Mason,male,1377,2146,2015,4161,0.6416589002795899,Texas
7619,2014,Mason,male,1377,32413,30214,62627,0.04248295437016012,Texas
7620,2014,Mason,male,1377,13026,13913,26939,0.10571165361584524,Texas
7627,2015,Mason,male,1349,6838,6940,13778,0.19727990640538168,Texas
7628,2015,Mason,male,1349,8485,8668,17153,0.15898644667059517,Texas
7629,2015,Mason,male,1349,14310,14574,28884,0.09426974143955276,Texas
7630,2015,Mason,male,1349,2146,2015,4161,0.6286113699906803,Texas
7631,2015,Mason,male,1349,32413,30214,62627,0.04161910344614815,Texas
7632,2015,Mason,male,1349,13026,13913,26939,0.10356210655611853,Texas
7639,2016,Mason,male,1250,6838,6940,13778,0.1828019888856391,Texas
7640,2016,Mason,male,1250,8485,8668,17153,0.1473187978786093,Texas
7641,2016,Mason,male,1250,14310,14574,28884,0.08735150244584207,Texas
7642,2016,Mason,male,1250,2146,2015,4161,0.5824790307548928,Texas
7643,2016,Mason,male,1250,32413,30214,62627,0.03856477339339154,Texas
7644,2016,Mason,male,1250,13026,13913,26939,0.0959619223092277,Texas
7646,2009,Matagorda,male,6807,18319,18424,36743,0.3715814181996834,Texas
7648,2010,Matagorda,male,5366,18319,18424,36743,0.29291991920956384,Texas
7650,2011,Matagorda,male,6436,18319,18424,36743,0.35132922102734865,Texas
7652,2012,Matagorda,male,4152,18319,18424,36743,0.22664992630602107,Texas
7654,2013,Matagorda,male,3812,18319,18424,36743,0.2080899612424259,Texas
7656,2014,Matagorda,male,2863,18319,18424,36743,0.15628582346197936,Texas
7658,2015,Matagorda,male,2385,18319,18424,36743,0.13019269610786616,Texas
7660,2016,Matagorda,male,3285,18319,18424,36743,0.17932201539385337,Texas
7662,2009,Maverick,male,9180,28736,29234,57970,0.3194599109131403,Texas
7664,2010,Maverick,male,8753,28736,29234,57970,0.3046005011135857,Texas
7666,2011,Maverick,male,7551,28736,29234,57970,0.26277143652561247,Texas
7668,2012,Maverick,male,7695,28736,29234,57970,0.2677825723830735,Texas
7670,2013,Maverick,male,7665,28736,29234,57970,0.26673858574610243,Texas
7672,2014,Maverick,male,8002,28736,29234,57970,0.27846603563474387,Texas
7674,2015,Maverick,male,11141,28736,29234,57970,0.38770183741648107,Texas
7676,2016,Maverick,male,12070,28736,29234,57970,0.4200306236080178,Texas
7678,2009,McCulloch,male,2330,4260,3838,8098,0.5469483568075117,Texas
7680,2010,McCulloch,male,3241,4260,3838,8098,0.7607981220657277,Texas
7682,2011,McCulloch,male,3219,4260,3838,8098,0.7556338028169014,Texas
7684,2012,McCulloch,male,3846,4260,3838,8098,0.9028169014084507,Texas
7686,2013,McCulloch,male,3025,4260,3838,8098,0.710093896713615,Texas
7688,2014,McCulloch,male,3072,4260,3838,8098,0.7211267605633803,Texas
7690,2015,McCulloch,male,3551,4260,3838,8098,0.8335680751173709,Texas
7692,2016,McCulloch,male,2560,4260,3838,8098,0.6009389671361502,Texas
7694,2009,McLennan,male,16841,121359,127070,248429,0.13877009533697543,Texas
7696,2010,McLennan,male,17879,121359,127070,248429,0.14732323107474518,Texas
7698,2011,McLennan,male,13472,121359,127070,248429,0.11100948425745104,Texas
7700,2012,McLennan,male,12954,121359,127070,248429,0.10674115640372778,Texas
7702,2013,McLennan,male,11524,121359,127070,248429,0.09495793472259989,Texas
7704,2014,McLennan,male,11038,121359,127070,248429,0.09095328735404873,Texas
7706,2015,McLennan,male,7124,121359,127070,248429,0.05870186801143714,Texas
7708,2016,McLennan,male,8041,121359,127070,248429,0.06625796191464993,Texas
7710,2009,McMullen,male,1484,387,275,662,3.834625322997416,Texas
7712,2010,McMullen,male,1291,387,275,662,3.3359173126614987,Texas
7714,2011,McMullen,male,1650,387,275,662,4.263565891472868,Texas
7716,2012,McMullen,male,2122,387,275,662,5.483204134366925,Texas
7718,2013,McMullen,male,1384,387,275,662,3.5762273901808785,Texas
7720,2014,McMullen,male,1790,387,275,662,4.625322997416021,Texas
7722,2015,McMullen,male,1376,387,275,662,3.5555555555555554,Texas
7724,2016,McMullen,male,1037,387,275,662,2.6795865633074936,Texas
7727,2009,Medina,male,12473,87695,89562,177257,0.1422315981526883,Texas
7728,2009,Medina,male,12473,25551,23783,49334,0.48816093303588903,Texas
7731,2010,Medina,male,14636,87695,89562,177257,0.16689663036661156,Texas
7732,2010,Medina,male,14636,25551,23783,49334,0.572815154005714,Texas
7735,2011,Medina,male,15197,87695,89562,177257,0.17329380238326017,Texas
7736,2011,Medina,male,15197,25551,23783,49334,0.5947712418300654,Texas
7739,2012,Medina,male,11063,87695,89562,177257,0.12615314442100461,Texas
7740,2012,Medina,male,11063,25551,23783,49334,0.43297718288912374,Texas
7743,2013,Medina,male,8960,87695,89562,177257,0.10217230172757855,Texas
7744,2013,Medina,male,8960,25551,23783,49334,0.35067120660639506,Texas
7747,2014,Medina,male,9076,87695,89562,177257,0.10349506813387309,Texas
7748,2014,Medina,male,9076,25551,23783,49334,0.3552111463347814,Texas
7751,2015,Medina,male,8833,87695,89562,177257,0.10072410057585951,Texas
7752,2015,Medina,male,8833,25551,23783,49334,0.34570075535204103,Texas
7755,2016,Medina,male,7295,87695,89562,177257,0.08318604253378185,Texas
7756,2016,Medina,male,7295,25551,23783,49334,0.2855074165394701,Texas
7759,2009,Menard,male,702,6043,6324,12367,0.1161674664901539,Texas
7760,2009,Menard,male,702,1117,1006,2123,0.6284691136974038,Texas
7763,2010,Menard,male,369,6043,6324,12367,0.061062386232003975,Texas
7764,2010,Menard,male,369,1117,1006,2123,0.3303491495076097,Texas
7767,2011,Menard,male,270,6043,6324,12367,0.04467979480390535,Texas
7768,2011,Menard,male,270,1117,1006,2123,0.24171888988361684,Texas
7771,2012,Menard,male,910,6043,6324,12367,0.15058745656131062,Texas
7772,2012,Menard,male,910,1117,1006,2123,0.8146821844225605,Texas
7775,2013,Menard,male,605,6043,6324,12367,0.10011583650504716,Texas
7776,2013,Menard,male,605,1117,1006,2123,0.5416293643688451,Texas
7779,2014,Menard,male,127,6043,6324,12367,0.021016051629985107,Texas
7780,2014,Menard,male,127,1117,1006,2123,0.11369740376007162,Texas
7783,2015,Menard,male,950,6043,6324,12367,0.15720668542114843,Texas
7784,2015,Menard,male,950,1117,1006,2123,0.8504923903312444,Texas
7787,2016,Menard,male,521,6043,6324,12367,0.08621545589938773,Texas
7788,2016,Menard,male,521,1117,1006,2123,0.4664279319606088,Texas
7791,2009,Midland,male,7338,40980,42409,83389,0.17906295754026355,Texas
7792,2009,Midland,male,7338,82543,81651,164194,0.08889911924693795,Texas
7795,2010,Midland,male,9605,40980,42409,83389,0.23438262567105905,Texas
7796,2010,Midland,male,9605,82543,81651,164194,0.11636359230946294,Texas
7799,2011,Midland,male,10162,40980,42409,83389,0.24797462176671548,Texas
7800,2011,Midland,male,10162,82543,81651,164194,0.12311159032261973,Texas
7803,2012,Midland,male,9729,40980,42409,83389,0.23740849194729136,Texas
7804,2012,Midland,male,9729,82543,81651,164194,0.11786583962298439,Texas
7807,2013,Midland,male,8328,40980,42409,83389,0.20322108345534406,Texas
7808,2013,Midland,male,8328,82543,81651,164194,0.10089286795973008,Texas
7811,2014,Midland,male,8773,40980,42409,83389,0.2140800390434358,Texas
7812,2014,Midland,male,8773,82543,81651,164194,0.10628399743164169,Texas
7815,2015,Midland,male,8159,40980,42409,83389,0.1990971205466081,Texas
7816,2015,Midland,male,8159,82543,81651,164194,0.09884545025017263,Texas
7819,2016,Midland,male,9720,40980,42409,83389,0.23718887262079064,Texas
7820,2016,Midland,male,9720,82543,81651,164194,0.11775680554377718,Texas
7822,2009,Milam,male,5038,12343,12321,24664,0.4081665721461557,Texas
7824,2010,Milam,male,6162,12343,12321,24664,0.49923033298225716,Texas
7826,2011,Milam,male,5087,12343,12321,24664,0.41213643360609253,Texas
7828,2012,Milam,male,3976,12343,12321,24664,0.32212590132058655,Texas
7830,2013,Milam,male,4385,12343,12321,24664,0.35526209187393665,Texas
7832,2014,Milam,male,3474,12343,12321,24664,0.2814550757514381,Texas
7834,2015,Milam,male,3043,12343,12321,24664,0.24653649842015718,Texas
7836,2016,Milam,male,3495,12343,12321,24664,0.28315644494855385,Texas
7839,2009,Mills,male,1744,7516,7441,14957,0.23203831825439064,Texas
7840,2009,Mills,male,1744,2329,2573,4902,0.7488192357234865,Texas
7843,2010,Mills,male,1941,7516,7441,14957,0.25824906865353914,Texas
7844,2010,Mills,male,1941,2329,2573,4902,0.8334048948046372,Texas
7847,2011,Mills,male,1179,7516,7441,14957,0.15686535391165513,Texas
7848,2011,Mills,male,1179,2329,2573,4902,0.506225848003435,Texas
7851,2012,Mills,male,1143,7516,7441,14957,0.15207557211282596,Texas
7852,2012,Mills,male,1143,2329,2573,4902,0.49076857020180337,Texas
7855,2013,Mills,male,1797,7516,7441,14957,0.23908994145822246,Texas
7856,2013,Mills,male,1797,2329,2573,4902,0.7715757835981107,Texas
7859,2014,Mills,male,1178,7516,7441,14957,0.1567323044172432,Texas
7860,2014,Mills,male,1178,2329,2573,4902,0.5057964791756119,Texas
7863,2015,Mills,male,1182,7516,7441,14957,0.1572645023948909,Texas
7864,2015,Mills,male,1182,2329,2573,4902,0.5075139544869043,Texas
7867,2016,Mills,male,1194,7516,7441,14957,0.15886109632783396,Texas
7868,2016,Mills,male,1194,2329,2573,4902,0.5126663804207815,Texas
7874,2009,Mitchell,male,4849,11683,10749,22432,0.4150475049216811,Texas
7875,2009,Mitchell,male,4849,5282,5349,10631,0.9180234759560773,Texas
7876,2009,Mitchell,male,4849,3163,3059,6222,1.5330382548213721,Texas
7877,2009,Mitchell,male,4849,7400,7640,15040,0.6552702702702703,Texas
7878,2009,Mitchell,male,4849,5383,3175,8558,0.900798811071893,Texas
7884,2010,Mitchell,male,5547,11683,10749,22432,0.4747924334503124,Texas
7885,2010,Mitchell,male,5547,5282,5349,10631,1.0501703900037864,Texas
7886,2010,Mitchell,male,5547,3163,3059,6222,1.7537148276952261,Texas
7887,2010,Mitchell,male,5547,7400,7640,15040,0.7495945945945945,Texas
7888,2010,Mitchell,male,5547,5383,3175,8558,1.0304662827419655,Texas
7894,2011,Mitchell,male,4454,11683,10749,22432,0.3812376957973123,Texas
7895,2011,Mitchell,male,4454,5282,5349,10631,0.843241196516471,Texas
7896,2011,Mitchell,male,4454,3163,3059,6222,1.4081568131520708,Texas
7897,2011,Mitchell,male,4454,7400,7640,15040,0.6018918918918919,Texas
7898,2011,Mitchell,male,4454,5383,3175,8558,0.8274196544677689,Texas
7904,2012,Mitchell,male,3592,11683,10749,22432,0.307455276898057,Texas
7905,2012,Mitchell,male,3592,5282,5349,10631,0.6800454373343431,Texas
7906,2012,Mitchell,male,3592,3163,3059,6222,1.1356307303193172,Texas
7907,2012,Mitchell,male,3592,7400,7640,15040,0.4854054054054054,Texas
7908,2012,Mitchell,male,3592,5383,3175,8558,0.667285900055731,Texas
7914,2013,Mitchell,male,2976,11683,10749,22432,0.25472909355473766,Texas
7915,2013,Mitchell,male,2976,5282,5349,10631,0.5634229458538432,Texas
7916,2013,Mitchell,male,2976,3163,3059,6222,0.9408789124249131,Texas
7917,2013,Mitchell,male,2976,7400,7640,15040,0.40216216216216216,Texas
7918,2013,Mitchell,male,2976,5383,3175,8558,0.5528515697566413,Texas
7924,2014,Mitchell,male,2754,11683,10749,22432,0.23572712488230763,Texas
7925,2014,Mitchell,male,2754,5282,5349,10631,0.5213934115865203,Texas
7926,2014,Mitchell,male,2754,3163,3059,6222,0.8706923806512804,Texas
7927,2014,Mitchell,male,2754,7400,7640,15040,0.37216216216216214,Texas
7928,2014,Mitchell,male,2754,5383,3175,8558,0.5116106260449563,Texas
7934,2015,Mitchell,male,1957,11683,10749,22432,0.16750834545921425,Texas
7935,2015,Mitchell,male,1957,5282,5349,10631,0.37050359712230213,Texas
7936,2015,Mitchell,male,1957,3163,3059,6222,0.6187164084729687,Texas
7937,2015,Mitchell,male,1957,7400,7640,15040,0.2644594594594595,Texas
7938,2015,Mitchell,male,1957,5383,3175,8558,0.36355192271967307,Texas
7944,2016,Mitchell,male,2808,11683,10749,22432,0.240349225370196,Texas
7945,2016,Mitchell,male,2808,5282,5349,10631,0.5316168118137069,Texas
7946,2016,Mitchell,male,2808,3163,3059,6222,0.8877647802718938,Texas
7947,2016,Mitchell,male,2808,7400,7640,15040,0.37945945945945947,Texas
7948,2016,Mitchell,male,2808,5383,3175,8558,0.5216422069477986,Texas
7950,2009,Montague,male,6268,9403,10006,19409,0.6665957673083058,Texas
7952,2010,Montague,male,6563,9403,10006,19409,0.6979687333829628,Texas
7954,2011,Montague,male,6819,9403,10006,19409,0.7251940869935127,Texas
7956,2012,Montague,male,7401,9403,10006,19409,0.787089226842497,Texas
7958,2013,Montague,male,7221,9403,10006,19409,0.7679464000850792,Texas
7960,2014,Montague,male,5547,9403,10006,19409,0.5899181112410933,Texas
7962,2015,Montague,male,3906,9403,10006,19409,0.41539934063596723,Texas
7964,2016,Montague,male,4190,9403,10006,19409,0.44560246729767095,Texas
7983,2009,Montgomery,male,34499,107354,119587,226941,0.32135737839298023,Texas
7984,2009,Montgomery,male,34499,4440,4553,8993,7.770045045045045,Texas
7985,2009,Montgomery,male,34499,4633,4403,9036,7.446363047701274,Texas
7986,2009,Montgomery,male,34499,15145,13864,29009,2.2779135028062067,Texas
7987,2009,Montgomery,male,34499,19442,18834,38276,1.7744573603538731,Texas
7988,2009,Montgomery,male,34499,4869,5286,10155,7.085438488395974,Texas
7989,2009,Montgomery,male,34499,16410,16560,32970,2.102315661182206,Texas
7990,2009,Montgomery,male,34499,13541,14218,27759,2.5477438889299164,Texas
7991,2009,Montgomery,male,34499,502389,537744,1040133,0.0686698952405407,Texas
7992,2009,Montgomery,male,34499,4769,5429,10198,7.234011323128539,Texas
7993,2009,Montgomery,male,34499,5764,5781,11545,5.985253296321998,Texas
7994,2009,Montgomery,male,34499,24265,25161,49426,1.4217597362456214,Texas
7995,2009,Montgomery,male,34499,13546,13792,27338,2.546803484423446,Texas
7996,2009,Montgomery,male,34499,256154,275880,532034,0.13468069989147155,Texas
7997,2009,Montgomery,male,34499,399358,421943,821301,0.08638614977038146,Texas
7998,2009,Montgomery,male,34499,98123,98264,196387,0.3515893317570804,Texas
7999,2009,Montgomery,male,34499,274604,279841,554445,0.1256318189101397,Texas
8000,2009,Montgomery,male,34499,50738,47259,97997,0.6799440261736766,Texas
8019,2010,Montgomery,male,36487,107354,119587,226941,0.3398755519123647,Texas
8020,2010,Montgomery,male,36487,4440,4553,8993,8.217792792792793,Texas
8021,2010,Montgomery,male,36487,4633,4403,9036,7.8754586660910855,Texas
8022,2010,Montgomery,male,36487,15145,13864,29009,2.4091779465170022,Texas
8023,2010,Montgomery,male,36487,19442,18834,38276,1.876710214998457,Texas
8024,2010,Montgomery,male,36487,4869,5286,10155,7.493735880057507,Texas
8025,2010,Montgomery,male,36487,16410,16560,32970,2.223461304082876,Texas
8026,2010,Montgomery,male,36487,13541,14218,27759,2.694557270511779,Texas
8027,2010,Montgomery,male,36487,502389,537744,1040133,0.07262698825014083,Texas
8028,2010,Montgomery,male,36487,4769,5429,10198,7.650870203396939,Texas
8029,2010,Montgomery,male,36487,5764,5781,11545,6.330152671755725,Texas
8030,2010,Montgomery,male,36487,24265,25161,49426,1.5036884401401196,Texas
8031,2010,Montgomery,male,36487,13546,13792,27338,2.6935626753285105,Texas
8032,2010,Montgomery,male,36487,256154,275880,532034,0.14244165619119747,Texas
8033,2010,Montgomery,male,36487,399358,421943,821301,0.09136413944380731,Texas
8034,2010,Montgomery,male,36487,98123,98264,196387,0.37184961731704086,Texas
8035,2010,Montgomery,male,36487,274604,279841,554445,0.1328713347219997,Texas
8036,2010,Montgomery,male,36487,50738,47259,97997,0.7191257046001025,Texas
8055,2011,Montgomery,male,41938,107354,119587,226941,0.39065148946476147,Texas
8056,2011,Montgomery,male,41938,4440,4553,8993,9.445495495495495,Texas
8057,2011,Montgomery,male,41938,4633,4403,9036,9.052018130800777,Texas
8058,2011,Montgomery,male,41938,15145,13864,29009,2.7690987124463518,Texas
8059,2011,Montgomery,male,41938,19442,18834,38276,2.1570826046703013,Texas
8060,2011,Montgomery,male,41938,4869,5286,10155,8.613267611419182,Texas
8061,2011,Montgomery,male,41938,16410,16560,32970,2.5556368068251065,Texas
8062,2011,Montgomery,male,41938,13541,14218,27759,3.0971124732294513,Texas
8063,2011,Montgomery,male,41938,502389,537744,1040133,0.08347714619547801,Texas
8064,2011,Montgomery,male,41938,4769,5429,10198,8.7938771230866,Texas
8065,2011,Montgomery,male,41938,5764,5781,11545,7.275850104094379,Texas
8066,2011,Montgomery,male,41938,24265,25161,49426,1.7283329899031528,Texas
8067,2011,Montgomery,male,41938,13546,13792,27338,3.0959692898272553,Texas
8068,2011,Montgomery,male,41938,256154,275880,532034,0.16372182359049633,Texas
8069,2011,Montgomery,male,41938,399358,421943,821301,0.10501354674252175,Texas
8070,2011,Montgomery,male,41938,98123,98264,196387,0.4274023419585622,Texas
8071,2011,Montgomery,male,41938,274604,279841,554445,0.15272173748379483,Texas
8072,2011,Montgomery,male,41938,50738,47259,97997,0.82655997477236,Texas
8091,2012,Montgomery,male,41286,107354,119587,226941,0.38457812470890695,Texas
8092,2012,Montgomery,male,41286,4440,4553,8993,9.29864864864865,Texas
8093,2012,Montgomery,male,41286,4633,4403,9036,8.911288581912368,Texas
8094,2012,Montgomery,male,41286,15145,13864,29009,2.7260482007263125,Texas
8095,2012,Montgomery,male,41286,19442,18834,38276,2.123546960189281,Texas
8096,2012,Montgomery,male,41286,4869,5286,10155,8.47935921133703,Texas
8097,2012,Montgomery,male,41286,16410,16560,32970,2.5159049360146253,Texas
8098,2012,Montgomery,male,41286,13541,14218,27759,3.04896241045713,Texas
8099,2012,Montgomery,male,41286,502389,537744,1040133,0.08217934707965342,Texas
8100,2012,Montgomery,male,41286,4769,5429,10198,8.65716083036276,Texas
8101,2012,Montgomery,male,41286,5764,5781,11545,7.162734212352533,Texas
8102,2012,Montgomery,male,41286,24265,25161,49426,1.7014630125695447,Texas
8103,2012,Montgomery,male,41286,13546,13792,27338,3.047836999852355,Texas
8104,2012,Montgomery,male,41286,256154,275880,532034,0.16117647977388602,Texas
8105,2012,Montgomery,male,41286,399358,421943,821301,0.1033809263868509,Texas
8106,2012,Montgomery,male,41286,98123,98264,196387,0.42075762053748866,Texas
8107,2012,Montgomery,male,41286,274604,279841,554445,0.15034740936038804,Texas
8108,2012,Montgomery,male,41286,50738,47259,97997,0.8137096456304939,Texas
8127,2013,Montgomery,male,38230,107354,119587,226941,0.356111556159994,Texas
8128,2013,Montgomery,male,38230,4440,4553,8993,8.61036036036036,Texas
8129,2013,Montgomery,male,38230,4633,4403,9036,8.251672782214548,Texas
8130,2013,Montgomery,male,38230,15145,13864,29009,2.524265434136679,Texas
8131,2013,Montgomery,male,38230,19442,18834,38276,1.9663614854438844,Texas
8132,2013,Montgomery,male,38230,4869,5286,10155,7.851714931197371,Texas
8133,2013,Montgomery,male,38230,16410,16560,32970,2.3296770262035342,Texas
8134,2013,Montgomery,male,38230,13541,14218,27759,2.823277453659257,Texas
8135,2013,Montgomery,male,38230,502389,537744,1040133,0.07609641134658601,Texas
8136,2013,Montgomery,male,38230,4769,5429,10198,8.016355630111134,Texas
8137,2013,Montgomery,male,38230,5764,5781,11545,6.632546842470506,Texas
8138,2013,Montgomery,male,38230,24265,25161,49426,1.575520296723676,Texas
8139,2013,Montgomery,male,38230,13546,13792,27338,2.822235346227669,Texas
8140,2013,Montgomery,male,38230,256154,275880,532034,0.14924615660891494,Texas
8141,2013,Montgomery,male,38230,399358,421943,821301,0.09572864447438138,Texas
8142,2013,Montgomery,male,38230,98123,98264,196387,0.3896130366988372,Texas
8143,2013,Montgomery,male,38230,274604,279841,554445,0.1392186566838065,Texas
8144,2013,Montgomery,male,38230,50738,47259,97997,0.7534786550514407,Texas
8163,2014,Montgomery,male,30934,107354,119587,226941,0.2881494867447883,Texas
8164,2014,Montgomery,male,30934,4440,4553,8993,6.967117117117117,Texas
8165,2014,Montgomery,male,30934,4633,4403,9036,6.676883229009281,Texas
8166,2014,Montgomery,male,30934,15145,13864,29009,2.0425222845823705,Texas
8167,2014,Montgomery,male,30934,19442,18834,38276,1.5910914514967596,Texas
8168,2014,Montgomery,male,30934,4869,5286,10155,6.3532552885602795,Texas
8169,2014,Montgomery,male,30934,16410,16560,32970,1.8850700792199877,Texas
8170,2014,Montgomery,male,30934,13541,14218,27759,2.2844693892622407,Texas
8171,2014,Montgomery,male,30934,502389,537744,1040133,0.06157380038177587,Texas
8172,2014,Montgomery,male,30934,4769,5429,10198,6.486475152023485,Texas
8173,2014,Montgomery,male,30934,5764,5781,11545,5.366759195003469,Texas
8174,2014,Montgomery,male,30934,24265,25161,49426,1.2748403049660004,Texas
8175,2014,Montgomery,male,30934,13546,13792,27338,2.2836261627048575,Texas
8176,2014,Montgomery,male,30934,256154,275880,532034,0.12076329083285836,Texas
8177,2014,Montgomery,male,30934,399358,421943,821301,0.0774593222121505,Texas
8178,2014,Montgomery,male,30934,98123,98264,196387,0.3152573810421614,Texas
8179,2014,Montgomery,male,30934,274604,279841,554445,0.1126494879899783,Texas
8180,2014,Montgomery,male,30934,50738,47259,97997,0.6096811068627065,Texas
8199,2015,Montgomery,male,27327,107354,119587,226941,0.25455036607858117,Texas
8200,2015,Montgomery,male,27327,4440,4553,8993,6.15472972972973,Texas
8201,2015,Montgomery,male,27327,4633,4403,9036,5.898338009928771,Texas
8202,2015,Montgomery,male,27327,15145,13864,29009,1.8043578738857708,Texas
8203,2015,Montgomery,male,27327,19442,18834,38276,1.4055652710626478,Texas
8204,2015,Montgomery,male,27327,4869,5286,10155,5.612446087492298,Texas
8205,2015,Montgomery,male,27327,16410,16560,32970,1.6652650822669104,Texas
8206,2015,Montgomery,male,27327,13541,14218,27759,2.0180931984343844,Texas
8207,2015,Montgomery,male,27327,502389,537744,1040133,0.05439410496647021,Texas
8208,2015,Montgomery,male,27327,4769,5429,10198,5.730132103166282,Texas
8209,2015,Montgomery,male,27327,5764,5781,11545,4.740978487161693,Texas
8210,2015,Montgomery,male,27327,24265,25161,49426,1.1261899855759323,Texas
8211,2015,Montgomery,male,27327,13546,13792,27338,2.0173482946995422,Texas
8212,2015,Montgomery,male,27327,256154,275880,532034,0.10668191790875801,Texas
8213,2015,Montgomery,male,27327,399358,421943,821301,0.0684273258580021,Texas
8214,2015,Montgomery,male,27327,98123,98264,196387,0.27849739612527136,Texas
8215,2015,Montgomery,male,27327,274604,279841,554445,0.09951420955266493,Texas
8216,2015,Montgomery,male,27327,50738,47259,97997,0.5385904056131499,Texas
8235,2016,Montgomery,male,27945,107354,119587,226941,0.2603070216293757,Texas
8236,2016,Montgomery,male,27945,4440,4553,8993,6.293918918918919,Texas
8237,2016,Montgomery,male,27945,4633,4403,9036,6.03172890135981,Texas
8238,2016,Montgomery,male,27945,15145,13864,29009,1.8451634202707163,Texas
8239,2016,Montgomery,male,27945,19442,18834,38276,1.4373521242670506,Texas
8240,2016,Montgomery,male,27945,4869,5286,10155,5.739371534195933,Texas
8241,2016,Montgomery,male,27945,16410,16560,32970,1.7029250457038392,Texas
8242,2016,Montgomery,male,27945,13541,14218,27759,2.06373236836275,Texas
8243,2016,Montgomery,male,27945,502389,537744,1040133,0.05562422744128554,Texas
8244,2016,Montgomery,male,27945,4769,5429,10198,5.859719018662194,Texas
8245,2016,Montgomery,male,27945,5764,5781,11545,4.848195697432339,Texas
8246,2016,Montgomery,male,27945,24265,25161,49426,1.1516587677725119,Texas
8247,2016,Montgomery,male,27945,13546,13792,27338,2.0629706186328067,Texas
8248,2016,Montgomery,male,27945,256154,275880,532034,0.10909452907235491,Texas
8249,2016,Montgomery,male,27945,399358,421943,821301,0.06997480956935882,Texas
8250,2016,Montgomery,male,27945,98123,98264,196387,0.2847956136685588,Texas
8251,2016,Montgomery,male,27945,274604,279841,554445,0.10176472301932965,Texas
8252,2016,Montgomery,male,27945,50738,47259,97997,0.5507706255666365,Texas
8256,2009,Moore,male,4777,46002,49627,95629,0.10384331116038432,Texas
8257,2009,Moore,male,4777,3101,3221,6322,1.5404708158658498,Texas
8258,2009,Moore,male,4777,11438,10363,21801,0.41764294457072915,Texas
8262,2010,Moore,male,4365,46002,49627,95629,0.09488717881831225,Texas
8263,2010,Moore,male,4365,3101,3221,6322,1.4076104482425025,Texas
8264,2010,Moore,male,4365,11438,10363,21801,0.38162266130442385,Texas
8268,2011,Moore,male,6389,46002,49627,95629,0.13888526585800617,Texas
8269,2011,Moore,male,6389,3101,3221,6322,2.0603031280232185,Texas
8270,2011,Moore,male,6389,11438,10363,21801,0.5585766742437489,Texas
8274,2012,Moore,male,7738,46002,49627,95629,0.16821007782270336,Texas
8275,2012,Moore,male,7738,3101,3221,6322,2.4953240890035473,Texas
8276,2012,Moore,male,7738,11438,10363,21801,0.6765168735792971,Texas
8280,2013,Moore,male,5275,46002,49627,95629,0.11466892743793748,Texas
8281,2013,Moore,male,5275,3101,3221,6322,1.7010641728474685,Texas
8282,2013,Moore,male,5275,11438,10363,21801,0.46118202482951565,Texas
8286,2014,Moore,male,3990,46002,49627,95629,0.08673535933220294,Texas
8287,2014,Moore,male,3990,3101,3221,6322,1.2866817155756207,Texas
8288,2014,Moore,male,3990,11438,10363,21801,0.3488372093023256,Texas
8292,2015,Moore,male,2886,46002,49627,95629,0.06273640276509716,Texas
8293,2015,Moore,male,2886,3101,3221,6322,0.9306675266043212,Texas
8294,2015,Moore,male,2886,11438,10363,21801,0.2523168386081483,Texas
8298,2016,Moore,male,3557,46002,49627,95629,0.07732272509890874,Texas
8299,2016,Moore,male,3557,3101,3221,6322,1.1470493389229282,Texas
8300,2016,Moore,male,3557,11438,10363,21801,0.31098094072390275,Texas
8304,2009,Morris,male,3737,2753,2813,5566,1.3574282600799128,Texas
8305,2009,Morris,male,3737,242484,251899,494383,0.01541132610811435,Texas
8306,2009,Morris,male,3737,5981,6443,12424,0.6248119043638187,Texas
8310,2010,Morris,male,4250,2753,2813,5566,1.543770432255721,Texas
8311,2010,Morris,male,4250,242484,251899,494383,0.017526929611850678,Texas
8312,2010,Morris,male,4250,5981,6443,12424,0.7105835144624645,Texas
8316,2011,Morris,male,3125,2753,2813,5566,1.135125317835089,Texas
8317,2011,Morris,male,3125,242484,251899,494383,0.012887448244007851,Texas
8318,2011,Morris,male,3125,5981,6443,12424,0.5224878782812239,Texas
8322,2012,Morris,male,3306,2753,2813,5566,1.2008717762440972,Texas
8323,2012,Morris,male,3306,242484,251899,494383,0.013633889246300787,Texas
8324,2012,Morris,male,3306,5981,6443,12424,0.5527503761912723,Texas
8328,2013,Morris,male,2694,2753,2813,5566,0.9785688339992735,Texas
8329,2013,Morris,male,2694,242484,251899,494383,0.01111001138219429,Texas
8330,2013,Morris,male,2694,5981,6443,12424,0.4504263501086775,Texas
8334,2014,Morris,male,1865,2753,2813,5566,0.6774427896839811,Texas
8335,2014,Morris,male,1865,242484,251899,494383,0.007691229112023886,Texas
8336,2014,Morris,male,1865,5981,6443,12424,0.3118207657582344,Texas
8340,2015,Morris,male,1548,2753,2813,5566,0.5622956774427896,Texas
8341,2015,Morris,male,1548,242484,251899,494383,0.0063839263621517294,Texas
8342,2015,Morris,male,1548,5981,6443,12424,0.25881959538538707,Texas
8346,2016,Morris,male,1027,2753,2813,5566,0.37304758445332364,Texas
8347,2016,Morris,male,1027,242484,251899,494383,0.0042353309909107404,Texas
8348,2016,Morris,male,1027,5981,6443,12424,0.1717104163183414,Texas
8350,2009,Motley,male,546,580,576,1156,0.9413793103448276,Texas
8352,2010,Motley,male,663,580,576,1156,1.143103448275862,Texas
8354,2011,Motley,male,656,580,576,1156,1.1310344827586207,Texas
8356,2012,Motley,male,510,580,576,1156,0.8793103448275862,Texas
8358,2013,Motley,male,128,580,576,1156,0.2206896551724138,Texas
8360,2014,Motley,male,62,580,576,1156,0.10689655172413794,Texas
8362,2015,Motley,male,48,580,576,1156,0.08275862068965517,Texas
8364,2016,Motley,male,89,580,576,1156,0.15344827586206897,Texas
8366,2009,Nacogdoches,male,9909,31365,34193,65558,0.3159253945480631,Texas
8368,2010,Nacogdoches,male,10894,31365,34193,65558,0.34732982623943887,Texas
8370,2011,Nacogdoches,male,9218,31365,34193,65558,0.2938944683564483,Texas
8372,2012,Nacogdoches,male,10421,31365,34193,65558,0.3322493224932249,Texas
8374,2013,Nacogdoches,male,9037,31365,34193,65558,0.28812370476645943,Texas
8376,2014,Nacogdoches,male,5957,31365,34193,65558,0.18992507572134545,Texas
8378,2015,Nacogdoches,male,5656,31365,34193,65558,0.18032839151920932,Texas
8380,2016,Nacogdoches,male,6347,31365,34193,65558,0.20235931771082416,Texas
8382,2009,Navarro,male,8108,23845,24738,48583,0.34002935625917385,Texas
8384,2010,Navarro,male,9916,23845,24738,48583,0.41585237995386876,Texas
8386,2011,Navarro,male,7667,23845,24738,48583,0.3215349129796603,Texas
8388,2012,Navarro,male,9448,23845,24738,48583,0.39622562382050747,Texas
8390,2013,Navarro,male,6310,23845,24738,48583,0.2646257076955337,Texas
8392,2014,Navarro,male,6427,23845,24738,48583,0.26953239672887397,Texas
8394,2015,Navarro,male,4267,23845,24738,48583,0.17894736842105263,Texas
8396,2016,Navarro,male,5985,23845,24738,48583,0.250996015936255,Texas
8403,2009,Newton,male,2940,3932,3916,7848,0.7477110885045778,Texas
8404,2009,Newton,male,2940,50598,55899,106497,0.058105063441242735,Texas
8405,2009,Newton,male,2940,7004,7014,14018,0.4197601370645346,Texas
8406,2009,Newton,male,2940,10142,11382,21524,0.2898836521396174,Texas
8407,2009,Newton,male,2940,28964,29238,58202,0.10150531694517331,Texas
8408,2009,Newton,male,2940,7233,6824,14057,0.40647034425549566,Texas
8415,2010,Newton,male,4227,3932,3916,7848,1.075025432349949,Texas
8416,2010,Newton,male,4227,50598,55899,106497,0.08354085141705206,Texas
8417,2010,Newton,male,4227,7004,7014,14018,0.6035122786978869,Texas
8418,2010,Newton,male,4227,10142,11382,21524,0.4167816998619602,Texas
8419,2010,Newton,male,4227,28964,29238,58202,0.14593978732219307,Texas
8420,2010,Newton,male,4227,7233,6824,14057,0.5844048112816259,Texas
8427,2011,Newton,male,3452,3932,3916,7848,0.8779247202441506,Texas
8428,2011,Newton,male,3452,50598,55899,106497,0.06822404047590813,Texas
8429,2011,Newton,male,3452,7004,7014,14018,0.49286122215876643,Texas
8430,2011,Newton,male,3452,10142,11382,21524,0.3403667915598501,Texas
8431,2011,Newton,male,3452,28964,29238,58202,0.11918243336555724,Texas
8432,2011,Newton,male,3452,7233,6824,14057,0.47725701645237106,Texas
8439,2012,Newton,male,3616,3932,3916,7848,0.9196337741607324,Texas
8440,2012,Newton,male,3616,50598,55899,106497,0.0714652753073244,Texas
8441,2012,Newton,male,3616,7004,7014,14018,0.5162764134780126,Texas
8442,2012,Newton,male,3616,10142,11382,21524,0.35653717215539343,Texas
8443,2012,Newton,male,3616,28964,29238,58202,0.12484463471896147,Texas
8444,2012,Newton,male,3616,7233,6824,14057,0.4999308723904327,Texas
8451,2013,Newton,male,3857,3932,3916,7848,0.9809257375381485,Texas
8452,2013,Newton,male,3857,50598,55899,106497,0.07622830941934464,Texas
8453,2013,Newton,male,3857,7004,7014,14018,0.5506853226727584,Texas
8454,2013,Newton,male,3857,10142,11382,21524,0.3802997436403076,Texas
8455,2013,Newton,male,3857,28964,29238,58202,0.13316530865902498,Texas
8456,2013,Newton,male,3857,7233,6824,14057,0.5332503802018527,Texas
8463,2014,Newton,male,2666,3932,3916,7848,0.6780264496439471,Texas
8464,2014,Newton,male,2666,50598,55899,106497,0.05268982963753508,Texas
8465,2014,Newton,male,2666,7004,7014,14018,0.38063963449457455,Texas
8466,2014,Newton,male,2666,10142,11382,21524,0.2628672845592585,Texas
8467,2014,Newton,male,2666,28964,29238,58202,0.09204529761082723,Texas
8468,2014,Newton,male,2666,7233,6824,14057,0.36858841421263655,Texas
8475,2015,Newton,male,2973,3932,3916,7848,0.7561037639877924,Texas
8476,2015,Newton,male,2973,50598,55899,106497,0.05875726313293016,Texas
8477,2015,Newton,male,2973,7004,7014,14018,0.42447173043974873,Texas
8478,2015,Newton,male,2973,10142,11382,21524,0.2931374482350621,Texas
8479,2015,Newton,male,2973,28964,29238,58202,0.10264466233945588,Texas
8480,2015,Newton,male,2973,7233,6824,14057,0.4110327664869349,Texas
8487,2016,Newton,male,2183,3932,3916,7848,0.5551881993896236,Texas
8488,2016,Newton,male,2183,50598,55899,106497,0.04314399778647377,Texas
8489,2016,Newton,male,2183,7004,7014,14018,0.3116790405482581,Texas
8490,2016,Newton,male,2183,10142,11382,21524,0.21524354170774995,Texas
8491,2016,Newton,male,2183,28964,29238,58202,0.07536942411269161,Texas
8492,2016,Newton,male,2183,7233,6824,14057,0.3018111433706622,Texas
8494,2009,Nolan,male,9377,7669,7297,14966,1.2227148259225453,Texas
8496,2010,Nolan,male,10549,7669,7297,14966,1.3755378797757205,Texas
8498,2011,Nolan,male,9172,7669,7297,14966,1.195983831007954,Texas
8500,2012,Nolan,male,7414,7669,7297,14966,0.9667492502281915,Texas
8502,2013,Nolan,male,5522,7669,7297,14966,0.7200417264310862,Texas
8504,2014,Nolan,male,5099,7669,7297,14966,0.6648846003390273,Texas
8506,2015,Nolan,male,4044,7669,7297,14966,0.5273177728517408,Texas
8508,2016,Nolan,male,7690,7669,7297,14966,1.0027382970400314,Texas
8510,2009,Nueces,male,11356,178020,182466,360486,0.0637905853274913,Texas
8512,2010,Nueces,male,11919,178020,182466,360486,0.06695315133131109,Texas
8514,2011,Nueces,male,10792,178020,182466,360486,0.06062240197730592,Texas
8516,2012,Nueces,male,12210,178020,182466,360486,0.06858779912369396,Texas
8518,2013,Nueces,male,11562,178020,182466,360486,0.06494775867880014,Texas
8520,2014,Nueces,male,7807,178020,182466,360486,0.04385462307605887,Texas
8522,2015,Nueces,male,6721,178020,182466,360486,0.037754184923042354,Texas
8524,2016,Nueces,male,6069,178020,182466,360486,0.034091675092686215,Texas
8526,2009,Ochiltree,male,1974,5230,5118,10348,0.37743785850860423,Texas
8528,2010,Ochiltree,male,1546,5230,5118,10348,0.2956022944550669,Texas
8530,2011,Ochiltree,male,2535,5230,5118,10348,0.4847036328871893,Texas
8532,2012,Ochiltree,male,1466,5230,5118,10348,0.28030592734225623,Texas
8534,2013,Ochiltree,male,2160,5230,5118,10348,0.4130019120458891,Texas
8536,2014,Ochiltree,male,1386,5230,5118,10348,0.2650095602294455,Texas
8538,2015,Ochiltree,male,602,5230,5118,10348,0.11510516252390057,Texas
8540,2016,Ochiltree,male,522,5230,5118,10348,0.09980879541108986,Texas
8543,2009,Oldham,male,4361,34328,31046,65374,0.12703915171288743,Texas
8544,2009,Oldham,male,4361,1145,945,2090,3.8087336244541485,Texas
8547,2010,Oldham,male,5453,34328,31046,65374,0.15884991843393148,Texas
8548,2010,Oldham,male,5453,1145,945,2090,4.7624454148471616,Texas
8551,2011,Oldham,male,5913,34328,31046,65374,0.17225005826147752,Texas
8552,2011,Oldham,male,5913,1145,945,2090,5.164192139737991,Texas
8555,2012,Oldham,male,5147,34328,31046,65374,0.14993591237473783,Texas
8556,2012,Oldham,male,5147,1145,945,2090,4.495196506550219,Texas
8559,2013,Oldham,male,3890,34328,31046,65374,0.11331857375903052,Texas
8560,2013,Oldham,male,3890,1145,945,2090,3.3973799126637556,Texas
8563,2014,Oldham,male,3123,34328,31046,65374,0.0909752971335353,Texas
8564,2014,Oldham,male,3123,1145,945,2090,2.7275109170305676,Texas
8567,2015,Oldham,male,3040,34328,31046,65374,0.08855744581682591,Texas
8568,2015,Oldham,male,3040,1145,945,2090,2.6550218340611353,Texas
8571,2016,Oldham,male,3042,34328,31046,65374,0.08861570729433699,Texas
8572,2016,Oldham,male,3042,1145,945,2090,2.656768558951965,Texas
8581,2009,Orange,male,10119,1562429,1601753,3164182,0.006476454290082942,Texas
8582,2009,Orange,male,10119,648446,672748,1321194,0.015605000262165238,Texas
8583,2009,Orange,male,10119,9727,9820,19547,1.0403001953325794,Texas
8584,2009,Orange,male,10119,189484,188743,378227,0.053402925840704225,Texas
8585,2009,Orange,male,10119,68187,74751,142938,0.14840072154516257,Texas
8586,2009,Orange,male,10119,41630,42417,84047,0.24306990151333174,Texas
8587,2009,Orange,male,10119,14357,14580,28937,0.7048129832137633,Texas
8588,2009,Orange,male,10119,17418,18194,35612,0.5809507406131588,Texas
8597,2010,Orange,male,11215,1562429,1601753,3164182,0.007177926164964936,Texas
8598,2010,Orange,male,11215,648446,672748,1321194,0.01729519497382974,Texas
8599,2010,Orange,male,11215,9727,9820,19547,1.1529762516706077,Texas
8600,2010,Orange,male,11215,189484,188743,378227,0.05918705537142978,Texas
8601,2010,Orange,male,11215,68187,74751,142938,0.16447416663000278,Texas
8602,2010,Orange,male,11215,41630,42417,84047,0.26939706942109054,Texas
8603,2010,Orange,male,11215,14357,14580,28937,0.7811520512641917,Texas
8604,2010,Orange,male,11215,17418,18194,35612,0.6438741531748766,Texas
8613,2011,Orange,male,9150,1562429,1601753,3164182,0.005856266108731981,Texas
8614,2011,Orange,male,9150,648446,672748,1321194,0.01411065840486332,Texas
8615,2011,Orange,male,9150,9727,9820,19547,0.9406805798293411,Texas
8616,2011,Orange,male,9150,189484,188743,378227,0.04828903759684195,Texas
8617,2011,Orange,male,9150,68187,74751,142938,0.1341898015750803,Texas
8618,2011,Orange,male,9150,41630,42417,84047,0.21979341820802306,Texas
8619,2011,Orange,male,9150,14357,14580,28937,0.6373197743261126,Texas
8620,2011,Orange,male,9150,17418,18194,35612,0.5253186358939028,Texas
8629,2012,Orange,male,10315,1562429,1601753,3164182,0.006601899990335561,Texas
8630,2012,Orange,male,10315,648446,672748,1321194,0.015907261360236628,Texas
8631,2012,Orange,male,10315,9727,9820,19547,1.060450292998869,Texas
8632,2012,Orange,male,10315,189484,188743,378227,0.054437313968461715,Texas
8633,2012,Orange,male,10315,68187,74751,142938,0.15127516975376537,Texas
8634,2012,Orange,male,10315,41630,42417,84047,0.2477780446793178,Texas
8635,2012,Orange,male,10315,14357,14580,28937,0.7184648603468691,Texas
8636,2012,Orange,male,10315,17418,18194,35612,0.5922034676771156,Texas
8645,2013,Orange,male,8736,1562429,1601753,3164182,0.005591294068402468,Texas
8646,2013,Orange,male,8736,648446,672748,1321194,0.013472208942610487,Texas
8647,2013,Orange,male,8736,9727,9820,19547,0.8981186388403413,Texas
8648,2013,Orange,male,8736,189484,188743,378227,0.04610415655147664,Texas
8649,2013,Orange,male,8736,68187,74751,142938,0.1281182630120111,Texas
8650,2013,Orange,male,8736,41630,42417,84047,0.20984866682680758,Texas
8651,2013,Orange,male,8736,14357,14580,28937,0.6084836665041443,Texas
8652,2013,Orange,male,8736,17418,18194,35612,0.5015501205649329,Texas
8661,2014,Orange,male,8313,1562429,1601753,3164182,0.0053205617663266615,Texas
8662,2014,Orange,male,8313,648446,672748,1321194,0.012819880144221724,Texas
8663,2014,Orange,male,8313,9727,9820,19547,0.8546314382646243,Texas
8664,2014,Orange,male,8313,189484,188743,378227,0.043871778092081655,Texas
8665,2014,Orange,male,8313,68187,74751,142938,0.1219147344801795,Texas
8666,2014,Orange,male,8313,41630,42417,84047,0.1996877251981744,Texas
8667,2014,Orange,male,8313,14357,14580,28937,0.5790206867730027,Texas
8668,2014,Orange,male,8313,17418,18194,35612,0.4772648983809852,Texas
8677,2015,Orange,male,8833,1562429,1601753,3164182,0.005653376889445856,Texas
8678,2015,Orange,male,8833,648446,672748,1321194,0.013621797343186633,Texas
8679,2015,Orange,male,8833,9727,9820,19547,0.9080908810527398,Texas
8680,2015,Orange,male,8833,189484,188743,378227,0.04661607312490764,Texas
8681,2015,Orange,male,8833,68187,74751,142938,0.12954082156422778,Texas
8682,2015,Orange,male,8833,41630,42417,84047,0.21217871727119866,Texas
8683,2015,Orange,male,8833,14357,14580,28937,0.6152399526363447,Texas
8684,2015,Orange,male,8833,17418,18194,35612,0.507119072224136,Texas
8693,2016,Orange,male,5812,1562429,1601753,3164182,0.0037198490299399207,Texas
8694,2016,Orange,male,5812,648446,672748,1321194,0.008962966846892417,Texas
8695,2016,Orange,male,5812,9727,9820,19547,0.5975120797779377,Texas
8696,2016,Orange,male,5812,189484,188743,378227,0.030672774482278186,Texas
8697,2016,Orange,male,5812,68187,74751,142938,0.08523618871632423,Texas
8698,2016,Orange,male,5812,41630,42417,84047,0.13961085755464808,Texas
8699,2016,Orange,male,5812,14357,14580,28937,0.4048199484571986,Texas
8700,2016,Orange,male,5812,17418,18194,35612,0.3336778045699851,Texas
8702,2009,Palo Pinto,male,9305,13987,14330,28317,0.6652605991277615,Texas
8704,2010,Palo Pinto,male,8907,13987,14330,28317,0.6368056052048331,Texas
8706,2011,Palo Pinto,male,7008,13987,14330,28317,0.5010366769142776,Texas
8708,2012,Palo Pinto,male,7252,13987,14330,28317,0.5184814470579824,Texas
8710,2013,Palo Pinto,male,7022,13987,14330,28317,0.5020376063487524,Texas
8712,2014,Palo Pinto,male,5820,13987,14330,28317,0.4161006649031243,Texas
8714,2015,Palo Pinto,male,5436,13987,14330,28317,0.38864660041467075,Texas
8716,2016,Palo Pinto,male,5915,13987,14330,28317,0.42289268606563235,Texas
8719,2009,Panola,male,6435,16549,17694,34243,0.38884524744697563,Texas
8720,2009,Panola,male,6435,11498,11942,23440,0.5596625500086971,Texas
8723,2010,Panola,male,6171,16549,17694,34243,0.37289262191068945,Texas
8724,2010,Panola,male,6171,11498,11942,23440,0.5367020351365455,Texas
8727,2011,Panola,male,4644,16549,17694,34243,0.2806211855701251,Texas
8728,2011,Panola,male,4644,11498,11942,23440,0.4038963297964863,Texas
8731,2012,Panola,male,5714,16549,17694,34243,0.345277660281588,Texas
8732,2012,Panola,male,5714,11498,11942,23440,0.49695599234649507,Texas
8735,2013,Panola,male,6307,16549,17694,34243,0.38111064112635207,Texas
8736,2013,Panola,male,6307,11498,11942,23440,0.5485301791615933,Texas
8739,2014,Panola,male,4339,16549,17694,34243,0.26219106894676414,Texas
8740,2014,Panola,male,4339,11498,11942,23440,0.3773699773873717,Texas
8743,2015,Panola,male,4838,16549,17694,34243,0.29234394827482024,Texas
8744,2015,Panola,male,4838,11498,11942,23440,0.4207688293616281,Texas
8747,2016,Panola,male,5622,16549,17694,34243,0.3397184119886398,Texas
8748,2016,Panola,male,5622,11498,11942,23440,0.48895460080013914,Texas
8750,2009,Parker,male,19669,64448,65354,129802,0.3051917825223436,Texas
8752,2010,Parker,male,19770,64448,65354,129802,0.3067589374379345,Texas
8754,2011,Parker,male,19899,64448,65354,129802,0.30876055114200596,Texas
8756,2012,Parker,male,24397,64448,65354,129802,0.3785532522343595,Texas
8758,2013,Parker,male,18743,64448,65354,129802,0.2908236097318769,Texas
8760,2014,Parker,male,11800,64448,65354,129802,0.18309334657398213,Texas
8762,2015,Parker,male,11733,64448,65354,129802,0.18205374875868918,Texas
8764,2016,Parker,male,13349,64448,65354,129802,0.207128227408143,Texas
8766,2009,Parmer,male,3039,5059,4793,9852,0.6007116030836134,Texas
8768,2010,Parmer,male,2459,5059,4793,9852,0.4860644396125717,Texas
8770,2011,Parmer,male,1594,5059,4793,9852,0.31508203202213875,Texas
8772,2012,Parmer,male,1559,5059,4793,9852,0.30816366870923106,Texas
8774,2013,Parmer,male,2190,5059,4793,9852,0.43289187586479544,Texas
8776,2014,Parmer,male,2067,5059,4793,9852,0.40857877050800556,Texas
8778,2015,Parmer,male,1412,5059,4793,9852,0.2791065427950188,Texas
8780,2016,Parmer,male,2165,5059,4793,9852,0.42795018778414706,Texas
8782,2009,Pecos,male,11297,9010,6787,15797,1.2538290788013318,Texas
8784,2010,Pecos,male,10837,9010,6787,15797,1.2027746947835738,Texas
8786,2011,Pecos,male,8412,9010,6787,15797,0.9336293007769145,Texas
8788,2012,Pecos,male,8976,9010,6787,15797,0.9962264150943396,Texas
8790,2013,Pecos,male,6053,9010,6787,15797,0.6718091009988901,Texas
8792,2014,Pecos,male,7075,9010,6787,15797,0.7852386237513873,Texas
8794,2015,Pecos,male,11086,9010,6787,15797,1.230410654827969,Texas
8796,2016,Pecos,male,13748,9010,6787,15797,1.5258601553829079,Texas
8809,2009,Polk,male,7615,9828,10335,20163,0.7748270248270248,Texas
8810,2009,Polk,male,7615,327706,340965,668671,0.02323729196291798,Texas
8811,2009,Polk,male,7615,20415,21206,41621,0.37301004163605195,Texas
8812,2009,Polk,male,7615,233599,240675,474274,0.03259859845290434,Texas
8813,2009,Polk,male,7615,15967,15624,31591,0.4769211498716102,Texas
8814,2009,Polk,male,7615,15435,16114,31549,0.49335924846128926,Texas
8815,2009,Polk,male,7615,2540,2715,5255,2.998031496062992,Texas
8816,2009,Polk,male,7615,9682,10776,20458,0.7865110514356538,Texas
8817,2009,Polk,male,7615,39563,41864,81427,0.1924778201855269,Texas
8818,2009,Polk,male,7615,8369,8413,16782,0.9099056040148166,Texas
8819,2009,Polk,male,7615,25878,21959,47837,0.2942653991807713,Texas
8820,2009,Polk,male,7615,21842,21507,43349,0.34864023441076825,Texas
8833,2010,Polk,male,6474,9828,10335,20163,0.6587301587301587,Texas
8834,2010,Polk,male,6474,327706,340965,668671,0.019755512563090088,Texas
8835,2010,Polk,male,6474,20415,21206,41621,0.3171197648787656,Texas
8836,2010,Polk,male,6474,233599,240675,474274,0.027714159735272838,Texas
8837,2010,Polk,male,6474,15967,15624,31591,0.40546126385670445,Texas
8838,2010,Polk,male,6474,15435,16114,31549,0.4194363459669582,Texas
8839,2010,Polk,male,6474,2540,2715,5255,2.5488188976377955,Texas
8840,2010,Polk,male,6474,9682,10776,20458,0.6686634992770089,Texas
8841,2010,Polk,male,6474,39563,41864,81427,0.16363774233501,Texas
8842,2010,Polk,male,6474,8369,8413,16782,0.7735691241486438,Texas
8843,2010,Polk,male,6474,25878,21959,47837,0.2501738928819847,Texas
8844,2010,Polk,male,6474,21842,21507,43349,0.296401428440619,Texas
8857,2011,Polk,male,6656,9828,10335,20163,0.6772486772486772,Texas
8858,2011,Polk,male,6656,327706,340965,668671,0.02031088841827736,Texas
8859,2011,Polk,male,6656,20415,21206,41621,0.326034778349253,Texas
8860,2011,Polk,male,6656,233599,240675,474274,0.028493272659557617,Texas
8861,2011,Polk,male,6656,15967,15624,31591,0.41685977328239493,Texas
8862,2011,Polk,male,6656,15435,16114,31549,0.4312277291869129,Texas
8863,2011,Polk,male,6656,2540,2715,5255,2.620472440944882,Texas
8864,2011,Polk,male,6656,9682,10776,20458,0.687461268332989,Texas
8865,2011,Polk,male,6656,39563,41864,81427,0.16823800015165685,Texas
8866,2011,Polk,male,6656,8369,8413,16782,0.7953160473174812,Texas
8867,2011,Polk,male,6656,25878,21959,47837,0.25720689388669915,Texas
8868,2011,Polk,male,6656,21842,21507,43349,0.3047339987180661,Texas
8881,2012,Polk,male,5047,9828,10335,20163,0.5135327635327636,Texas
8882,2012,Polk,male,5047,327706,340965,668671,0.015400999676539337,Texas
8883,2012,Polk,male,5047,20415,21206,41621,0.24722018123928485,Texas
8884,2012,Polk,male,5047,233599,240675,474274,0.021605400708050976,Texas
8885,2012,Polk,male,5047,15967,15624,31591,0.3160894344585708,Texas
8886,2012,Polk,male,5047,15435,16114,31549,0.326984126984127,Texas
8887,2012,Polk,male,5047,2540,2715,5255,1.987007874015748,Texas
8888,2012,Polk,male,5047,9682,10776,20458,0.5212765957446809,Texas
8889,2012,Polk,male,5047,39563,41864,81427,0.12756868791547657,Texas
8890,2012,Polk,male,5047,8369,8413,16782,0.6030589078742981,Texas
8891,2012,Polk,male,5047,25878,21959,47837,0.195030527861504,Texas
8892,2012,Polk,male,5047,21842,21507,43349,0.23106858346305284,Texas
8905,2013,Polk,male,4814,9828,10335,20163,0.48982498982498984,Texas
8906,2013,Polk,male,4814,327706,340965,668671,0.014689996521272116,Texas
8907,2013,Polk,male,4814,20415,21206,41621,0.2358070046534411,Texas
8908,2013,Polk,male,4814,233599,240675,474274,0.020607964931356727,Texas
8909,2013,Polk,male,4814,15967,15624,31591,0.3014968372267802,Texas
8910,2013,Polk,male,4814,15435,16114,31549,0.31188856494978945,Texas
8911,2013,Polk,male,4814,2540,2715,5255,1.895275590551181,Texas
8912,2013,Polk,male,4814,9682,10776,20458,0.49721131997521173,Texas
8913,2013,Polk,male,4814,39563,41864,81427,0.12167934686449461,Texas
8914,2013,Polk,male,4814,8369,8413,16782,0.5752180666746326,Texas
8915,2013,Polk,male,4814,25878,21959,47837,0.186026740860963,Texas
8916,2013,Polk,male,4814,21842,21507,43349,0.2204010621737936,Texas
8929,2014,Polk,male,4222,9828,10335,20163,0.4295889295889296,Texas
8930,2014,Polk,male,4222,327706,340965,668671,0.012883499234069562,Texas
8931,2014,Polk,male,4222,20415,21206,41621,0.2068087190791085,Texas
8932,2014,Polk,male,4222,233599,240675,474274,0.018073707507309536,Texas
8933,2014,Polk,male,4222,15967,15624,31591,0.2644203670069518,Texas
8934,2014,Polk,male,4222,15435,16114,31549,0.2735341755749919,Texas
8935,2014,Polk,male,4222,2540,2715,5255,1.6622047244094489,Texas
8936,2014,Polk,male,4222,9682,10776,20458,0.4360669283205949,Texas
8937,2014,Polk,male,4222,39563,41864,81427,0.10671587088946743,Texas
8938,2014,Polk,male,4222,8369,8413,16782,0.5044808220814913,Texas
8939,2014,Polk,male,4222,25878,21959,47837,0.16315016616430944,Texas
8940,2014,Polk,male,4222,21842,21507,43349,0.19329731709550407,Texas
8953,2015,Polk,male,5750,9828,10335,20163,0.585063085063085,Texas
8954,2015,Polk,male,5750,327706,340965,668671,0.01754621520509237,Texas
8955,2015,Polk,male,5750,20415,21206,41621,0.2816556453588048,Texas
8956,2015,Polk,male,5750,233599,240675,474274,0.024614831399107015,Texas
8957,2015,Polk,male,5750,15967,15624,31591,0.360117742844617,Texas
8958,2015,Polk,male,5750,15435,16114,31549,0.37252996436669905,Texas
8959,2015,Polk,male,5750,2540,2715,5255,2.263779527559055,Texas
8960,2015,Polk,male,5750,9682,10776,20458,0.5938855608345384,Texas
8961,2015,Polk,male,5750,39563,41864,81427,0.14533781563582135,Texas
8962,2015,Polk,male,5750,8369,8413,16782,0.6870593858286533,Texas
8963,2015,Polk,male,5750,25878,21959,47837,0.22219646031378004,Texas
8964,2015,Polk,male,5750,21842,21507,43349,0.26325428074352164,Texas
8977,2016,Polk,male,4408,9828,10335,20163,0.4485144485144485,Texas
8978,2016,Polk,male,4408,327706,340965,668671,0.013451081152008203,Texas
8979,2016,Polk,male,4408,20415,21206,41621,0.21591966691158462,Texas
8980,2016,Polk,male,4408,233599,240675,474274,0.018869943792567605,Texas
8981,2016,Polk,male,4408,15967,15624,31591,0.27606939312331685,Texas
8982,2016,Polk,male,4408,15435,16114,31549,0.285584710074506,Texas
8983,2016,Polk,male,4408,2540,2715,5255,1.7354330708661416,Texas
8984,2016,Polk,male,4408,9682,10776,20458,0.4552778351580252,Texas
8985,2016,Polk,male,4408,39563,41864,81427,0.11141723327351313,Texas
8986,2016,Polk,male,4408,8369,8413,16782,0.5267056996056877,Texas
8987,2016,Polk,male,4408,25878,21959,47837,0.17033773861967694,Texas
8988,2016,Polk,male,4408,21842,21507,43349,0.20181302078564234,Texas
8992,2009,Potter,male,9472,8475,8462,16937,1.1176401179941002,Texas
8993,2009,Potter,male,9472,1179,1147,2326,8.033927056827821,Texas
8994,2009,Potter,male,9472,62295,58604,120899,0.15205072638253472,Texas
8998,2010,Potter,male,9678,8475,8462,16937,1.1419469026548672,Texas
8999,2010,Potter,male,9678,1179,1147,2326,8.208651399491094,Texas
9000,2010,Potter,male,9678,62295,58604,120899,0.15535757283891163,Texas
9004,2011,Potter,male,7805,8475,8462,16937,0.9209439528023599,Texas
9005,2011,Potter,male,7805,1179,1147,2326,6.620016963528414,Texas
9006,2011,Potter,male,7805,62295,58604,120899,0.12529095433020307,Texas
9010,2012,Potter,male,7883,8475,8462,16937,0.9301474926253688,Texas
9011,2012,Potter,male,7883,1179,1147,2326,6.6861747243426635,Texas
9012,2012,Potter,male,7883,62295,58604,120899,0.12654306124087006,Texas
9016,2013,Potter,male,7946,8475,8462,16937,0.9375811209439529,Texas
9017,2013,Potter,male,7946,1179,1147,2326,6.73960983884648,Texas
9018,2013,Potter,male,7946,62295,58604,120899,0.12755437836102415,Texas
9022,2014,Potter,male,6957,8475,8462,16937,0.8208849557522124,Texas
9023,2014,Potter,male,6957,1179,1147,2326,5.900763358778626,Texas
9024,2014,Potter,male,6957,62295,58604,120899,0.11167830483987479,Texas
9028,2015,Potter,male,6266,8475,8462,16937,0.7393510324483776,Texas
9029,2015,Potter,male,6266,1179,1147,2326,5.314673452078032,Texas
9030,2015,Potter,male,6266,62295,58604,120899,0.10058592182358135,Texas
9034,2016,Potter,male,5578,8475,8462,16937,0.6581710914454277,Texas
9035,2016,Potter,male,5578,1179,1147,2326,4.731128074639525,Texas
9036,2016,Potter,male,5578,62295,58604,120899,0.08954169676539048,Texas
9038,2009,Presidio,male,8316,3497,3626,7123,2.378038318558765,Texas
9040,2010,Presidio,male,5856,3497,3626,7123,1.674578209894195,Texas
9042,2011,Presidio,male,4430,3497,3626,7123,1.2668001143837575,Texas
9044,2012,Presidio,male,4340,3497,3626,7123,1.2410637689448099,Texas
9046,2013,Presidio,male,2935,3497,3626,7123,0.8392908207034601,Texas
9048,2014,Presidio,male,4443,3497,3626,7123,1.2705175865027165,Texas
9050,2015,Presidio,male,4785,3497,3626,7123,1.3683156991707177,Texas
9052,2016,Presidio,male,5089,3497,3626,7123,1.4552473548756077,Texas
9054,2009,Rains,male,2566,5868,5605,11473,0.4372869802317655,Texas
9056,2010,Rains,male,2698,5868,5605,11473,0.4597818677573279,Texas
9058,2011,Rains,male,3111,5868,5605,11473,0.5301635991820041,Texas
9060,2012,Rains,male,2268,5868,5605,11473,0.38650306748466257,Texas
9062,2013,Rains,male,1814,5868,5605,11473,0.30913428766189505,Texas
9064,2014,Rains,male,1301,5868,5605,11473,0.22171097477845944,Texas
9066,2015,Rains,male,1012,5868,5605,11473,0.17246080436264485,Texas
9068,2016,Rains,male,1460,5868,5605,11473,0.24880708929788684,Texas
9070,2009,Randall,male,8621,65083,67392,132475,0.13246162592382035,Texas
9072,2010,Randall,male,9795,65083,67392,132475,0.15050013060246148,Texas
9074,2011,Randall,male,11306,65083,67392,132475,0.17371663875359156,Texas
9076,2012,Randall,male,10250,65083,67392,132475,0.15749120354009497,Texas
9078,2013,Randall,male,9822,65083,67392,132475,0.15091498548007928,Texas
9080,2014,Randall,male,7889,65083,67392,132475,0.12121444924173748,Texas
9082,2015,Randall,male,7722,65083,67392,132475,0.11864849499869398,Texas
9084,2016,Randall,male,9035,65083,67392,132475,0.13882273404729345,Texas
9086,2009,Reagan,male,1010,1951,1801,3752,0.5176832393644285,Texas
9088,2010,Reagan,male,1742,1951,1801,3752,0.8928754484879549,Texas
9090,2011,Reagan,male,1934,1951,1801,3752,0.99128651973347,Texas
9092,2012,Reagan,male,1628,1951,1801,3752,0.8344438749359303,Texas
9094,2013,Reagan,male,1520,1951,1801,3752,0.779087647360328,Texas
9096,2014,Reagan,male,1572,1951,1801,3752,0.805740645822655,Texas
9098,2015,Reagan,male,942,1951,1801,3752,0.48282931829830855,Texas
9100,2016,Reagan,male,725,1951,1801,3752,0.371604305484367,Texas
9102,2009,Real,male,1206,1426,1963,3389,0.8457223001402524,Texas
9104,2010,Real,male,994,1426,1963,3389,0.697054698457223,Texas
9106,2011,Real,male,836,1426,1963,3389,0.5862552594670407,Texas
9108,2012,Real,male,939,1426,1963,3389,0.6584852734922861,Texas
9110,2013,Real,male,612,1426,1963,3389,0.42917251051893407,Texas
9112,2014,Real,male,469,1426,1963,3389,0.3288920056100982,Texas
9114,2015,Real,male,376,1426,1963,3389,0.26367461430575034,Texas
9116,2016,Real,male,387,1426,1963,3389,0.2713884992987377,Texas
9119,2009,Red River,male,2886,4067,4551,8618,0.709613966068355,Texas
9120,2009,Red River,male,2886,5986,6289,12275,0.48212495823588375,Texas
9123,2010,Red River,male,2968,4067,4551,8618,0.729776247848537,Texas
9124,2010,Red River,male,2968,5986,6289,12275,0.49582358837287005,Texas
9127,2011,Red River,male,2591,4067,4551,8618,0.6370789279567248,Texas
9128,2011,Red River,male,2591,5986,6289,12275,0.4328433010357501,Texas
9131,2012,Red River,male,2587,4067,4551,8618,0.6360954020162282,Texas
9132,2012,Red River,male,2587,5986,6289,12275,0.43217507517540926,Texas
9135,2013,Red River,male,2577,4067,4551,8618,0.6336365871649865,Texas
9136,2013,Red River,male,2577,5986,6289,12275,0.4305045105245573,Texas
9139,2014,Red River,male,1911,4067,4551,8618,0.46987951807228917,Texas
9140,2014,Red River,male,1911,5986,6289,12275,0.3192449047778149,Texas
9143,2015,Red River,male,1164,4067,4551,8618,0.28620604868453403,Texas
9144,2015,Red River,male,1164,5986,6289,12275,0.1944537253591714,Texas
9147,2016,Red River,male,1251,4067,4551,8618,0.30759773789033684,Texas
9148,2016,Red River,male,1251,5986,6289,12275,0.2089876378215837,Texas
9150,2009,Reeves,male,5373,8689,6436,15125,0.618368051559443,Texas
9152,2010,Reeves,male,4863,8689,6436,15125,0.5596731499597192,Texas
9154,2011,Reeves,male,3680,8689,6436,15125,0.4235239958568305,Texas
9156,2012,Reeves,male,2383,8689,6436,15125,0.2742548049257682,Texas
9158,2013,Reeves,male,2025,8689,6436,15125,0.23305328576360917,Texas
9160,2014,Reeves,male,3716,8689,6436,15125,0.42766716538151683,Texas
9162,2015,Reeves,male,2047,8689,6436,15125,0.23558522269536195,Texas
9164,2016,Reeves,male,6060,8689,6436,15125,0.6974335366555415,Texas
9166,2009,Refugio,male,8350,3586,3650,7236,2.328499721137758,Texas
9168,2010,Refugio,male,8047,3586,3650,7236,2.244004461795873,Texas
9170,2011,Refugio,male,6794,3586,3650,7236,1.8945900725041829,Texas
9172,2012,Refugio,male,3737,3586,3650,7236,1.0421081985499163,Texas
9174,2013,Refugio,male,3777,3586,3650,7236,1.0532626882320133,Texas
9176,2014,Refugio,male,2795,3586,3650,7236,0.779419966536531,Texas
9178,2015,Refugio,male,2626,3586,3650,7236,0.7322922476296709,Texas
9180,2016,Refugio,male,2204,3586,3650,7236,0.6146123814835471,Texas
9183,2009,Roberts,male,348,5290,4995,10285,0.06578449905482042,Texas
9184,2009,Roberts,male,348,401,484,885,0.8678304239401496,Texas
9187,2010,Roberts,male,690,5290,4995,10285,0.13043478260869565,Texas
9188,2010,Roberts,male,690,401,484,885,1.7206982543640899,Texas
9191,2011,Roberts,male,733,5290,4995,10285,0.1385633270321361,Texas
9192,2011,Roberts,male,733,401,484,885,1.827930174563591,Texas
9195,2012,Roberts,male,642,5290,4995,10285,0.12136105860113422,Texas
9196,2012,Roberts,male,642,401,484,885,1.600997506234414,Texas
9199,2013,Roberts,male,762,5290,4995,10285,0.1440453686200378,Texas
9200,2013,Roberts,male,762,401,484,885,1.9002493765586035,Texas
9203,2014,Roberts,male,914,5290,4995,10285,0.1727788279773157,Texas
9204,2014,Roberts,male,914,401,484,885,2.27930174563591,Texas
9207,2015,Roberts,male,611,5290,4995,10285,0.11550094517958412,Texas
9208,2015,Roberts,male,611,401,484,885,1.5236907730673317,Texas
9211,2016,Roberts,male,329,5290,4995,10285,0.06219281663516068,Texas
9212,2016,Roberts,male,329,401,484,885,0.8204488778054863,Texas
9216,2009,Robertson,male,4255,1147,996,2143,3.7096774193548385,Texas
9217,2009,Robertson,male,4255,34287,35057,69344,0.12409951293493161,Texas
9218,2009,Robertson,male,4255,8296,8594,16890,0.5128977820636451,Texas
9222,2010,Robertson,male,4361,1147,996,2143,3.802092414995641,Texas
9223,2010,Robertson,male,4361,34287,35057,69344,0.12719106366844576,Texas
9224,2010,Robertson,male,4361,8296,8594,16890,0.5256750241080038,Texas
9228,2011,Robertson,male,4771,1147,996,2143,4.159546643417611,Texas
9229,2011,Robertson,male,4771,34287,35057,69344,0.1391489485810949,Texas
9230,2011,Robertson,male,4771,8296,8594,16890,0.5750964320154291,Texas
9234,2012,Robertson,male,3202,1147,996,2143,2.791630340017437,Texas
9235,2012,Robertson,male,3202,34287,35057,69344,0.09338816461049378,Texas
9236,2012,Robertson,male,3202,8296,8594,16890,0.3859691417550627,Texas
9240,2013,Robertson,male,3069,1147,996,2143,2.675675675675676,Texas
9241,2013,Robertson,male,3069,34287,35057,69344,0.08950914340712224,Texas
9242,2013,Robertson,male,3069,8296,8594,16890,0.3699373191899711,Texas
9246,2014,Robertson,male,2599,1147,996,2143,2.265911072362685,Texas
9247,2014,Robertson,male,2599,34287,35057,69344,0.07580132411701228,Texas
9248,2014,Robertson,male,2599,8296,8594,16890,0.3132835101253616,Texas
9252,2015,Robertson,male,3031,1147,996,2143,2.6425457715780296,Texas
9253,2015,Robertson,male,3031,34287,35057,69344,0.08840085163473037,Texas
9254,2015,Robertson,male,3031,8296,8594,16890,0.36535679845708774,Texas
9258,2016,Robertson,male,3486,1147,996,2143,3.039232781168265,Texas
9259,2016,Robertson,male,3486,34287,35057,69344,0.1016711873304751,Texas
9260,2016,Robertson,male,3486,8296,8594,16890,0.42020250723240116,Texas
9262,2009,Rockwall,male,9851,46167,47475,93642,0.21337752073992244,Texas
9264,2010,Rockwall,male,7691,46167,47475,93642,0.16659085493967551,Texas
9266,2011,Rockwall,male,4539,46167,47475,93642,0.09831697966079667,Texas
9268,2012,Rockwall,male,4470,46167,47475,93642,0.09682240561439989,Texas
9270,2013,Rockwall,male,3421,46167,47475,93642,0.07410054801048369,Texas
9272,2014,Rockwall,male,1962,46167,47475,93642,0.04249788810189096,Texas
9274,2015,Rockwall,male,1114,46167,47475,93642,0.024129789676608834,Texas
9276,2016,Rockwall,male,1152,46167,47475,93642,0.024952888426798363,Texas
9278,2009,Runnels,male,2858,5233,5077,10310,0.5461494362698261,Texas
9280,2010,Runnels,male,3716,5233,5077,10310,0.7101089241352952,Texas
9282,2011,Runnels,male,2125,5233,5077,10310,0.40607682017962926,Texas
9284,2012,Runnels,male,1656,5233,5077,10310,0.31645327727880757,Texas
9286,2013,Runnels,male,1982,5233,5077,10310,0.3787502388687177,Texas
9288,2014,Runnels,male,993,5233,5077,10310,0.18975730938276322,Texas
9290,2015,Runnels,male,943,5233,5077,10310,0.1802025606726543,Texas
9292,2016,Runnels,male,1201,5233,5077,10310,0.22950506401681636,Texas
9295,2009,Rusk,male,9855,28379,25216,53595,0.347263821840093,Texas
9296,2009,Rusk,male,9855,7109,7074,14183,1.3862709241806161,Texas
9299,2010,Rusk,male,10430,28379,25216,53595,0.36752528277952007,Texas
9300,2010,Rusk,male,10430,7109,7074,14183,1.4671543114362076,Texas
9303,2011,Rusk,male,10660,28379,25216,53595,0.3756298671552909,Texas
9304,2011,Rusk,male,10660,7109,7074,14183,1.4995076663384441,Texas
9307,2012,Rusk,male,8913,28379,25216,53595,0.31407026322280557,Texas
9308,2012,Rusk,male,8913,7109,7074,14183,1.2537628358418906,Texas
9311,2013,Rusk,male,6432,28379,25216,53595,0.22664646393459953,Texas
9312,2013,Rusk,male,6432,7109,7074,14183,0.9047686031790688,Texas
9315,2014,Rusk,male,6001,28379,25216,53595,0.21145917756087249,Texas
9316,2014,Rusk,male,6001,7109,7074,14183,0.8441412294274863,Texas
9319,2015,Rusk,male,5702,28379,25216,53595,0.2009232178723704,Texas
9320,2015,Rusk,male,5702,7109,7074,14183,0.8020818680545787,Texas
9323,2016,Rusk,male,5592,28379,25216,53595,0.19704711230134958,Texas
9324,2016,Rusk,male,5592,7109,7074,14183,0.786608524405683,Texas
9327,2009,Sabine,male,1184,11929,12159,24088,0.09925391902087351,Texas
9328,2009,Sabine,male,1184,5072,5386,10458,0.2334384858044164,Texas
9331,2010,Sabine,male,869,11929,12159,24088,0.0728476821192053,Texas
9332,2010,Sabine,male,869,5072,5386,10458,0.1713328075709779,Texas
9335,2011,Sabine,male,337,11929,12159,24088,0.02825048201861011,Texas
9336,2011,Sabine,male,337,5072,5386,10458,0.06644321766561515,Texas
9339,2012,Sabine,male,1365,11929,12159,24088,0.11442702657389554,Texas
9340,2012,Sabine,male,1365,5072,5386,10458,0.26912460567823343,Texas
9343,2013,Sabine,male,2472,11929,12159,24088,0.20722608768547238,Texas
9344,2013,Sabine,male,2472,5072,5386,10458,0.48738170347003157,Texas
9347,2014,Sabine,male,2094,11929,12159,24088,0.17553860340347052,Texas
9348,2014,Sabine,male,2094,5072,5386,10458,0.41285488958990535,Texas
9351,2015,Sabine,male,1620,11929,12159,24088,0.1358035040657222,Texas
9352,2015,Sabine,male,1620,5072,5386,10458,0.3194006309148265,Texas
9355,2016,Sabine,male,1772,11929,12159,24088,0.14854556123732082,Texas
9356,2016,Sabine,male,1772,5072,5386,10458,0.34936908517350157,Texas
9358,2009,San Augustine,male,1225,4085,4242,8327,0.2998776009791922,Texas
9360,2010,San Augustine,male,1300,4085,4242,8327,0.3182374541003672,Texas
9362,2011,San Augustine,male,1227,4085,4242,8327,0.3003671970624235,Texas
9364,2012,San Augustine,male,808,4085,4242,8327,0.197796817625459,Texas
9366,2013,San Augustine,male,1187,4085,4242,8327,0.2905752753977968,Texas
9368,2014,San Augustine,male,870,4085,4242,8327,0.21297429620563035,Texas
9370,2015,San Augustine,male,884,4085,4242,8327,0.2164014687882497,Texas
9372,2016,San Augustine,male,758,4085,4242,8327,0.18555691554467565,Texas
9374,2009,San Jacinto,male,4988,13718,14101,27819,0.363609855664091,Texas
9376,2010,San Jacinto,male,8232,13718,14101,27819,0.6000874763084998,Texas
9378,2011,San Jacinto,male,9342,13718,14101,27819,0.6810030616707975,Texas
9380,2012,San Jacinto,male,8986,13718,14101,27819,0.6550517568158624,Texas
9382,2013,San Jacinto,male,7809,13718,14101,27819,0.5692520775623269,Texas
9384,2014,San Jacinto,male,6989,13718,14101,27819,0.5094766000874763,Texas
9386,2015,San Jacinto,male,5236,13718,14101,27819,0.38168829275404575,Texas
9388,2016,San Jacinto,male,5062,13718,14101,27819,0.3690042280215775,Texas
9390,2009,San Patricio,male,14395,33721,33325,67046,0.4268853236855372,Texas
9392,2010,San Patricio,male,10896,33721,33325,67046,0.3231220900922274,Texas
9394,2011,San Patricio,male,13431,33721,33325,67046,0.39829779662524833,Texas
9396,2012,San Patricio,male,9314,33721,33325,67046,0.27620770439785297,Texas
9398,2013,San Patricio,male,10974,33721,33325,67046,0.3254351887547819,Texas
9400,2014,San Patricio,male,7972,33721,33325,67046,0.23641054535749237,Texas
9402,2015,San Patricio,male,6974,33721,33325,67046,0.20681474452121823,Texas
9404,2016,San Patricio,male,8681,33721,33325,67046,0.25743601909789154,Texas
9406,2009,San Saba,male,1127,3073,2889,5962,0.36674259681093396,Texas
9408,2010,San Saba,male,1259,3073,2889,5962,0.4096973641392776,Texas
9410,2011,San Saba,male,1213,3073,2889,5962,0.39472827855515785,Texas
9412,2012,San Saba,male,909,3073,2889,5962,0.29580214773836644,Texas
9414,2013,San Saba,male,350,3073,2889,5962,0.11389521640091116,Texas
9416,2014,San Saba,male,193,3073,2889,5962,0.06280507647250244,Texas
9418,2015,San Saba,male,430,3073,2889,5962,0.13992840872111942,Texas
9420,2016,San Saba,male,438,3073,2889,5962,0.14253172795314026,Texas
9422,2009,Schleicher,male,325,1542,1519,3061,0.21076523994811933,Texas
9424,2010,Schleicher,male,1055,1542,1519,3061,0.6841763942931258,Texas
9426,2011,Schleicher,male,1237,1542,1519,3061,0.8022049286640727,Texas
9428,2012,Schleicher,male,1036,1542,1519,3061,0.6718547341115434,Texas
9430,2013,Schleicher,male,779,1542,1519,3061,0.5051880674448768,Texas
9432,2014,Schleicher,male,370,1542,1519,3061,0.23994811932555124,Texas
9434,2015,Schleicher,male,236,1542,1519,3061,0.15304798962386512,Texas
9436,2016,Schleicher,male,615,1542,1519,3061,0.39883268482490275,Texas
9438,2009,Scurry,male,5407,9425,7814,17239,0.5736870026525199,Texas
9440,2010,Scurry,male,6562,9425,7814,17239,0.6962334217506632,Texas
9442,2011,Scurry,male,5691,9425,7814,17239,0.6038196286472148,Texas
9444,2012,Scurry,male,4696,9425,7814,17239,0.49824933687002654,Texas
9446,2013,Scurry,male,3433,9425,7814,17239,0.36424403183023873,Texas
9448,2014,Scurry,male,2760,9425,7814,17239,0.2928381962864722,Texas
9450,2015,Scurry,male,2038,9425,7814,17239,0.21623342175066312,Texas
9452,2016,Scurry,male,2673,9425,7814,17239,0.2836074270557029,Texas
9454,2009,Shackelford,male,2143,1770,1541,3311,1.2107344632768362,Texas
9456,2010,Shackelford,male,2005,1770,1541,3311,1.1327683615819208,Texas
9458,2011,Shackelford,male,1451,1770,1541,3311,0.8197740112994351,Texas
9460,2012,Shackelford,male,1740,1770,1541,3311,0.9830508474576272,Texas
9462,2013,Shackelford,male,1392,1770,1541,3311,0.7864406779661017,Texas
9464,2014,Shackelford,male,960,1770,1541,3311,0.5423728813559322,Texas
9466,2015,Shackelford,male,617,1770,1541,3311,0.34858757062146895,Texas
9468,2016,Shackelford,male,980,1770,1541,3311,0.5536723163841808,Texas
9478,2009,Shelby,male,6707,102478,108783,211261,0.0654481937586604,Texas
9479,2009,Shelby,male,6707,10791,11041,21832,0.6215364655731628,Texas
9480,2009,Shelby,male,6707,21941,22458,44399,0.3056834237272686,Texas
9481,2009,Shelby,male,6707,5735,5959,11694,1.169485614646905,Texas
9482,2009,Shelby,male,6707,22613,24173,46786,0.2965993012868704,Texas
9483,2009,Shelby,male,6707,3047,3014,6061,2.2011814899901543,Texas
9484,2009,Shelby,male,6707,24657,24140,48797,0.2720120047045464,Texas
9485,2009,Shelby,male,6707,445994,491011,937005,0.015038318901151137,Texas
9486,2009,Shelby,male,6707,12572,12906,25478,0.5334871142220808,Texas
9496,2010,Shelby,male,6333,102478,108783,211261,0.06179862994984289,Texas
9497,2010,Shelby,male,6333,10791,11041,21832,0.586877953850431,Texas
9498,2010,Shelby,male,6333,21941,22458,44399,0.28863771022287044,Texas
9499,2010,Shelby,male,6333,5735,5959,11694,1.1042720139494333,Texas
9500,2010,Shelby,male,6333,22613,24173,46786,0.28006014239596694,Texas
9501,2010,Shelby,male,6333,3047,3014,6061,2.078437807679685,Texas
9502,2010,Shelby,male,6333,24657,24140,48797,0.25684389828446286,Texas
9503,2010,Shelby,male,6333,445994,491011,937005,0.014199742597434046,Texas
9504,2010,Shelby,male,6333,12572,12906,25478,0.503738466433344,Texas
9514,2011,Shelby,male,5786,102478,108783,211261,0.05646089892464724,Texas
9515,2011,Shelby,male,5786,10791,11041,21832,0.5361875637104995,Texas
9516,2011,Shelby,male,5786,21941,22458,44399,0.2637072148033362,Texas
9517,2011,Shelby,male,5786,5735,5959,11694,1.0088927637314735,Texas
9518,2011,Shelby,male,5786,22613,24173,46786,0.2558705169592712,Texas
9519,2011,Shelby,male,5786,3047,3014,6061,1.8989169675090252,Texas
9520,2011,Shelby,male,5786,24657,24140,48797,0.23465952873423368,Texas
9521,2011,Shelby,male,5786,445994,491011,937005,0.012973268698682046,Texas
9522,2011,Shelby,male,5786,12572,12906,25478,0.4602290804963411,Texas
9532,2012,Shelby,male,4616,102478,108783,211261,0.04504381428208981,Texas
9533,2012,Shelby,male,4616,10791,11041,21832,0.4277638773051617,Texas
9534,2012,Shelby,male,4616,21941,22458,44399,0.21038238913449706,Texas
9535,2012,Shelby,male,4616,5735,5959,11694,0.8048823016564952,Texas
9536,2012,Shelby,male,4616,22613,24173,46786,0.2041303674877283,Texas
9537,2012,Shelby,male,4616,3047,3014,6061,1.514932720708894,Texas
9538,2012,Shelby,male,4616,24657,24140,48797,0.18720850062862474,Texas
9539,2012,Shelby,male,4616,445994,491011,937005,0.010349915021278314,Texas
9540,2012,Shelby,male,4616,12572,12906,25478,0.3671651288577792,Texas
9550,2013,Shelby,male,5077,102478,108783,211261,0.049542340795097485,Texas
9551,2013,Shelby,male,5077,10791,11041,21832,0.4704846631452136,Texas
9552,2013,Shelby,male,5077,21941,22458,44399,0.2313932819835012,Texas
9553,2013,Shelby,male,5077,5735,5959,11694,0.8852659110723626,Texas
9554,2013,Shelby,male,5077,22613,24173,46786,0.22451687082651572,Texas
9555,2013,Shelby,male,5077,3047,3014,6061,1.6662290777814244,Texas
9556,2013,Shelby,male,5077,24657,24140,48797,0.20590501683092022,Texas
9557,2013,Shelby,male,5077,445994,491011,937005,0.011383561213827989,Texas
9558,2013,Shelby,male,5077,12572,12906,25478,0.4038339166401527,Texas
9568,2014,Shelby,male,4857,102478,108783,211261,0.047395538554616604,Texas
9569,2014,Shelby,male,4857,10791,11041,21832,0.4500973033083125,Texas
9570,2014,Shelby,male,4857,21941,22458,44399,0.22136639168679642,Texas
9571,2014,Shelby,male,4857,5735,5959,11694,0.8469049694856147,Texas
9572,2014,Shelby,male,4857,22613,24173,46786,0.21478795383186663,Texas
9573,2014,Shelby,male,4857,3047,3014,6061,1.5940269117164425,Texas
9574,2014,Shelby,male,4857,24657,24140,48797,0.1969826012896946,Texas
9575,2014,Shelby,male,4857,445994,491011,937005,0.010890281035170877,Texas
9576,2014,Shelby,male,4857,12572,12906,25478,0.3863347120585428,Texas
9586,2015,Shelby,male,3651,102478,108783,211261,0.035627158999980486,Texas
9587,2015,Shelby,male,3651,10791,11041,21832,0.33833750347511815,Texas
9588,2015,Shelby,male,3651,21941,22458,44399,0.16640080215122374,Texas
9589,2015,Shelby,male,3651,5735,5959,11694,0.6366172624237141,Texas
9590,2015,Shelby,male,3651,22613,24173,46786,0.1614557997611993,Texas
9591,2015,Shelby,male,3651,3047,3014,6061,1.1982277650147686,Texas
9592,2015,Shelby,male,3651,24657,24140,48797,0.1480715415500669,Texas
9593,2015,Shelby,male,3651,445994,491011,937005,0.0081862087830778,Texas
9594,2015,Shelby,male,3651,12572,12906,25478,0.29040725421571745,Texas
9604,2016,Shelby,male,4230,102478,108783,211261,0.04127715216924608,Texas
9605,2016,Shelby,male,4230,10791,11041,21832,0.3919933277731443,Texas
9606,2016,Shelby,male,4230,21941,22458,44399,0.19278975434118772,Texas
9607,2016,Shelby,male,4230,5735,5959,11694,0.7375762859633828,Texas
9608,2016,Shelby,male,4230,22613,24173,46786,0.1870605403971167,Texas
9609,2016,Shelby,male,4230,3047,3014,6061,1.388250738431244,Texas
9610,2016,Shelby,male,4230,24657,24140,48797,0.1715537169972016,Texas
9611,2016,Shelby,male,4230,445994,491011,937005,0.009484432525998107,Texas
9612,2016,Shelby,male,4230,12572,12906,25478,0.3364619790009545,Texas
9617,2009,Sherman,male,2167,3003,2963,5966,0.7216117216117216,Texas
9618,2009,Sherman,male,2167,1527,1515,3042,1.4191224623444663,Texas
9619,2009,Sherman,male,2167,871,734,1605,2.4879448909299655,Texas
9620,2009,Sherman,male,2167,1574,1484,3058,1.3767471410419314,Texas
9625,2010,Sherman,male,1588,3003,2963,5966,0.5288045288045288,Texas
9626,2010,Sherman,male,1588,1527,1515,3042,1.039947609692207,Texas
9627,2010,Sherman,male,1588,871,734,1605,1.823191733639495,Texas
9628,2010,Sherman,male,1588,1574,1484,3058,1.008894536213469,Texas
9633,2011,Sherman,male,1723,3003,2963,5966,0.5737595737595738,Texas
9634,2011,Sherman,male,1723,1527,1515,3042,1.1283562540929928,Texas
9635,2011,Sherman,male,1723,871,734,1605,1.9781859931113663,Texas
9636,2011,Sherman,male,1723,1574,1484,3058,1.0946632782719188,Texas
9641,2012,Sherman,male,1286,3003,2963,5966,0.4282384282384282,Texas
9642,2012,Sherman,male,1286,1527,1515,3042,0.842174197773412,Texas
9643,2012,Sherman,male,1286,871,734,1605,1.4764638346727899,Texas
9644,2012,Sherman,male,1286,1574,1484,3058,0.8170266836086404,Texas
9649,2013,Sherman,male,2220,3003,2963,5966,0.7392607392607392,Texas
9650,2013,Sherman,male,2220,1527,1515,3042,1.4538310412573674,Texas
9651,2013,Sherman,male,2220,871,734,1605,2.5487944890929968,Texas
9652,2013,Sherman,male,2220,1574,1484,3058,1.4104193138500636,Texas
9657,2014,Sherman,male,1227,3003,2963,5966,0.4085914085914086,Texas
9658,2014,Sherman,male,1227,1527,1515,3042,0.8035363457760314,Texas
9659,2014,Sherman,male,1227,871,734,1605,1.4087256027554536,Texas
9660,2014,Sherman,male,1227,1574,1484,3058,0.7795425667090216,Texas
9665,2015,Sherman,male,815,3003,2963,5966,0.2713952713952714,Texas
9666,2015,Sherman,male,815,1527,1515,3042,0.5337262606417813,Texas
9667,2015,Sherman,male,815,871,734,1605,0.9357060849598163,Texas
9668,2015,Sherman,male,815,1574,1484,3058,0.5177890724269377,Texas
9673,2016,Sherman,male,1016,3003,2963,5966,0.3383283383283383,Texas
9674,2016,Sherman,male,1016,1527,1515,3042,0.6653569089718402,Texas
9675,2016,Sherman,male,1016,871,734,1605,1.166475315729047,Texas
9676,2016,Sherman,male,1016,1574,1484,3058,0.6454891994917408,Texas
9681,2009,Smith,male,21799,1809,1854,3663,12.050304035378662,Texas
9682,2009,Smith,male,21799,7847,8216,16063,2.7780043328660633,Texas
9683,2009,Smith,male,21799,9675,9783,19458,2.25312661498708,Texas
9684,2009,Smith,male,21799,108730,116285,225015,0.2004874459670744,Texas
9689,2010,Smith,male,21491,1809,1854,3663,11.880044223327806,Texas
9690,2010,Smith,male,21491,7847,8216,16063,2.7387536638205683,Texas
9691,2010,Smith,male,21491,9675,9783,19458,2.2212919896640826,Texas
9692,2010,Smith,male,21491,108730,116285,225015,0.19765474110181183,Texas
9697,2011,Smith,male,24516,1809,1854,3663,13.552238805970148,Texas
9698,2011,Smith,male,24516,7847,8216,16063,3.124251306231681,Texas
9699,2011,Smith,male,24516,9675,9783,19458,2.533953488372093,Texas
9700,2011,Smith,male,24516,108730,116285,225015,0.22547594959992642,Texas
9705,2012,Smith,male,23863,1809,1854,3663,13.19126589275843,Texas
9706,2012,Smith,male,23863,7847,8216,16063,3.041034790365745,Texas
9707,2012,Smith,male,23863,9675,9783,19458,2.4664599483204133,Texas
9708,2012,Smith,male,23863,108730,116285,225015,0.21947024740182103,Texas
9713,2013,Smith,male,20667,1809,1854,3663,11.424543946932006,Texas
9714,2013,Smith,male,20667,7847,8216,16063,2.633745380400153,Texas
9715,2013,Smith,male,20667,9675,9783,19458,2.136124031007752,Texas
9716,2013,Smith,male,20667,108730,116285,225015,0.1900763358778626,Texas
9721,2014,Smith,male,18689,1809,1854,3663,10.331122166943063,Texas
9722,2014,Smith,male,18689,7847,8216,16063,2.3816745252962916,Texas
9723,2014,Smith,male,18689,9675,9783,19458,1.9316795865633074,Texas
9724,2014,Smith,male,18689,108730,116285,225015,0.1718844845028971,Texas
9729,2015,Smith,male,11577,1809,1854,3663,6.39966832504146,Texas
9730,2015,Smith,male,11577,7847,8216,16063,1.4753408946094049,Texas
9731,2015,Smith,male,11577,9675,9783,19458,1.1965891472868218,Texas
9732,2015,Smith,male,11577,108730,116285,225015,0.10647475397774303,Texas
9737,2016,Smith,male,12196,1809,1854,3663,6.741846323935876,Texas
9738,2016,Smith,male,12196,7847,8216,16063,1.5542245444118772,Texas
9739,2016,Smith,male,12196,9675,9783,19458,1.2605684754521964,Texas
9740,2016,Smith,male,12196,108730,116285,225015,0.11216775498942334,Texas
9742,2009,Somervell,male,1105,4192,4551,8743,0.2635973282442748,Texas
9744,2010,Somervell,male,1910,4192,4551,8743,0.4556297709923664,Texas
9746,2011,Somervell,male,1349,4192,4551,8743,0.3218034351145038,Texas
9748,2012,Somervell,male,2568,4192,4551,8743,0.6125954198473282,Texas
9750,2013,Somervell,male,3103,4192,4551,8743,0.740219465648855,Texas
9752,2014,Somervell,male,2311,4192,4551,8743,0.5512881679389313,Texas
9754,2015,Somervell,male,1619,4192,4551,8743,0.3862118320610687,Texas
9756,2016,Somervell,male,853,4192,4551,8743,0.20348282442748092,Texas
9758,2009,Starr,male,11422,31073,32821,63894,0.36758600714446626,Texas
9760,2010,Starr,male,12499,31073,32821,63894,0.40224632317446013,Texas
9762,2011,Starr,male,13865,31073,32821,63894,0.44620731825057125,Texas
9764,2012,Starr,male,13951,31073,32821,63894,0.4489749943681009,Texas
9766,2013,Starr,male,14391,31073,32821,63894,0.4631351977601133,Texas
9768,2014,Starr,male,47186,31073,32821,63894,1.5185530846715798,Texas
9770,2015,Starr,male,53880,31073,32821,63894,1.7339812699127861,Texas
9772,2016,Starr,male,42588,31073,32821,63894,1.3705789592250508,Texas
9776,2009,Stephens,male,1286,11765,13911,25676,0.10930726731831704,Texas
9777,2009,Stephens,male,1286,21328,22655,43983,0.06029632408102026,Texas
9778,2009,Stephens,male,1286,4808,4564,9372,0.2674708818635607,Texas
9782,2010,Stephens,male,1372,11765,13911,25676,0.11661708457288568,Texas
9783,2010,Stephens,male,1372,21328,22655,43983,0.06432858214553638,Texas
9784,2010,Stephens,male,1372,4808,4564,9372,0.2853577371048253,Texas
9788,2011,Stephens,male,1966,11765,13911,25676,0.16710582235444113,Texas
9789,2011,Stephens,male,1966,21328,22655,43983,0.09217929482370593,Texas
9790,2011,Stephens,male,1966,4808,4564,9372,0.4089018302828619,Texas
9794,2012,Stephens,male,2376,11765,13911,25676,0.20195495112622183,Texas
9795,2012,Stephens,male,2376,21328,22655,43983,0.11140285071267816,Texas
9796,2012,Stephens,male,2376,4808,4564,9372,0.49417637271214643,Texas
9800,2013,Stephens,male,426,11765,13911,25676,0.036209094772630686,Texas
9801,2013,Stephens,male,426,21328,22655,43983,0.019973743435858966,Texas
9802,2013,Stephens,male,426,4808,4564,9372,0.08860232945091515,Texas
9806,2014,Stephens,male,1712,11765,13911,25676,0.14551636209094773,Texas
9807,2014,Stephens,male,1712,21328,22655,43983,0.08027006751687922,Texas
9808,2014,Stephens,male,1712,4808,4564,9372,0.3560732113144759,Texas
9812,2015,Stephens,male,1399,11765,13911,25676,0.11891202719932002,Texas
9813,2015,Stephens,male,1399,21328,22655,43983,0.06559452363090773,Texas
9814,2015,Stephens,male,1399,4808,4564,9372,0.290973377703827,Texas
9818,2016,Stephens,male,1410,11765,13911,25676,0.11984700382490437,Texas
9819,2016,Stephens,male,1410,21328,22655,43983,0.06611027756939235,Texas
9820,2016,Stephens,male,1410,4808,4564,9372,0.293261231281198,Texas
9822,2009,Sterling,male,1018,622,519,1141,1.6366559485530547,Texas
9824,2010,Sterling,male,557,622,519,1141,0.8954983922829582,Texas
9826,2011,Sterling,male,348,622,519,1141,0.5594855305466238,Texas
9828,2012,Sterling,male,1946,622,519,1141,3.1286173633440515,Texas
9830,2013,Sterling,male,1814,622,519,1141,2.9163987138263665,Texas
9832,2014,Sterling,male,803,622,519,1141,1.2909967845659165,Texas
9834,2015,Sterling,male,548,622,519,1141,0.8810289389067524,Texas
9836,2016,Sterling,male,422,622,519,1141,0.6784565916398714,Texas
9838,2009,Stonewall,male,1105,730,655,1385,1.5136986301369864,Texas
9840,2010,Stonewall,male,1553,730,655,1385,2.127397260273973,Texas
9842,2011,Stonewall,male,1381,730,655,1385,1.8917808219178083,Texas
9844,2012,Stonewall,male,1247,730,655,1385,1.7082191780821918,Texas
9846,2013,Stonewall,male,881,730,655,1385,1.2068493150684931,Texas
9848,2014,Stonewall,male,935,730,655,1385,1.2808219178082192,Texas
9850,2015,Stonewall,male,779,730,655,1385,1.0671232876712329,Texas
9852,2016,Stonewall,male,707,730,655,1385,0.9684931506849315,Texas
9854,2009,Sutton,male,6750,2116,1749,3865,3.1899810964083177,Texas
9856,2010,Sutton,male,5648,2116,1749,3865,2.669187145557656,Texas
9858,2011,Sutton,male,5894,2116,1749,3865,2.7854442344045367,Texas
9860,2012,Sutton,male,3909,2116,1749,3865,1.8473534971644612,Texas
9862,2013,Sutton,male,3562,2116,1749,3865,1.6833648393194707,Texas
9864,2014,Sutton,male,4963,2116,1749,3865,2.3454631379962194,Texas
9866,2015,Sutton,male,4961,2116,1749,3865,2.3445179584120983,Texas
9868,2016,Sutton,male,5600,2116,1749,3865,2.6465028355387523,Texas
9870,2009,Swisher,male,2952,4036,3448,7484,0.7314172447968286,Texas
9872,2010,Swisher,male,3417,4036,3448,7484,0.8466303270564915,Texas
9874,2011,Swisher,male,2697,4036,3448,7484,0.6682358771060456,Texas
9876,2012,Swisher,male,2922,4036,3448,7484,0.72398414271556,Texas
9878,2013,Swisher,male,2136,4036,3448,7484,0.5292368681863231,Texas
9880,2014,Swisher,male,2142,4036,3448,7484,0.5307234886025768,Texas
9882,2015,Swisher,male,1327,4036,3448,7484,0.32879088206144697,Texas
9884,2016,Swisher,male,2351,4036,3448,7484,0.5825074331020813,Texas
9886,2009,Tarrant,male,1870,988765,1031212,2019977,0.0018912481732261963,Texas
9888,2010,Tarrant,male,3962,988765,1031212,2019977,0.004007018856856786,Texas
9890,2011,Tarrant,male,3874,988765,1031212,2019977,0.003918018942822612,Texas
9892,2012,Tarrant,male,3358,988765,1031212,2019977,0.0033961558105313192,Texas
9894,2013,Tarrant,male,2013,988765,1031212,2019977,0.002035873033531729,Texas
9896,2014,Tarrant,male,6081,988765,1031212,2019977,0.006150096332293315,Texas
9898,2015,Tarrant,male,9815,988765,1031212,2019977,0.009926524502788832,Texas
9900,2016,Tarrant,male,8848,988765,1031212,2019977,0.008948536811072398,Texas
9908,2009,Taylor,male,8159,12414,9684,22098,0.6572418237473819,Texas
9909,2009,Taylor,male,8159,3946,4247,8193,2.067663456664977,Texas
9910,2009,Taylor,male,8159,3168,3033,6201,2.575441919191919,Texas
9911,2009,Taylor,male,8159,12525,12975,25500,0.6514171656686627,Texas
9912,2009,Taylor,male,8159,66718,69630,136348,0.1222908360562367,Texas
9913,2009,Taylor,male,8159,8580,8371,16951,0.950932400932401,Texas
9914,2009,Taylor,male,8159,10385,9971,20356,0.785652383245065,Texas
9922,2010,Taylor,male,10062,12414,9684,22098,0.8105364910584824,Texas
9923,2010,Taylor,male,10062,3946,4247,8193,2.5499239736441965,Texas
9924,2010,Taylor,male,10062,3168,3033,6201,3.1761363636363638,Texas
9925,2010,Taylor,male,10062,12525,12975,25500,0.8033532934131736,Texas
9926,2010,Taylor,male,10062,66718,69630,136348,0.15081387331754548,Texas
9927,2010,Taylor,male,10062,8580,8371,16951,1.1727272727272726,Texas
9928,2010,Taylor,male,10062,10385,9971,20356,0.9688974482426577,Texas
9936,2011,Taylor,male,12141,12414,9684,22098,0.9780086998550024,Texas
9937,2011,Taylor,male,12141,3946,4247,8193,3.0767866193613784,Texas
9938,2011,Taylor,male,12141,3168,3033,6201,3.8323863636363638,Texas
9939,2011,Taylor,male,12141,12525,12975,25500,0.9693413173652694,Texas
9940,2011,Taylor,male,12141,66718,69630,136348,0.18197487934290596,Texas
9941,2011,Taylor,male,12141,8580,8371,16951,1.415034965034965,Texas
9942,2011,Taylor,male,12141,10385,9971,20356,1.1690900337024555,Texas
9950,2012,Taylor,male,12009,12414,9684,22098,0.9673755437409377,Texas
9951,2012,Taylor,male,12009,3946,4247,8193,3.0433350228079066,Texas
9952,2012,Taylor,male,12009,3168,3033,6201,3.790719696969697,Texas
9953,2012,Taylor,male,12009,12525,12975,25500,0.9588023952095809,Texas
9954,2012,Taylor,male,12009,66718,69630,136348,0.1799964027698672,Texas
9955,2012,Taylor,male,12009,8580,8371,16951,1.3996503496503496,Texas
9956,2012,Taylor,male,12009,10385,9971,20356,1.1563793933558015,Texas
9964,2013,Taylor,male,7923,12414,9684,22098,0.6382310294828419,Texas
9965,2013,Taylor,male,7923,3946,4247,8193,2.0078560567663457,Texas
9966,2013,Taylor,male,7923,3168,3033,6201,2.5009469696969697,Texas
9967,2013,Taylor,male,7923,12525,12975,25500,0.6325748502994012,Texas
9968,2013,Taylor,male,7923,66718,69630,136348,0.11875355975898558,Texas
9969,2013,Taylor,male,7923,8580,8371,16951,0.9234265734265734,Texas
9970,2013,Taylor,male,7923,10385,9971,20356,0.7629272989889263,Texas
9978,2014,Taylor,male,5930,12414,9684,22098,0.47768648300306105,Texas
9979,2014,Taylor,male,5930,3946,4247,8193,1.5027876330461227,Texas
9980,2014,Taylor,male,5930,3168,3033,6201,1.8718434343434343,Texas
9981,2014,Taylor,male,5930,12525,12975,25500,0.47345309381237527,Texas
9982,2014,Taylor,male,5930,66718,69630,136348,0.08888156119787763,Texas
9983,2014,Taylor,male,5930,8580,8371,16951,0.6911421911421911,Texas
9984,2014,Taylor,male,5930,10385,9971,20356,0.5710158883004334,Texas
9992,2015,Taylor,male,4801,12414,9684,22098,0.3867407765426132,Texas
9993,2015,Taylor,male,4801,3946,4247,8193,1.2166751140395338,Texas
9994,2015,Taylor,male,4801,3168,3033,6201,1.5154671717171717,Texas
9995,2015,Taylor,male,4801,12525,12975,25500,0.383313373253493,Texas
9996,2015,Taylor,male,4801,66718,69630,136348,0.07195959111484157,Texas
9997,2015,Taylor,male,4801,8580,8371,16951,0.5595571095571096,Texas
9998,2015,Taylor,male,4801,10385,9971,20356,0.46230139624458355,Texas
10006,2016,Taylor,male,5391,12414,9684,22098,0.4342677622039633,Texas
10007,2016,Taylor,male,5391,3946,4247,8193,1.3661936137861126,Texas
10008,2016,Taylor,male,5391,3168,3033,6201,1.7017045454545454,Texas
10009,2016,Taylor,male,5391,12525,12975,25500,0.43041916167664673,Texas
10010,2016,Taylor,male,5391,66718,69630,136348,0.08080278185796937,Texas
10011,2016,Taylor,male,5391,8580,8371,16951,0.6283216783216783,Texas
10012,2016,Taylor,male,5391,10385,9971,20356,0.5191141068849302,Texas
10015,2009,Terrell,male,613,4228,4631,8859,0.14498580889309365,Texas
10016,2009,Terrell,male,613,429,433,862,1.4289044289044288,Texas
10019,2010,Terrell,male,408,4228,4631,8859,0.09649952696310313,Texas
10020,2010,Terrell,male,408,429,433,862,0.951048951048951,Texas
10023,2011,Terrell,male,103,4228,4631,8859,0.02436140018921476,Texas
10024,2011,Terrell,male,103,429,433,862,0.2400932400932401,Texas
10027,2012,Terrell,male,174,4228,4631,8859,0.04115421002838222,Texas
10028,2012,Terrell,male,174,429,433,862,0.40559440559440557,Texas
10031,2013,Terrell,male,23,4228,4631,8859,0.005439924314096499,Texas
10032,2013,Terrell,male,23,429,433,862,0.053613053613053616,Texas
10035,2014,Terrell,male,201,4228,4631,8859,0.04754020813623463,Texas
10036,2014,Terrell,male,201,429,433,862,0.46853146853146854,Texas
10039,2015,Terrell,male,375,4228,4631,8859,0.08869441816461685,Texas
10040,2015,Terrell,male,375,429,433,862,0.8741258741258742,Texas
10043,2016,Terrell,male,604,4228,4631,8859,0.14285714285714285,Texas
10044,2016,Terrell,male,604,429,433,862,1.407925407925408,Texas
10046,2009,Terry,male,3163,6515,6100,12615,0.4854950115118956,Texas
10048,2010,Terry,male,3343,6515,6100,12615,0.5131235610130468,Texas
10050,2011,Terry,male,2668,6515,6100,12615,0.40951650038372983,Texas
10052,2012,Terry,male,2196,6515,6100,12615,0.3370683039140445,Texas
10054,2013,Terry,male,2822,6515,6100,12615,0.4331542594013814,Texas
10056,2014,Terry,male,1600,6515,6100,12615,0.24558710667689945,Texas
10058,2015,Terry,male,2172,6515,6100,12615,0.333384497313891,Texas
10060,2016,Terry,male,1561,6515,6100,12615,0.23960092095165003,Texas
10062,2009,Throckmorton,male,863,694,873,1567,1.2435158501440922,Texas
10064,2010,Throckmorton,male,1030,694,873,1567,1.484149855907781,Texas
10066,2011,Throckmorton,male,710,694,873,1567,1.0230547550432276,Texas
10068,2012,Throckmorton,male,424,694,873,1567,0.6109510086455331,Texas
10070,2013,Throckmorton,male,248,694,873,1567,0.3573487031700288,Texas
10072,2014,Throckmorton,male,292,694,873,1567,0.4207492795389049,Texas
10074,2015,Throckmorton,male,170,694,873,1567,0.24495677233429394,Texas
10076,2016,Throckmorton,male,166,694,873,1567,0.23919308357348704,Texas
10078,2009,Titus,male,9481,16046,16684,32730,0.5908637666708214,Texas
10080,2010,Titus,male,8682,16046,16684,32730,0.5410694254019693,Texas
10082,2011,Titus,male,9329,16046,16684,32730,0.5813910008724916,Texas
10084,2012,Titus,male,9446,16046,16684,32730,0.5886825377041007,Texas
10086,2013,Titus,male,7016,16046,16684,32730,0.43724292658606506,Texas
10088,2014,Titus,male,5568,16046,16684,32730,0.3470023681914496,Texas
10090,2015,Titus,male,4830,16046,16684,32730,0.3010095974074536,Texas
10092,2016,Titus,male,4908,16046,16684,32730,0.30587062196185966,Texas
10094,2009,Tom Green,male,12972,58343,59123,117466,0.22234029789349194,Texas
10096,2010,Tom Green,male,11739,58343,59123,117466,0.20120665718252403,Texas
10098,2011,Tom Green,male,11786,58343,59123,117466,0.20201223797199322,Texas
10100,2012,Tom Green,male,7710,58343,59123,117466,0.1321495295065389,Texas
10102,2013,Tom Green,male,6299,58343,59123,117466,0.10796496580566649,Texas
10104,2014,Tom Green,male,6510,58343,59123,117466,0.11158150934987916,Texas
10106,2015,Tom Green,male,10390,58343,59123,117466,0.17808477452307903,Texas
10108,2016,Tom Green,male,7231,58343,59123,117466,0.12393946146067224,Texas
10110,2009,Travis,male,22206,607356,595810,1203166,0.03656175290933159,Texas
10112,2010,Travis,male,20038,607356,595810,1203166,0.03299218250910504,Texas
10114,2011,Travis,male,26970,607356,595810,1203166,0.04440558749728331,Texas
10116,2012,Travis,male,22507,607356,595810,1203166,0.03705734363371729,Texas
10118,2013,Travis,male,22360,607356,595810,1203166,0.03681531095436614,Texas
10120,2014,Travis,male,18455,607356,595810,1203166,0.030385803383847363,Texas
10122,2015,Travis,male,11538,607356,595810,1203166,0.018997095607847785,Texas
10124,2016,Travis,male,12815,607356,595810,1203166,0.0210996516046602,Texas
10127,2009,Trinity,male,1701,6582,6280,12862,0.25843208751139474,Texas
10128,2009,Trinity,male,1701,7011,7558,14569,0.24261874197689345,Texas
10131,2010,Trinity,male,797,6582,6280,12862,0.12108781525372227,Texas
10132,2010,Trinity,male,797,7011,7558,14569,0.11367850520610469,Texas
10135,2011,Trinity,male,1371,6582,6280,12862,0.20829535095715587,Texas
10136,2011,Trinity,male,1371,7011,7558,14569,0.19554985023534446,Texas
10139,2012,Trinity,male,1062,6582,6280,12862,0.16134913400182316,Texas
10140,2012,Trinity,male,1062,7011,7558,14569,0.1514762516046213,Texas
10143,2013,Trinity,male,768,6582,6280,12862,0.11668185961713765,Texas
10144,2013,Trinity,male,768,7011,7558,14569,0.10954214805305948,Texas
10147,2014,Trinity,male,970,6582,6280,12862,0.1473716195685202,Texas
10148,2014,Trinity,male,970,7011,7558,14569,0.13835401511909856,Texas
10151,2015,Trinity,male,1309,6582,6280,12862,0.19887572166514736,Texas
10152,2015,Trinity,male,1309,7011,7558,14569,0.18670660390814434,Texas
10155,2016,Trinity,male,833,6582,6280,12862,0.1265572774232756,Texas
10156,2016,Trinity,male,833,7011,7558,14569,0.11881329339609185,Texas
10159,2009,Tyler,male,3689,11738,9758,21496,0.31427841199522916,Texas
10160,2009,Tyler,male,3689,4437,4472,8909,0.8314176245210728,Texas
10163,2010,Tyler,male,4268,11738,9758,21496,0.36360538422218436,Texas
10164,2010,Tyler,male,4268,4437,4472,8909,0.961911201262114,Texas
10167,2011,Tyler,male,4647,11738,9758,21496,0.3958936786505367,Texas
10168,2011,Tyler,male,4647,4437,4472,8909,1.0473292765382014,Texas
10171,2012,Tyler,male,4687,11738,9758,21496,0.3993014142102573,Texas
10172,2012,Tyler,male,4687,4437,4472,8909,1.0563443768311922,Texas
10175,2013,Tyler,male,4290,11738,9758,21496,0.36547963878003065,Texas
10176,2013,Tyler,male,4290,4437,4472,8909,0.966869506423259,Texas
10179,2014,Tyler,male,3936,11738,9758,21496,0.33532117907650366,Texas
10180,2014,Tyler,male,3936,4437,4472,8909,0.8870858688302907,Texas
10183,2015,Tyler,male,1717,11738,9758,21496,0.1462770489010053,Texas
10184,2015,Tyler,male,1717,4437,4472,8909,0.38697318007662834,Texas
10187,2016,Tyler,male,1725,11738,9758,21496,0.1469585960129494,Texas
10188,2016,Tyler,male,1725,4437,4472,8909,0.3887762001352265,Texas
10191,2009,Upshur,male,6440,20224,20545,40769,0.31843354430379744,Texas
10192,2009,Upshur,male,6440,12200,12405,24605,0.5278688524590164,Texas
10195,2010,Upshur,male,6916,20224,20545,40769,0.3419699367088608,Texas
10196,2010,Upshur,male,6916,12200,12405,24605,0.5668852459016394,Texas
10199,2011,Upshur,male,7507,20224,20545,40769,0.3711926424050633,Texas
10200,2011,Upshur,male,7507,12200,12405,24605,0.615327868852459,Texas
10203,2012,Upshur,male,7210,20224,20545,40769,0.35650712025316456,Texas
10204,2012,Upshur,male,7210,12200,12405,24605,0.590983606557377,Texas
10207,2013,Upshur,male,5677,20224,20545,40769,0.2807060917721519,Texas
10208,2013,Upshur,male,5677,12200,12405,24605,0.465327868852459,Texas
10211,2014,Upshur,male,5545,20224,20545,40769,0.27417919303797467,Texas
10212,2014,Upshur,male,5545,12200,12405,24605,0.4545081967213115,Texas
10215,2015,Upshur,male,4492,20224,20545,40769,0.2221123417721519,Texas
10216,2015,Upshur,male,4492,12200,12405,24605,0.3681967213114754,Texas
10219,2016,Upshur,male,3233,20224,20545,40769,0.15985957278481014,Texas
10220,2016,Upshur,male,3233,12200,12405,24605,0.265,Texas
10222,2009,Upton,male,481,1843,1791,3634,0.2609875203472599,Texas
10224,2010,Upton,male,632,1843,1791,3634,0.34291915355398805,Texas
10226,2011,Upton,male,1340,1843,1791,3634,0.7270754205100379,Texas
10228,2012,Upton,male,1075,1843,1791,3634,0.583288117200217,Texas
10230,2013,Upton,male,912,1843,1791,3634,0.4948453608247423,Texas
10232,2014,Upton,male,1629,1843,1791,3634,0.8838849701573521,Texas
10234,2015,Upton,male,354,1843,1791,3634,0.19207813347802496,Texas
10236,2016,Upton,male,848,1843,1791,3634,0.46011937059142705,Texas
10238,2009,Uvalde,male,6727,13083,13926,27009,0.5141787051899411,Texas
10240,2010,Uvalde,male,5004,13083,13926,27009,0.38248108232056865,Texas
10242,2011,Uvalde,male,3363,13083,13926,27009,0.2570511350607659,Texas
10244,2012,Uvalde,male,2754,13083,13926,27009,0.21050217839944968,Texas
10246,2013,Uvalde,male,3298,13083,13926,27009,0.2520828556141558,Texas
10248,2014,Uvalde,male,2956,13083,13926,27009,0.2259420622181457,Texas
10250,2015,Uvalde,male,6075,13083,13926,27009,0.4643430405870213,Texas
10252,2016,Uvalde,male,5105,13083,13926,27009,0.3902010242299167,Texas
10254,2009,Val Verde,male,4804,24925,24102,49027,0.1927382146439318,Texas
10256,2010,Val Verde,male,5041,24925,24102,49027,0.202246740220662,Texas
10258,2011,Val Verde,male,4909,24925,24102,49027,0.19695085255767303,Texas
10260,2012,Val Verde,male,3636,24925,24102,49027,0.1458776328986961,Texas
10262,2013,Val Verde,male,3557,24925,24102,49027,0.14270812437311936,Texas
10264,2014,Val Verde,male,3705,24925,24102,49027,0.14864593781344032,Texas
10266,2015,Val Verde,male,6312,24925,24102,49027,0.2532397191574724,Texas
10268,2016,Val Verde,male,5241,24925,24102,49027,0.21027081243731194,Texas
10270,2009,Van Zandt,male,10645,26619,27749,54368,0.3999023254066644,Texas
10272,2010,Van Zandt,male,10738,26619,27749,54368,0.4033960704759758,Texas
10274,2011,Van Zandt,male,13879,26619,27749,54368,0.5213944926556219,Texas
10276,2012,Van Zandt,male,11847,26619,27749,54368,0.4450580412487321,Texas
10278,2013,Van Zandt,male,10601,26619,27749,54368,0.398249370750216,Texas
10280,2014,Van Zandt,male,7830,26619,27749,54368,0.2941507945452496,Texas
10282,2015,Van Zandt,male,5045,26619,27749,54368,0.1895262782223224,Texas
10284,2016,Van Zandt,male,6829,26619,27749,54368,0.2565460761110485,Texas
10286,2009,Victoria,male,11665,44999,46971,91970,0.2592279828440632,Texas
10288,2010,Victoria,male,10571,44999,46971,91970,0.23491633147403276,Texas
10290,2011,Victoria,male,9384,44999,46971,91970,0.2085379675103891,Texas
10292,2012,Victoria,male,6726,44999,46971,91970,0.14946998822196048,Texas
10294,2013,Victoria,male,7886,44999,46971,91970,0.1752483388519745,Texas
10296,2014,Victoria,male,9849,44999,46971,91970,0.2188715304784551,Texas
10298,2015,Victoria,male,6371,44999,46971,91970,0.1415809240205338,Texas
10300,2016,Victoria,male,5238,44999,46971,91970,0.11640258672414942,Texas
10304,2009,Walker,male,9902,31506,32987,64493,0.31428934171268963,Texas
10305,2009,Walker,male,9902,34082,34742,68824,0.29053459304031454,Texas
10306,2009,Walker,male,9902,41642,29897,71539,0.23778877095240383,Texas
10310,2010,Walker,male,13572,31506,32987,64493,0.4307750904589602,Texas
10311,2010,Walker,male,13572,34082,34742,68824,0.3982160671322105,Texas
10312,2010,Walker,male,13572,41642,29897,71539,0.32592094519955817,Texas
10316,2011,Walker,male,13875,31506,32987,64493,0.44039230622738523,Texas
10317,2011,Walker,male,13875,34082,34742,68824,0.4071063904700428,Texas
10318,2011,Walker,male,13875,41642,29897,71539,0.333197252773642,Texas
10322,2012,Walker,male,11887,31506,32987,64493,0.37729321399098587,Texas
10323,2012,Walker,male,11887,34082,34742,68824,0.34877648025350627,Texas
10324,2012,Walker,male,11887,41642,29897,71539,0.28545699053839874,Texas
10328,2013,Walker,male,9225,31506,32987,64493,0.2928013711673967,Texas
10329,2013,Walker,male,9225,34082,34742,68824,0.27067073528548796,Texas
10330,2013,Walker,male,9225,41642,29897,71539,0.2215311464386917,Texas
10334,2014,Walker,male,6526,31506,32987,64493,0.2071351488605345,Texas
10335,2014,Walker,male,6526,34082,34742,68824,0.1914793732762162,Texas
10336,2014,Walker,male,6526,41642,29897,71539,0.1567167763315883,Texas
10340,2015,Walker,male,6883,31506,32987,64493,0.2184663238748175,Texas
10341,2015,Walker,male,6883,34082,34742,68824,0.2019541106742562,Texas
10342,2015,Walker,male,6883,41642,29897,71539,0.16528985159214254,Texas
10346,2016,Walker,male,6065,31506,32987,64493,0.19250301529867328,Texas
10347,2016,Walker,male,6065,34082,34742,68824,0.17795317176222053,Texas
10348,2016,Walker,male,6065,41642,29897,71539,0.14564622256375775,Texas
10350,2009,Waller,male,8587,24869,25118,49987,0.34528931601592344,Texas
10352,2010,Waller,male,8812,24869,25118,49987,0.35433672443604486,Texas
10354,2011,Waller,male,7770,24869,25118,49987,0.3124371707748603,Texas
10356,2012,Waller,male,9417,24869,25118,49987,0.3786642004101492,Texas
10358,2013,Waller,male,7121,24869,25118,49987,0.2863404238208211,Texas
10360,2014,Waller,male,4783,24869,25118,49987,0.192327797659737,Texas
10362,2015,Waller,male,4211,24869,25118,49987,0.16932727492058386,Texas
10364,2016,Waller,male,3937,24869,25118,49987,0.15830954200008043,Texas
10367,2009,Ward,male,5158,35881,33153,69034,0.14375296117722472,Texas
10368,2009,Ward,male,5158,5864,5722,11586,0.8796043656207367,Texas
10371,2010,Ward,male,5092,35881,33153,69034,0.14191354755998997,Texas
10372,2010,Ward,male,5092,5864,5722,11586,0.8683492496589359,Texas
10375,2011,Ward,male,6588,35881,33153,69034,0.1836069228839776,Texas
10376,2011,Ward,male,6588,5864,5722,11586,1.1234652114597545,Texas
10379,2012,Ward,male,4238,35881,33153,69034,0.11811265014910398,Texas
10380,2012,Ward,male,4238,5864,5722,11586,0.7227148703956344,Texas
10383,2013,Ward,male,2454,35881,33153,69034,0.06839274267718291,Texas
10384,2013,Ward,male,2454,5864,5722,11586,0.4184856753069577,Texas
10387,2014,Ward,male,2210,35881,33153,69034,0.06159248627407263,Texas
10388,2014,Ward,male,2210,5864,5722,11586,0.37687585266030016,Texas
10391,2015,Ward,male,1416,35881,33153,69034,0.03946378306067278,Texas
10392,2015,Ward,male,1416,5864,5722,11586,0.24147339699863574,Texas
10395,2016,Ward,male,2608,35881,33153,69034,0.072684707784064,Texas
10396,2016,Ward,male,2608,5864,5722,11586,0.44474761255115963,Texas
10428,2009,Washington,male,6541,8420,8223,16643,0.7768408551068884,Texas
10429,2009,Washington,male,6541,114181,114348,228529,0.057286238516040325,Texas
10430,2009,Washington,male,6541,2510,2330,4840,2.60597609561753,Texas
10431,2009,Washington,male,6541,13231,11335,24566,0.4943692842566699,Texas
10432,2009,Washington,male,6541,10361,10100,20461,0.6313097191390792,Texas
10433,2009,Washington,male,6541,4966,5059,10025,1.3171566653242046,Texas
10434,2009,Washington,male,6541,7108,7047,14155,0.9202307259425999,Texas
10435,2009,Washington,male,6541,13892,13935,27827,0.4708465303771955,Texas
10436,2009,Washington,male,6541,11075,11068,22143,0.5906094808126411,Texas
10437,2009,Washington,male,6541,2844,2681,5525,2.299929676511955,Texas
10438,2009,Washington,male,6541,5865,6154,12019,1.1152600170502984,Texas
10439,2009,Washington,male,6541,22963,23494,46457,0.28484954056525713,Texas
10440,2009,Washington,male,6541,15614,16080,31694,0.4189189189189189,Texas
10441,2009,Washington,male,6541,76098,73713,149811,0.08595495282399011,Texas
10442,2009,Washington,male,6541,125332,127985,253317,0.05218938499345738,Texas
10443,2009,Washington,male,6541,22018,25068,47086,0.2970751203560723,Texas
10444,2009,Washington,male,6541,12835,12096,24931,0.509622126996494,Texas
10445,2009,Washington,male,6541,9911,10308,20219,0.6599737665220462,Texas
10446,2009,Washington,male,6541,32002,29826,61828,0.20439347540778702,Texas
10447,2009,Washington,male,6541,5726,6430,12156,1.142333216905344,Texas
10448,2009,Washington,male,6541,29953,30718,60671,0.21837545487931093,Texas
10449,2009,Washington,male,6541,25253,26748,52001,0.2590187304478676,Texas
10450,2009,Washington,male,6541,287522,294299,581821,0.022749563511661717,Texas
10451,2009,Washington,male,6541,101709,105838,207547,0.06431092627004494,Texas
10452,2009,Washington,male,6541,61110,65132,126242,0.10703649157257404,Texas
10453,2009,Washington,male,6541,61851,65204,127055,0.1057541511050751,Texas
10454,2009,Washington,male,6541,17259,17537,34796,0.3789906715336926,Texas
10455,2009,Washington,male,6541,79500,81037,160537,0.08227672955974842,Texas
10456,2009,Washington,male,6541,28816,29661,58477,0.22699194891726818,Texas
10457,2009,Washington,male,6541,26851,27555,54406,0.24360359018286099,Texas
10458,2009,Washington,male,6541,66754,67781,134535,0.09798663750486862,Texas
10490,2010,Washington,male,7022,8420,8223,16643,0.8339667458432304,Texas
10491,2010,Washington,male,7022,114181,114348,228529,0.061498848319772995,Texas
10492,2010,Washington,male,7022,2510,2330,4840,2.797609561752988,Texas
10493,2010,Washington,male,7022,13231,11335,24566,0.5307233013377674,Texas
10494,2010,Washington,male,7022,10361,10100,20461,0.6777338094778497,Texas
10495,2010,Washington,male,7022,4966,5059,10025,1.4140153040676602,Texas
10496,2010,Washington,male,7022,7108,7047,14155,0.9879009566685425,Texas
10497,2010,Washington,male,7022,13892,13935,27827,0.5054707745465016,Texas
10498,2010,Washington,male,7022,11075,11068,22143,0.634040632054176,Texas
10499,2010,Washington,male,7022,2844,2681,5525,2.469057665260197,Texas
10500,2010,Washington,male,7022,5865,6154,12019,1.1972719522591646,Texas
10501,2010,Washington,male,7022,22963,23494,46457,0.30579628097374034,Texas
10502,2010,Washington,male,7022,15614,16080,31694,0.44972460612271037,Texas
10503,2010,Washington,male,7022,76098,73713,149811,0.09227574969118768,Texas
10504,2010,Washington,male,7022,125332,127985,253317,0.056027191778635944,Texas
10505,2010,Washington,male,7022,22018,25068,47086,0.31892088291397946,Texas
10506,2010,Washington,male,7022,12835,12096,24931,0.5470977795091546,Texas
10507,2010,Washington,male,7022,9911,10308,20219,0.7085057007365554,Texas
10508,2010,Washington,male,7022,32002,29826,61828,0.21942378601337417,Texas
10509,2010,Washington,male,7022,5726,6430,12156,1.226336011177087,Texas
10510,2010,Washington,male,7022,29953,30718,60671,0.23443394651620872,Texas
10511,2010,Washington,male,7022,25253,26748,52001,0.27806597235971964,Texas
10512,2010,Washington,male,7022,287522,294299,581821,0.024422478975521873,Texas
10513,2010,Washington,male,7022,101709,105838,207547,0.06904010461217788,Texas
10514,2010,Washington,male,7022,61110,65132,126242,0.11490754377352315,Texas
10515,2010,Washington,male,7022,61851,65204,127055,0.11353090491665455,Texas
10516,2010,Washington,male,7022,17259,17537,34796,0.4068601888869575,Texas
10517,2010,Washington,male,7022,79500,81037,160537,0.08832704402515723,Texas
10518,2010,Washington,male,7022,28816,29661,58477,0.24368406440866186,Texas
10519,2010,Washington,male,7022,26851,27555,54406,0.2615172619269301,Texas
10520,2010,Washington,male,7022,66754,67781,134535,0.10519219822033136,Texas
10552,2011,Washington,male,5937,8420,8223,16643,0.7051068883610452,Texas
10553,2011,Washington,male,5937,114181,114348,228529,0.051996391693889525,Texas
10554,2011,Washington,male,5937,2510,2330,4840,2.3653386454183267,Texas
10555,2011,Washington,male,5937,13231,11335,24566,0.448718917693296,Texas
10556,2011,Washington,male,5937,10361,10100,20461,0.5730141878197085,Texas
10557,2011,Washington,male,5937,4966,5059,10025,1.1955296012887635,Texas
10558,2011,Washington,male,5937,7108,7047,14155,0.8352560495216658,Texas
10559,2011,Washington,male,5937,13892,13935,27827,0.4273682695076303,Texas
10560,2011,Washington,male,5937,11075,11068,22143,0.5360722347629797,Texas
10561,2011,Washington,male,5937,2844,2681,5525,2.0875527426160336,Texas
10562,2011,Washington,male,5937,5865,6154,12019,1.0122762148337596,Texas
10563,2011,Washington,male,5937,22963,23494,46457,0.2585463571832949,Texas
10564,2011,Washington,male,5937,15614,16080,31694,0.3802356859228897,Texas
10565,2011,Washington,male,5937,76098,73713,149811,0.07801781912796657,Texas
10566,2011,Washington,male,5937,125332,127985,253317,0.04737018478919988,Texas
10567,2011,Washington,male,5937,22018,25068,47086,0.2696430193478063,Texas
10568,2011,Washington,male,5937,12835,12096,24931,0.4625633034670822,Texas
10569,2011,Washington,male,5937,9911,10308,20219,0.5990313792755524,Texas
10570,2011,Washington,male,5937,32002,29826,61828,0.18551965502156115,Texas
10571,2011,Washington,male,5937,5726,6430,12156,1.0368494586098498,Texas
10572,2011,Washington,male,5937,29953,30718,60671,0.1982105298300671,Texas
10573,2011,Washington,male,5937,25253,26748,52001,0.23510078010533403,Texas
10574,2011,Washington,male,5937,287522,294299,581821,0.02064885469633628,Texas
10575,2011,Washington,male,5937,101709,105838,207547,0.058372415420464265,Texas
10576,2011,Washington,male,5937,61110,65132,126242,0.09715267550319097,Texas
10577,2011,Washington,male,5937,61851,65204,127055,0.09598874715040985,Texas
10578,2011,Washington,male,5937,17259,17537,34796,0.34399443768468624,Texas
10579,2011,Washington,male,5937,79500,81037,160537,0.07467924528301886,Texas
10580,2011,Washington,male,5937,28816,29661,58477,0.20603137146029984,Texas
10581,2011,Washington,male,5937,26851,27555,54406,0.22110908346057875,Texas
10582,2011,Washington,male,5937,66754,67781,134535,0.08893849057734368,Texas
10614,2012,Washington,male,3161,8420,8223,16643,0.37541567695961997,Texas
10615,2012,Washington,male,3161,114181,114348,228529,0.02768411557089183,Texas
10616,2012,Washington,male,3161,2510,2330,4840,1.2593625498007968,Texas
10617,2012,Washington,male,3161,13231,11335,24566,0.23890862368679616,Texas
10618,2012,Washington,male,3161,10361,10100,20461,0.3050863816233954,Texas
10619,2012,Washington,male,3161,4966,5059,10025,0.6365283930728957,Texas
10620,2012,Washington,male,3161,7108,7047,14155,0.4447101857062465,Texas
10621,2012,Washington,male,3161,13892,13935,27827,0.22754103080909877,Texas
10622,2012,Washington,male,3161,11075,11068,22143,0.2854176072234763,Texas
10623,2012,Washington,male,3161,2844,2681,5525,1.111462728551336,Texas
10624,2012,Washington,male,3161,5865,6154,12019,0.5389599317988065,Texas
10625,2012,Washington,male,3161,22963,23494,46457,0.13765622958672646,Texas
10626,2012,Washington,male,3161,15614,16080,31694,0.20244652235173563,Texas
10627,2012,Washington,male,3161,76098,73713,149811,0.04153854240584509,Texas
10628,2012,Washington,male,3161,125332,127985,253317,0.02522101298949989,Texas
10629,2012,Washington,male,3161,22018,25068,47086,0.14356435643564355,Texas
10630,2012,Washington,male,3161,12835,12096,24931,0.24627970393455395,Texas
10631,2012,Washington,male,3161,9911,10308,20219,0.31893855312279284,Texas
10632,2012,Washington,male,3161,32002,29826,61828,0.09877507655771514,Texas
10633,2012,Washington,male,3161,5726,6430,12156,0.5520433112120153,Texas
10634,2012,Washington,male,3161,29953,30718,60671,0.10553200013354255,Texas
10635,2012,Washington,male,3161,25253,26748,52001,0.12517324674296124,Texas
10636,2012,Washington,male,3161,287522,294299,581821,0.010993941333184938,Texas
10637,2012,Washington,male,3161,101709,105838,207547,0.031078862244245838,Texas
10638,2012,Washington,male,3161,61110,65132,126242,0.051726395025364094,Texas
10639,2012,Washington,male,3161,61851,65204,127055,0.05110669188857092,Texas
10640,2012,Washington,male,3161,17259,17537,34796,0.18315081986210094,Texas
10641,2012,Washington,male,3161,79500,81037,160537,0.039761006289308176,Texas
10642,2012,Washington,male,3161,28816,29661,58477,0.10969600222098834,Texas
10643,2012,Washington,male,3161,26851,27555,54406,0.11772373468399687,Texas
10644,2012,Washington,male,3161,66754,67781,134535,0.04735296761242772,Texas
10676,2013,Washington,male,2939,8420,8223,16643,0.3490498812351544,Texas
10677,2013,Washington,male,2939,114181,114348,228529,0.025739834123015212,Texas
10678,2013,Washington,male,2939,2510,2330,4840,1.1709163346613545,Texas
10679,2013,Washington,male,2939,13231,11335,24566,0.2221298465724435,Texas
10680,2013,Washington,male,2939,10361,10100,20461,0.2836598783901168,Texas
10681,2013,Washington,male,2939,4966,5059,10025,0.5918244059605317,Texas
10682,2013,Washington,male,2939,7108,7047,14155,0.4134777715250422,Texas
10683,2013,Washington,male,2939,13892,13935,27827,0.21156061042326518,Texas
10684,2013,Washington,male,2939,11075,11068,22143,0.265372460496614,Texas
10685,2013,Washington,male,2939,2844,2681,5525,1.0334036568213782,Texas
10686,2013,Washington,male,2939,5865,6154,12019,0.5011082693947144,Texas
10687,2013,Washington,male,2939,22963,23494,46457,0.1279885032443496,Texas
10688,2013,Washington,male,2939,15614,16080,31694,0.18822851287306264,Texas
10689,2013,Washington,male,2939,76098,73713,149811,0.038621251544061604,Texas
10690,2013,Washington,male,2939,125332,127985,253317,0.023449717550186704,Texas
10691,2013,Washington,male,2939,22018,25068,47086,0.13348169679353256,Texas
10692,2013,Washington,male,2939,12835,12096,24931,0.22898324892871055,Texas
10693,2013,Washington,male,2939,9911,10308,20219,0.2965391988699425,Texas
10694,2013,Washington,male,2939,32002,29826,61828,0.09183801012436722,Texas
10695,2013,Washington,male,2939,5726,6430,12156,0.5132727907789032,Texas
10696,2013,Washington,male,2939,29953,30718,60671,0.09812038860882048,Texas
10697,2013,Washington,male,2939,25253,26748,52001,0.11638221201441414,Texas
10698,2013,Washington,male,2939,287522,294299,581821,0.01022182650371102,Texas
10699,2013,Washington,male,2939,101709,105838,207547,0.028896164547876784,Texas
10700,2013,Washington,male,2939,61110,65132,126242,0.04809360170184913,Texas
10701,2013,Washington,male,2939,61851,65204,127055,0.047517420898611176,Texas
10702,2013,Washington,male,2939,17259,17537,34796,0.17028796569905558,Texas
10703,2013,Washington,male,2939,79500,81037,160537,0.036968553459119494,Texas
10704,2013,Washington,male,2939,28816,29661,58477,0.10199194891726819,Texas
10705,2013,Washington,male,2939,26851,27555,54406,0.1094558861867342,Texas
10706,2013,Washington,male,2939,66754,67781,134535,0.04402732420529107,Texas
10738,2014,Washington,male,1433,8420,8223,16643,0.17019002375296913,Texas
10739,2014,Washington,male,1433,114181,114348,228529,0.012550249165798163,Texas
10740,2014,Washington,male,1433,2510,2330,4840,0.5709163346613546,Texas
10741,2014,Washington,male,1433,13231,11335,24566,0.10830625047237548,Texas
10742,2014,Washington,male,1433,10361,10100,20461,0.13830711321301034,Texas
10743,2014,Washington,male,1433,4966,5059,10025,0.2885622231171969,Texas
10744,2014,Washington,male,1433,7108,7047,14155,0.20160382667416996,Texas
10745,2014,Washington,male,1433,13892,13935,27827,0.10315289375179959,Texas
10746,2014,Washington,male,1433,11075,11068,22143,0.12939051918735892,Texas
10747,2014,Washington,male,1433,2844,2681,5525,0.5038677918424754,Texas
10748,2014,Washington,male,1433,5865,6154,12019,0.2443307757885763,Texas
10749,2014,Washington,male,1433,22963,23494,46457,0.062404738056874104,Texas
10750,2014,Washington,male,1433,15614,16080,31694,0.09177661073395671,Texas
10751,2014,Washington,male,1433,76098,73713,149811,0.01883098110331415,Texas
10752,2014,Washington,male,1433,125332,127985,253317,0.011433632272683751,Texas
10753,2014,Washington,male,1433,22018,25068,47086,0.06508311381596875,Texas
10754,2014,Washington,male,1433,12835,12096,24931,0.11164783794312427,Texas
10755,2014,Washington,male,1433,9911,10308,20219,0.14458682272222784,Texas
10756,2014,Washington,male,1433,32002,29826,61828,0.04477845134679082,Texas
10757,2014,Washington,male,1433,5726,6430,12156,0.2502619629758994,Texas
10758,2014,Washington,male,1433,29953,30718,60671,0.04784161853570594,Texas
10759,2014,Washington,male,1433,25253,26748,52001,0.05674573318021621,Texas
10760,2014,Washington,male,1433,287522,294299,581821,0.00498396644430687,Texas
10761,2014,Washington,male,1433,101709,105838,207547,0.014089215310346183,Texas
10762,2014,Washington,male,1433,61110,65132,126242,0.023449517263950254,Texas
10763,2014,Washington,male,1433,61851,65204,127055,0.023168582561316712,Texas
10764,2014,Washington,male,1433,17259,17537,34796,0.08302914421461266,Texas
10765,2014,Washington,male,1433,79500,81037,160537,0.0180251572327044,Texas
10766,2014,Washington,male,1433,28816,29661,58477,0.049729317046085506,Texas
10767,2014,Washington,male,1433,26851,27555,54406,0.053368589624222564,Texas
10768,2014,Washington,male,1433,66754,67781,134535,0.021466878389310003,Texas
10800,2015,Washington,male,1492,8420,8223,16643,0.17719714964370548,Texas
10801,2015,Washington,male,1492,114181,114348,228529,0.013066972613657264,Texas
10802,2015,Washington,male,1492,2510,2330,4840,0.5944223107569722,Texas
10803,2015,Washington,male,1492,13231,11335,24566,0.11276547502078452,Texas
10804,2015,Washington,male,1492,10361,10100,20461,0.1440015442524853,Texas
10805,2015,Washington,male,1492,4966,5059,10025,0.3004430124848973,Texas
10806,2015,Washington,male,1492,7108,7047,14155,0.20990433314575127,Texas
10807,2015,Washington,male,1492,13892,13935,27827,0.1073999424128995,Texas
10808,2015,Washington,male,1492,11075,11068,22143,0.13471783295711062,Texas
10809,2015,Washington,male,1492,2844,2681,5525,0.5246132208157525,Texas
10810,2015,Washington,male,1492,5865,6154,12019,0.2543904518329071,Texas
10811,2015,Washington,male,1492,22963,23494,46457,0.06497408875146976,Texas
10812,2015,Washington,male,1492,15614,16080,31694,0.09555527091072115,Texas
10813,2015,Washington,male,1492,76098,73713,149811,0.01960629714315751,Texas
10814,2015,Washington,male,1492,125332,127985,253317,0.01190438196151023,Texas
10815,2015,Washington,male,1492,22018,25068,47086,0.06776273957670996,Texas
10816,2015,Washington,male,1492,12835,12096,24931,0.11624464355278535,Texas
10817,2015,Washington,male,1492,9911,10308,20219,0.15053980425789526,Texas
10818,2015,Washington,male,1492,32002,29826,61828,0.046622086119617524,Texas
10819,2015,Washington,male,1492,5726,6430,12156,0.2605658400279427,Texas
10820,2015,Washington,male,1492,29953,30718,60671,0.049811371148132076,Texas
10821,2015,Washington,male,1492,25253,26748,52001,0.059082089256721974,Texas
10822,2015,Washington,male,1492,287522,294299,581821,0.0051891681332211104,Texas
10823,2015,Washington,male,1492,101709,105838,207547,0.014669301635056878,Texas
10824,2015,Washington,male,1492,61110,65132,126242,0.02441498936344297,Texas
10825,2015,Washington,male,1492,61851,65204,127055,0.024122487914504213,Texas
10826,2015,Washington,male,1492,17259,17537,34796,0.08644765050118779,Texas
10827,2015,Washington,male,1492,79500,81037,160537,0.018767295597484277,Texas
10828,2015,Washington,male,1492,28816,29661,58477,0.051776790671848975,Texas
10829,2015,Washington,male,1492,26851,27555,54406,0.05556590071133291,Texas
10830,2015,Washington,male,1492,66754,67781,134535,0.022350720556071547,Texas
10862,2016,Washington,male,2655,8420,8223,16643,0.3153206650831354,Texas
10863,2016,Washington,male,2655,114181,114348,228529,0.02325255515365954,Texas
10864,2016,Washington,male,2655,2510,2330,4840,1.0577689243027888,Texas
10865,2016,Washington,male,2655,13231,11335,24566,0.20066510467840676,Texas
10866,2016,Washington,male,2655,10361,10100,20461,0.25624939677637293,Texas
10867,2016,Washington,male,2655,4966,5059,10025,0.5346355215465163,Texas
10868,2016,Washington,male,2655,7108,7047,14155,0.3735227912211593,Texas
10869,2016,Washington,male,2655,13892,13935,27827,0.19111718974949612,Texas
10870,2016,Washington,male,2655,11075,11068,22143,0.23972911963882618,Texas
10871,2016,Washington,male,2655,2844,2681,5525,0.9335443037974683,Texas
10872,2016,Washington,male,2655,5865,6154,12019,0.45268542199488493,Texas
10873,2016,Washington,male,2655,22963,23494,46457,0.11562078125680443,Texas
10874,2016,Washington,male,2655,15614,16080,31694,0.1700397079543999,Texas
10875,2016,Washington,male,2655,76098,73713,149811,0.034889221792951196,Texas
10876,2016,Washington,male,2655,125332,127985,253317,0.02118373599719146,Texas
10877,2016,Washington,male,2655,22018,25068,47086,0.12058315923335453,Texas
10878,2016,Washington,male,2655,12835,12096,24931,0.20685625243474873,Texas
10879,2016,Washington,male,2655,9911,10308,20219,0.2678841691050348,Texas
10880,2016,Washington,male,2655,32002,29826,61828,0.08296356477720143,Texas
10881,2016,Washington,male,2655,5726,6430,12156,0.463674467341949,Texas
10882,2016,Washington,male,2655,29953,30718,60671,0.08863886755917605,Texas
10883,2016,Washington,male,2655,25253,26748,52001,0.10513602344275928,Texas
10884,2016,Washington,male,2655,287522,294299,581821,0.009234076001140783,Texas
10885,2016,Washington,male,2655,101709,105838,207547,0.02610388461198124,Texas
10886,2016,Washington,male,2655,61110,65132,126242,0.04344624447717231,Texas
10887,2016,Washington,male,2655,61851,65204,127055,0.04292574089343745,Texas
10888,2016,Washington,male,2655,17259,17537,34796,0.1538327828958804,Texas
10889,2016,Washington,male,2655,79500,81037,160537,0.03339622641509434,Texas
10890,2016,Washington,male,2655,28816,29661,58477,0.09213631315935591,Texas
10891,2016,Washington,male,2655,26851,27555,54406,0.09887899891996574,Texas
10892,2016,Washington,male,2655,66754,67781,134535,0.039772897504269406,Texas
10894,2009,Webb,male,20367,132906,139147,272053,0.15324364588506162,Texas
10896,2010,Webb,male,27080,132906,139147,272053,0.20375302845620213,Texas
10898,2011,Webb,male,21693,132906,139147,272053,0.16322062209381066,Texas
10900,2012,Webb,male,22069,132906,139147,272053,0.16604968925405925,Texas
10902,2013,Webb,male,15013,132906,139147,272053,0.1129595353106707,Texas
10904,2014,Webb,male,13156,132906,139147,272053,0.0989872541495493,Texas
10906,2015,Webb,male,17184,132906,139147,272053,0.12929438851519118,Texas
10908,2016,Webb,male,15127,132906,139147,272053,0.11381728439649075,Texas
10910,2009,Wharton,male,10084,20395,21156,41551,0.49443491051728367,Texas
10912,2010,Wharton,male,9504,20395,21156,41551,0.4659965677862221,Texas
10914,2011,Wharton,male,11273,20395,21156,41551,0.5527335131159598,Texas
10916,2012,Wharton,male,6928,20395,21156,41551,0.3396911007599902,Texas
10918,2013,Wharton,male,5984,20395,21156,41551,0.29340524638391763,Texas
10920,2014,Wharton,male,3910,20395,21156,41551,0.19171365530767345,Texas
10922,2015,Wharton,male,2893,20395,21156,41551,0.141848492277519,Texas
10924,2016,Wharton,male,3668,20395,21156,41551,0.17984800196126502,Texas
10929,2009,Wheeler,male,4180,5007,2932,7939,0.8348312362692231,Texas
10930,2009,Wheeler,male,4180,435,387,822,9.60919540229885,Texas
10931,2009,Wheeler,male,4180,728,698,1426,5.741758241758242,Texas
10932,2009,Wheeler,male,4180,2844,2638,5482,1.469760900140647,Texas
10937,2010,Wheeler,male,4286,5007,2932,7939,0.8560015977631316,Texas
10938,2010,Wheeler,male,4286,435,387,822,9.85287356321839,Texas
10939,2010,Wheeler,male,4286,728,698,1426,5.887362637362638,Texas
10940,2010,Wheeler,male,4286,2844,2638,5482,1.5070323488045008,Texas
10945,2011,Wheeler,male,3172,5007,2932,7939,0.6335130816856401,Texas
10946,2011,Wheeler,male,3172,435,387,822,7.291954022988506,Texas
10947,2011,Wheeler,male,3172,728,698,1426,4.357142857142857,Texas
10948,2011,Wheeler,male,3172,2844,2638,5482,1.1153305203938115,Texas
10953,2012,Wheeler,male,2888,5007,2932,7939,0.5767924905132814,Texas
10954,2012,Wheeler,male,2888,435,387,822,6.639080459770115,Texas
10955,2012,Wheeler,male,2888,728,698,1426,3.967032967032967,Texas
10956,2012,Wheeler,male,2888,2844,2638,5482,1.0154711673699015,Texas
10961,2013,Wheeler,male,3345,5007,2932,7939,0.6680647094068305,Texas
10962,2013,Wheeler,male,3345,435,387,822,7.689655172413793,Texas
10963,2013,Wheeler,male,3345,728,698,1426,4.59478021978022,Texas
10964,2013,Wheeler,male,3345,2844,2638,5482,1.1761603375527425,Texas
10969,2014,Wheeler,male,3166,5007,2932,7939,0.6323147593369283,Texas
10970,2014,Wheeler,male,3166,435,387,822,7.2781609195402295,Texas
10971,2014,Wheeler,male,3166,728,698,1426,4.3489010989010985,Texas
10972,2014,Wheeler,male,3166,2844,2638,5482,1.1132208157524612,Texas
10977,2015,Wheeler,male,2872,5007,2932,7939,0.5735969642500499,Texas
10978,2015,Wheeler,male,2872,435,387,822,6.602298850574712,Texas
10979,2015,Wheeler,male,2872,728,698,1426,3.9450549450549453,Texas
10980,2015,Wheeler,male,2872,2844,2638,5482,1.009845288326301,Texas
10985,2016,Wheeler,male,2194,5007,2932,7939,0.43818653884561615,Texas
10986,2016,Wheeler,male,2194,435,387,822,5.04367816091954,Texas
10987,2016,Wheeler,male,2194,728,698,1426,3.0137362637362637,Texas
10988,2016,Wheeler,male,2194,2844,2638,5482,0.7714486638537271,Texas
10991,2009,Wichita,male,6842,1019,1124,2143,6.714425907752699,Texas
10992,2009,Wichita,male,6842,68325,63493,131818,0.10013904134650567,Texas
10995,2010,Wichita,male,7182,1019,1124,2143,7.048086359175662,Texas
10996,2010,Wichita,male,7182,68325,63493,131818,0.10511525795828759,Texas
10999,2011,Wichita,male,7140,1019,1124,2143,7.006869479882237,Texas
11000,2011,Wichita,male,7140,68325,63493,131818,0.10450054884742041,Texas
11003,2012,Wichita,male,6875,1019,1124,2143,6.746810598626104,Texas
11004,2012,Wichita,male,6875,68325,63493,131818,0.10062202707647273,Texas
11007,2013,Wichita,male,6293,1019,1124,2143,6.1756624141315015,Texas
11008,2013,Wichita,male,6293,68325,63493,131818,0.09210391511159897,Texas
11011,2014,Wichita,male,5330,1019,1124,2143,5.230618253189402,Texas
11012,2014,Wichita,male,5330,68325,63493,131818,0.07800951335528723,Texas
11015,2015,Wichita,male,5367,1019,1124,2143,5.266928361138371,Texas
11016,2015,Wichita,male,5367,68325,63493,131818,0.0785510428100988,Texas
11019,2016,Wichita,male,5712,1019,1124,2143,5.60549558390579,Texas
11020,2016,Wichita,male,5712,68325,63493,131818,0.08360043907793634,Texas
11022,2009,Wilbarger,male,4662,6347,6559,12906,0.7345202457854104,Texas
11024,2010,Wilbarger,male,6277,6347,6559,12906,0.9889711674806996,Texas
11026,2011,Wilbarger,male,7624,6347,6559,12906,1.2011974161020955,Texas
11028,2012,Wilbarger,male,6446,6347,6559,12906,1.0155979202772965,Texas
11030,2013,Wilbarger,male,5450,6347,6559,12906,0.8586733890026784,Texas
11032,2014,Wilbarger,male,3431,6347,6559,12906,0.5405703481959981,Texas
11034,2015,Wilbarger,male,2308,6347,6559,12906,0.36363636363636365,Texas
11036,2016,Wilbarger,male,4565,6347,6559,12906,0.7192374350086655,Texas
11038,2009,Willacy,male,11698,11681,10073,21754,1.001455354849756,Texas
11040,2010,Willacy,male,9762,11681,10073,21754,0.8357161201951888,Texas
11042,2011,Willacy,male,7940,11681,10073,21754,0.6797363239448677,Texas
11044,2012,Willacy,male,8773,11681,10073,21754,0.7510487115829124,Texas
11046,2013,Willacy,male,8621,11681,10073,21754,0.7380361270439175,Texas
11048,2014,Willacy,male,4605,11681,10073,21754,0.39422994606626144,Texas
11050,2015,Willacy,male,3836,11681,10073,21754,0.3283965413920041,Texas
11052,2016,Willacy,male,3867,11681,10073,21754,0.3310504237650886,Texas
11056,2009,Williamson,male,26202,33607,33692,67299,0.7796589996131759,Texas
11057,2009,Williamson,male,26202,107021,111627,218648,0.244830453836163,Texas
11058,2009,Williamson,male,26202,259443,267614,527057,0.10099328176131174,Texas
11062,2010,Williamson,male,26888,33607,33692,67299,0.8000714136935757,Texas
11063,2010,Williamson,male,26888,107021,111627,218648,0.25124041076050496,Texas
11064,2010,Williamson,male,26888,259443,267614,527057,0.10363740783139264,Texas
11068,2011,Williamson,male,30497,33607,33692,67299,0.9074597554080995,Texas
11069,2011,Williamson,male,30497,107021,111627,218648,0.2849627643172835,Texas
11070,2011,Williamson,male,30497,259443,267614,527057,0.11754797778317395,Texas
11074,2012,Williamson,male,26165,33607,33692,67299,0.7785580385038832,Texas
11075,2012,Williamson,male,26165,107021,111627,218648,0.2444847272965119,Texas
11076,2012,Williamson,male,26165,259443,267614,527057,0.10085066854761933,Texas
11080,2013,Williamson,male,18752,33607,33692,67299,0.5579789924718065,Texas
11081,2013,Williamson,male,18752,107021,111627,218648,0.17521794787938816,Texas
11082,2013,Williamson,male,18752,259443,267614,527057,0.07227791846378588,Texas
11086,2014,Williamson,male,15798,33607,33692,67299,0.4700806379623293,Texas
11087,2014,Williamson,male,15798,107021,111627,218648,0.1476158884704871,Texas
11088,2014,Williamson,male,15798,259443,267614,527057,0.06089198783547831,Texas
11092,2015,Williamson,male,9607,33607,33692,67299,0.2858630642425685,Texas
11093,2015,Williamson,male,9607,107021,111627,218648,0.08976742882238066,Texas
11094,2015,Williamson,male,9607,259443,267614,527057,0.037029328214675285,Texas
11098,2016,Williamson,male,8052,33607,33692,67299,0.23959294194661826,Texas
11099,2016,Williamson,male,8052,107021,111627,218648,0.07523757019650348,Texas
11100,2016,Williamson,male,8052,259443,267614,527057,0.03103571882841318,Texas
11105,2009,Wilson,male,4919,4318,4462,8780,1.1391848077813802,Texas
11106,2009,Wilson,male,4919,38362,42974,81336,0.1282258484959074,Texas
11107,2009,Wilson,male,4919,65056,67607,132663,0.07561178061977374,Texas
11108,2009,Wilson,male,4919,24197,24001,48198,0.20328966400793486,Texas
11113,2010,Wilson,male,6126,4318,4462,8780,1.4187123668364985,Texas
11114,2010,Wilson,male,6126,38362,42974,81336,0.15968927584588916,Texas
11115,2010,Wilson,male,6126,65056,67607,132663,0.09416502705361535,Texas
11116,2010,Wilson,male,6126,24197,24001,48198,0.25317188081167086,Texas
11121,2011,Wilson,male,5174,4318,4462,8780,1.1982399258916165,Texas
11122,2011,Wilson,male,5174,38362,42974,81336,0.13487305145717116,Texas
11123,2011,Wilson,male,5174,65056,67607,132663,0.07953148057058534,Texas
11124,2011,Wilson,male,5174,24197,24001,48198,0.21382816051576642,Texas
11129,2012,Wilson,male,6686,4318,4462,8780,1.5484020379805465,Texas
11130,2012,Wilson,male,6686,38362,42974,81336,0.17428705489807622,Texas
11131,2012,Wilson,male,6686,65056,67607,132663,0.10277299557304476,Texas
11132,2012,Wilson,male,6686,24197,24001,48198,0.27631524569161464,Texas
11137,2013,Wilson,male,5518,4318,4462,8780,1.2779064381658176,Texas
11138,2013,Wilson,male,5518,38362,42974,81336,0.14384025858922891,Texas
11139,2013,Wilson,male,5518,65056,67607,132663,0.08481923266109198,Texas
11140,2013,Wilson,male,5518,24197,24001,48198,0.2280447989420176,Texas
11145,2014,Wilson,male,4031,4318,4462,8780,0.9335340435386753,Texas
11146,2014,Wilson,male,4031,38362,42974,81336,0.10507794171315364,Texas
11147,2014,Wilson,male,4031,65056,67607,132663,0.06196200196753566,Texas
11148,2014,Wilson,male,4031,24197,24001,48198,0.1665908996983097,Texas
11153,2015,Wilson,male,6184,4318,4462,8780,1.4321445113478461,Texas
11154,2015,Wilson,male,6184,38362,42974,81336,0.16120118867629424,Texas
11155,2015,Wilson,male,6184,65056,67607,132663,0.09505656665027054,Texas
11156,2015,Wilson,male,6184,24197,24001,48198,0.25556887217423646,Texas
11161,2016,Wilson,male,6489,4318,4462,8780,1.502779064381658,Texas
11162,2016,Wilson,male,6489,38362,42974,81336,0.16915176476721755,Texas
11163,2016,Wilson,male,6489,65056,67607,132663,0.09974483521888834,Texas
11164,2016,Wilson,male,6489,24197,24001,48198,0.26817374054634874,Texas
11166,2009,Winkler,male,1007,3977,3825,7802,0.2532059341211969,Texas
11168,2010,Winkler,male,811,3977,3825,7802,0.2039225546894644,Texas
11170,2011,Winkler,male,585,3977,3825,7802,0.14709580085491578,Texas
11172,2012,Winkler,male,800,3977,3825,7802,0.20115665074176514,Texas
11174,2013,Winkler,male,450,3977,3825,7802,0.1131506160422429,Texas
11176,2014,Winkler,male,1242,3977,3825,7802,0.31229570027659037,Texas
11178,2015,Winkler,male,117,3977,3825,7802,0.029419160170983154,Texas
11180,2016,Winkler,male,519,3977,3825,7802,0.13050037716872015,Texas
11183,2009,Wise,male,22236,32424,32215,64639,0.6857883049592894,Texas
11184,2009,Wise,male,22236,20490,18535,39025,1.085212298682284,Texas
11187,2010,Wise,male,20927,32424,32215,64639,0.6454169750801875,Texas
11188,2010,Wise,male,20927,20490,18535,39025,1.0213274768179599,Texas
11191,2011,Wise,male,20090,32424,32215,64639,0.6196027633851469,Texas
11192,2011,Wise,male,20090,20490,18535,39025,0.9804782820888238,Texas
11195,2012,Wise,male,16763,32424,32215,64639,0.5169935849987664,Texas
11196,2012,Wise,male,16763,20490,18535,39025,0.8181063933626159,Texas
11199,2013,Wise,male,15721,32424,32215,64639,0.48485689612632615,Texas
11200,2013,Wise,male,15721,20490,18535,39025,0.767252318204002,Texas
11203,2014,Wise,male,14396,32424,32215,64639,0.4439921046138663,Texas
11204,2014,Wise,male,14396,20490,18535,39025,0.7025866276232309,Texas
11207,2015,Wise,male,11700,32424,32215,64639,0.36084381939304216,Texas
11208,2015,Wise,male,11700,20490,18535,39025,0.5710102489019033,Texas
11211,2016,Wise,male,14066,32424,32215,64639,0.43381445842585736,Texas
11212,2016,Wise,male,14066,20490,18535,39025,0.6864812103465104,Texas
11217,2009,Wood,male,6726,63995,65941,129936,0.10510196109071021,Texas
11218,2009,Wood,male,6726,21807,22008,43815,0.308433071949374,Texas
11219,2009,Wood,male,6726,41246,44310,85556,0.16307035833777822,Texas
11220,2009,Wood,male,6726,36056,37218,73274,0.186543155092079,Texas
11225,2010,Wood,male,5816,63995,65941,129936,0.09088210016407532,Texas
11226,2010,Wood,male,5816,21807,22008,43815,0.26670335213463564,Texas
11227,2010,Wood,male,5816,41246,44310,85556,0.14100761285942878,Texas
11228,2010,Wood,male,5816,36056,37218,73274,0.16130463723097405,Texas
11233,2011,Wood,male,6175,63995,65941,129936,0.09649191343073678,Texas
11234,2011,Wood,male,6175,21807,22008,43815,0.28316595588572474,Texas
11235,2011,Wood,male,6175,41246,44310,85556,0.14971148717451388,Texas
11236,2011,Wood,male,6175,36056,37218,73274,0.171261371200355,Texas
11241,2012,Wood,male,5544,63995,65941,129936,0.08663176810688335,Texas
11242,2012,Wood,male,5544,21807,22008,43815,0.2542302930251754,Texas
11243,2012,Wood,male,5544,41246,44310,85556,0.1344130339911749,Texas
11244,2012,Wood,male,5544,36056,37218,73274,0.15376081650765475,Texas
11249,2013,Wood,male,5963,63995,65941,129936,0.0931791546214548,Texas
11250,2013,Wood,male,5963,21807,22008,43815,0.27344430687393956,Texas
11251,2013,Wood,male,5963,41246,44310,85556,0.144571594821316,Texas
11252,2013,Wood,male,5963,36056,37218,73274,0.16538162857776792,Texas
11257,2014,Wood,male,5804,63995,65941,129936,0.09069458551449332,Texas
11258,2014,Wood,male,5804,21807,22008,43815,0.26615307011510064,Texas
11259,2014,Wood,male,5804,41246,44310,85556,0.1407166755564176,Texas
11260,2014,Wood,male,5804,36056,37218,73274,0.1609718216108276,Texas
11265,2015,Wood,male,3843,63995,65941,129936,0.06005156652863505,Texas
11266,2015,Wood,male,3843,21807,22008,43815,0.1762278167560875,Texas
11267,2015,Wood,male,3843,41246,44310,85556,0.09317267128933715,Texas
11268,2015,Wood,male,3843,36056,37218,73274,0.10658420235189704,Texas
11273,2016,Wood,male,5358,63995,65941,129936,0.08372529103836238,Texas
11274,2016,Wood,male,5358,21807,22008,43815,0.24570092172238273,Texas
11275,2016,Wood,male,5358,41246,44310,85556,0.12990350579450127,Texas
11276,2016,Wood,male,5358,36056,37218,73274,0.14860217439538495,Texas
11278,2009,Yoakum,male,1831,4438,4133,8571,0.41257323118521855,Texas
11280,2010,Yoakum,male,1751,4438,4133,8571,0.3945470932852636,Texas
11282,2011,Yoakum,male,1267,4438,4133,8571,0.2854889589905363,Texas
11284,2012,Yoakum,male,1409,4438,4133,8571,0.3174853537629563,Texas
11286,2013,Yoakum,male,664,4438,4133,8571,0.14961694456962596,Texas
11288,2014,Yoakum,male,961,4438,4133,8571,0.21653898152320866,Texas
11290,2015,Yoakum,male,656,4438,4133,8571,0.14781433077963047,Texas
11292,2016,Yoakum,male,803,4438,4133,8571,0.18093735917079765,Texas
11294,2009,Young,male,5564,8930,9184,18114,0.6230683090705487,Texas
11296,2010,Young,male,5005,8930,9184,18114,0.5604703247480403,Texas
11298,2011,Young,male,4794,8930,9184,18114,0.5368421052631579,Texas
11300,2012,Young,male,5589,8930,9184,18114,0.6258678611422173,Texas
11302,2013,Young,male,4518,8930,9184,18114,0.5059350503919373,Texas
11304,2014,Young,male,2845,8930,9184,18114,0.31858902575587905,Texas
11306,2015,Young,male,1772,8930,9184,18114,0.19843225083986563,Texas
11308,2016,Young,male,2564,8930,9184,18114,0.28712206047032474,Texas
11310,2009,Zapata,male,5211,7177,7192,14369,0.7260693883238122,Texas
11312,2010,Zapata,male,3568,7177,7192,14369,0.4971436533370489,Texas
11314,2011,Zapata,male,2594,7177,7192,14369,0.3614323533509823,Texas
11316,2012,Zapata,male,1574,7177,7192,14369,0.21931169012122056,Texas
11318,2013,Zapata,male,2800,7177,7192,14369,0.39013515396405185,Texas
11320,2014,Zapata,male,3079,7177,7192,14369,0.42900933537689845,Texas
11322,2015,Zapata,male,2726,7177,7192,14369,0.3798244391807162,Texas
11324,2016,Zapata,male,5898,7177,7192,14369,0.8217918350285635,Texas
11326,2009,Zavala,male,5131,6208,5923,12131,0.826514175257732,Texas
11328,2010,Zavala,male,5105,6208,5923,12131,0.8223260309278351,Texas
11330,2011,Zavala,male,3319,6208,5923,12131,0.5346327319587629,Texas
11332,2012,Zavala,male,1999,6208,5923,12131,0.32200386597938147,Texas
11334,2013,Zavala,male,1947,6208,5923,12131,0.3136275773195876,Texas
11336,2014,Zavala,male,2081,6208,5923,12131,0.33521262886597936,Texas
11338,2015,Zavala,male,2137,6208,5923,12131,0.3442332474226804,Texas
11340,2016,Zavala,male,4017,6208,5923,12131,0.6470682989690721,Texas
